1	1
101	1 0 1
102	1 0 2
20	2 0
240	2 4 0
540	5 4 0
6	6
איבערצובּיהע	א י ב ע ר צ ו בּ י ה ע
אמפּלעך	א מ פּ ל ע ך
אקט	א ק ט
ארומגעקלאַפּט	א ר ו מ ג ע ק ל אַ פּ ט
ארין	א ר י ן
ארץד	א ר ץ ד
ארבּײסער	א ר בּ ײ ס ע ר
אױסגעשפּרײט	א ױ ס ג ע ש פּ ר ײ ט
אױסגעשפּאַנט	א ױ ס ג ע ש פּ אַ נ ט
אױסגעפּוצט	א ױ ס ג ע פּ ו צ ט
אױסגעפּוצטע	א ױ ס ג ע פּ ו צ ט ע
אױסזגשעשפּמנט	א ױ ס ז ג ש ע ש פּ מ נ ט
אױסכאַפּען	א ױ ס כ אַ פּ ע ן
אױפגעכאפּט	א ױ פ ג ע כ א פּ ט
אױפגעכאַפּט	א ױ פ ג ע כ אַ פּ ט
אױפגעפּראַלט	א ױ פ ג ע פּ ר אַ ל ט
אײנגעקאָפּעט	א ײ נ ג ע ק אָ פּ ע ט
אײנגעשסרומפּפען	א ײ נ ג ע ש ס ר ו מ פּ פ ע ן
אײנגעשעפּט	א ײ נ ג ע ש ע פּ ט
אײנגעשפּאַנט	א ײ נ ג ע ש פּ אַ נ ט
אײנגעשפּאַרט	א ײ נ ג ע ש פּ אַ ר ט
אײנגעפּאַקט	א ײ נ ג ע פּ אַ ק ט
אײנפאָהר	א ײ נ פ אָ ה ר
אײנבּילדונגס	א ײ נ בּ י ל ד ו נ ג ס
אפּיקורסות	א פּ י ק ו ר ס ו ת
אפּיקירסטע	א פּ י ק י ר ס ט ע
בוזעם	ב ו ז ע ם
בושת-המת	ב ו ש ת - ה מ ת
בים-באָם	ב י ם - ב אָ ם
בירנ	ב י ר נ
בישט	ב י ש ט
בעלײסט	ב ע ל ײ ס ט
בעלײע	ב ע ל ײ ע
בעקאַנטען	ב ע ק אַ נ ט ע ן
בערזע	ב ע ר ז ע
בעשטימטע	ב ע ש ט י מ ט ע
בעשײנפּערליך	ב ע ש ײ נ פּ ע ר ל י ך
בעפּוצט	ב ע פּ ו צ ט
בתדינע	ב ת ד י נ ע
בתיש	ב ת י ש
בתישע	ב ת י ש ע
גאנ	ג א נ
גין	ג י ן
גיפּען	ג י פּ ע ן
געהעגדיק	ג ע ה ע ג ד י ק
געזונטער	ג ע ז ו נ ט ע ר
געזינדען	ג ע ז י נ ד ע ן
געטשעפּעט	ג ע ט ש ע פּ ע ט
געטאַפּט	ג ע ט אַ פּ ט
געכאפּט	ג ע כ א פּ ט
געכאַפּט	ג ע כ אַ פּ ט
געמעל	ג ע מ ע ל
געסקריפּעט	ג ע ס ק ר י פּ ע ט
געפלאפּקערט	ג ע פ ל א פּ ק ע ר ט
געצופּט	ג ע צ ו פּ ט
געקאפּעט	ג ע ק א פּ ע ט
געקלאַפּט	ג ע ק ל אַ פּ ט
געשטפּט	ג ע ש ט פּ ט
געשלעפּט	ג ע ש ל ע פּ ט
געשפּיעלט	ג ע ש פּ י ע ל ט
געשפּרעך	ג ע ש פּ ר ע ך
געשפּראָכען	ג ע ש פּ ר אָ כ ע ן
געשפּאַנט	ג ע ש פּ אַ נ ט
געשפּאַנעכטס	ג ע ש פּ אַ נ ע כ ט ס
געבּורטס-סאָג	ג ע בּ ו ר ט ס - ס אָ ג
געפּ	ג ע פּ
געפּועלט	ג ע פּ ו ע ל ט
געפּיהלט	ג ע פּ י ה ל ט
געפּלאבּעלט	ג ע פּ ל א בּ ע ל ט
געפּלאַצט	ג ע פּ ל אַ צ ט
געפּלאַפּעלט	ג ע פּ ל אַ פּ ע ל ט
געפּרובט	ג ע פּ ר ו ב ט
געפּרעסט	ג ע פּ ר ע ס ט
געפּרעסטע	ג ע פּ ר ע ס ט ע
געפּײניגט	ג ע פּ ײ נ י ג ט
געפּאַטשט	ג ע פּ אַ ט ש ט
גרעגער	ג ר ע ג ע ר
גרױמען-מילעריל	ג ר ױ מ ע ן - מ י ל ע ר י ל
גרױפּען	ג ר ױ פּ ע ן
דאגות-פּרנסה	ד א ג ו ת - פּ ר נ ס ה
דאך-בּאהנען	ד א ך - בּ א ה נ ע ן
דורכגעשטופּט	ד ו ר כ ג ע ש ט ו פּ ט
דורכגעפּרעגעלט	ד ו ר כ ג ע פּ ר ע ג ע ל ט
דיקאַפּאָטע	ד י ק אַ פּ אָ ט ע
דיפּלאָמאַטישע	ד י פּ ל אָ מ אַ ט י ש ע
דיפּעלצען	ד י פּ ע ל צ ע ן
דלעך	ד ל ע ך
דעםפּריץ	ד ע ם פּ ר י ץ
דערפּאַקט	ד ע ר פּ אַ ק ט
דרףײ	ד ר ף ײ
דאָרש-	ד אָ ר ש -
דאָפּעלט	ד אָ פּ ע ל ט
דאָפּעלטע	ד אָ פּ ע ל ט ע
הביתטע	ה ב י ת ט ע
הביתטעס	ה ב י ת ט ע ס
הביתישע	ה ב י ת י ש ע
הביתישער	ה ב י ת י ש ע ר
הביתישקײט	ה ב י ת י ש ק ײ ט
הבתים	ה ב ת י ם
הבתיש	ה ב ת י ש
הור	ה ו ר
הח	ה ח
היטערין	ה י ט ע ר י ן
הינקער-פּלעט	ה י נ ק ע ר - פּ ל ע ט
הכנסת	ה כ נ ס ת
המדרשל	ה מ ד ר ש ל
המקדש	ה מ ק ד ש
המפּיל	ה מ פּ י ל
העמדערשאפּ	ה ע מ ד ע ר ש א פּ
הקברות	ה ק ב ר ו ת
הײטאַטס	ה ײ ט אַ ט ס
הײל	ה ײ ל
האָפּ	ה אָ פּ
ומ	ו מ
ואָליע	ו אָ ל י ע
זום-זום-זום	ז ו ם - ז ו ם - ז ו ם
זיצוגגס	ז י צ ו ג ג ס
זײדעע	ז ײ ד ע ע
זאַק	ז אַ ק
זאָדע	ז אָ ד ע
חופּה	ח ו פּ ה
חופּות	ח ו פּ ו ת
חס	ח ס
חרפּה	ח ר פּ ה
חתז-כלג	ח ת ז - כ ל ג
טהױ	ט ה ױ
טובדינער	ט ו ב ד י נ ע ר
טובדיק	ט ו ב ד י ק
טעהרטראָפּען	ט ע ה ר ט ר אָ פּ ע ן
טעמפּלען	ט ע מ פּ ל ע ן
טעמפּעל	ט ע מ פּ ע ל
טעפּ	ט ע פּ
טעפּלעך	ט ע פּ ל ע ך
טעפּעל	ט ע פּ ע ל
טרוער	ט ר ו ע ר
טרעפּ	ט ר ע פּ
טרעפּעלעך	ט ר ע פּ ע ל ע ך
טראַנספּאָרט	ט ר אַ נ ס פּ אָ ר ט
טראָפּען	ט ר אָ פּ ע ן
טשעפּיק	ט ש ע פּ י ק
טשעפּען	ט ש ע פּ ע ן
טױערען	ט ױ ע ר ע ן
טאַמע	ט אַ מ ע
טאַנטשיקך	ט אַ נ ט ש י ק ך
טאַנץ	ט אַ נ ץ
טאָגס	ט אָ ג ס
טאָפּ	ט אָ פּ
טאָפּאָלען	ט אָ פּ אָ ל ע ן
ידים	י ד י ם
יודעי	י ו ד ע י
יונגס	י ו נ ג ס
יורה	י ו ר ה
יטהיל	י ט ה י ל
יכול	י כ ו ל
ימער	י מ ע ר
ינגענומ	י נ ג ע נ ו מ
יעהריגע	י ע ה ר י ג ע
ייִאר-יאױפ	י יִ א ר - י א ױ פ
יאַגדע-סטאַניק	י אַ ג ד ע - ס ט אַ נ י ק
יאָה	י אָ ה
כאפּט	כ א פּ ט
כאפּען	כ א פּ ע ן
כליפּענדיק	כ ל י פּ ע נ ד י ק
כפול-שמונהדיגע	כ פ ו ל - ש מ ו נ ה ד י ג ע
כאַפּ	כ אַ פּ
כאַפּט	כ אַ פּ ט
כאַפּען	כ אַ פּ ע ן
כאַפּענדיק	כ אַ פּ ע נ ד י ק
כפּורדיג	כ פּ ו ר ד י ג
לה	ל ה
לואיש	ל ו א י ש
ליבס	ל י ב ס
לית	ל י ת
ליפּ	ל י פּ
ליפּעלעך	ל י פּ ע ל ע ך
ליפּען	ל י פּ ע ן
למפּרענדעע	ל מ פּ ר ע נ ד ע ע
לעגער	ל ע ג ע ר
לעמפּעלעך	ל ע מ פּ ע ל ע ך
לעפּען	ל ע פּ ע ן
לאַפּען	ל אַ פּ ע ן
לאָמפּ	ל אָ מ פּ
לאָמפּען	ל אָ מ פּ ע ן
לאָס-שען	ל אָ ס - ש ע ן
לאָסטעגס	ל אָ ס ט ע ג ס
לאָפּעטע	ל אָ פּ ע ט ע
לאָפּעטעס	ל אָ פּ ע ט ע ס
מילה	מ י ל ה
מילען	מ י ל ע ן
מלכותדינען	מ ל כ ו ת ד י נ ע ן
מנורת-הכלל	מ נ ו ר ת - ה כ ל ל
מעהליגער	מ ע ה ל י ג ע ר
מעהרסטענט	מ ע ה ר ס ט ע נ ט
מעפּ	מ ע פּ
מעפּלעד	מ ע פּ ל ע ד
משפּחה	מ ש פּ ח ה
משפּחהגריבעלע	מ ש פּ ח ה ג ר י ב ע ל ע
משפּחהדיג	מ ש פּ ח ה ד י ג
משפּחהבּלוט	מ ש פּ ח ה בּ ל ו ט
משפּחות	מ ש פּ ח ו ת
מת	מ ת
מײדל	מ ײ ד ל
מײלעכער-פערקרימענישען	מ ײ ל ע כ ע ר - פ ע ר ק ר י מ ע נ י ש ע ן
מאַנספּערשױנעז	מ אַ נ ס פּ ע ר ש ױ נ ע ז
מאַנספּערשױנען	מ אַ נ ס פּ ע ר ש ױ נ ע ן
מאַרשאַל	מ אַ ר ש אַ ל
מאָדיש	מ אָ ד י ש
נחמה	נ ח מ ה
ניו-יאָרק	נ י ו - י אָ ר ק
נלאכימ	נ ל א כ י מ
נעזער	נ ע ז ע ר
נעשםי	נ ע ש ם י
נצחון	נ צ ח ו ן
נקמה	נ ק מ ה
נײחגעןבױרע	נ ײ ח ג ע ן ב ױ ר ע
נײפעלן	נ ײ פ ע ל ן
נאַכטען	נ אַ כ ט ע ן
נאַמ	נ אַ מ
נאָכגעשלעפּבּ	נ אָ כ ג ע ש ל ע פּ בּ
סימפּטאָמען	ס י מ פּ ט אָ מ ע ן
סקריפּען	ס ק ר י פּ ע ן
סאַ	ס אַ
סאַק	ס אַ ק
ספּעציעלע	ס פּ ע צ י ע ל ע
עגלה	ע ג ל ה
עגלות	ע ג ל ו ת
עולי	ע ו ל י
עילין	ע י ל י ן
עמפּפאנגען	ע מ פּ פ א נ ג ע ן
עמפּפאַגנט	ע מ פּ פ אַ ג נ ט
ענדיק	ע נ ד י ק
ענטפּלעקט	ע נ ט פּ ל ע ק ט
ענספּלעקט	ע נ ס פּ ל ע ק ט
עעמפּעל	ע ע מ פּ ע ל
עפעפּי	ע פ ע פּ י
עקספּעדירט	ע ק ס פּ ע ד י ר ט
עקענדיגש	ע ק ע נ ד י ג ש
ערדער	ע ר ד ע ר
ערשטערפּון	ע ר ש ט ע ר פּ ו ן
עאַפּעלוש	ע אַ פּ ע ל ו ש
עפּעל	ע פּ ע ל
עפּעליך	ע פּ ע ל י ך
עפּעלעך	ע פּ ע ל ע ך
עפּעמ	ע פּ ע מ
עפּעס	ע פּ ע ס
עפּעק	ע פּ ע ק
עפּשטײן	ע פּ ש ט ײ ן
עפּשטײנען	ע פּ ש ט ײ נ ע ן
עפּאָכעס	ע פּ אָ כ ע ס
פאד-נאַכטען	פ א ד - נ אַ כ ט ע ן
פילאַנטראָפּ	פ י ל אַ נ ט ר אָ פּ
פיאַ	פ י אַ
פליסטע	פ ל י ס ט ע
פליסענדיגע	פ ל י ס ע נ ד י ג ע
פלעדער-װישען	פ ל ע ד ע ר - װ י ש ע ן
פלעקען	פ ל ע ק ע ן
פערסאָפּעט	פ ע ר ס אָ פּ ע ט
פערפאָלגונגס-װאַהנזין	פ ע ר פ אָ ל ג ו נ ג ס - װ אַ ה נ ז י ן
פערקריפּעלט	פ ע ר ק ר י פּ ע ל ט
פערשטופּט	פ ע ר ש ט ו פּ ט
פערשפּרײט	פ ע ר ש פּ ר ײ ט
פערשפּרײטען	פ ע ר ש פּ ר ײ ט ע ן
פערפּלאָנטערט	פ ע ר פּ ל אָ נ ט ע ר ט
פערפּאַקט	פ ע ר פּ אַ ק ט
פרײטאָגס	פ ר ײ ט אָ ג ס
פײפען	פ ײ פ ע ן
פאַמיליען-ראַט	פ אַ מ י ל י ע ן - ר אַ ט
פאַראַ-יאָהריגער	פ אַ ר אַ - י אָ ה ר י ג ע ר
צוגעכאַפּט	צ ו ג ע כ אַ פּ ט
צוזאַמענפיהרעןחתן	צ ו ז אַ מ ע נ פ י ה ר ע ן ח ת ן
צוזאַמענכּשלאַפּט	צ ו ז אַ מ ע נ כּ ש ל אַ פּ ט
צונאַכטס	צ ו נ אַ כ ט ס
צופּ	צ ו פּ
צופּט	צ ו פּ ט
צופּלאַצט	צ ו פּ ל אַ צ ט
צופּלאָשעט	צ ו פּ ל אָ ש ע ט
צופּען	צ ו פּ ע ן
צפּ	צ פּ
קאפּױר	ק א פּ ױ ר
קו	ק ו
קופּיעץ	ק ו פּ י ע ץ
קופּעס	ק ו פּ ע ס
קופּער	ק ו פּ ע ר
קופּקעלע	ק ו פּ ק ע ל ע
קופּקעלעך	ק ו פּ ק ע ל ע ך
קיהן-העלצלע	ק י ה ן - ה ע ל צ ל ע
קילעך	ק י ל ע ך
קירכען-גלאָק	ק י ר כ ע ן - ג ל אָ ק
קלאַפּ	ק ל אַ פּ
קלאַפּט	ק ל אַ פּ ט
קלאַפּען	ק ל אַ פּ ע ן
קלאָפּט	ק ל אָ פּ ט
קנעפּ	ק נ ע פּ
קנאַפּ	ק נ אַ פּ
קערט	ק ע ר ט
קערפּער	ק ע ר פּ ע ר
קעפּ	ק ע פּ
קעפּי-יגער	ק ע פּ י - י ג ע ר
קעפּליך	ק ע פּ ל י ך
קעפּלעך	ק ע פּ ל ע ך
קראפט	ק ר א פ ט
קריאת	ק ר י א ת
קאַם	ק אַ ם
קאַנאַפּע	ק אַ נ אַ פּ ע
קאַפּיטל	ק אַ פּ י ט ל
קאַפּעלושלער	ק אַ פּ ע ל ו ש ל ע ר
קאַפּריז	ק אַ פּ ר י ז
קאַפּאָטע	ק אַ פּ אָ ט ע
קאַפּאָטעס	ק אַ פּ אָ ט ע ס
קאַפּאָטקעלעך	ק אַ פּ אָ ט ק ע ל ע ך
קאַפּאָטש	ק אַ פּ אָ ט ש
קאָרפּוס	ק אָ ר פּ ו ס
קאָפּ	ק אָ פּ
קאָפּקע	ק אָ פּ ק ע
רגעפען	ר ג ע פ ע ן
רהלע	ר ה ל ע
רע	ר ע
רעכען-מײסטער	ר ע כ ע ן - מ ײ ס ט ע ר
רעמפּיגקײט	ר ע מ פּ י ג ק ײ ט
רעמפּלען	ר ע מ פּ ל ע ן
רענדיגע	ר ע נ ד י ג ע
רײטאג	ר ײ ט א ג
רײסענדיגער	ר ײ ס ע נ ד י ג ע ר
ראַמפּעלט	ר אַ מ פּ ע ל ט
ראָט	ר אָ ט
שאפּ	ש א פּ
שאפּס	ש א פּ ס
שהל-געעל	ש ה ל - ג ע ע ל
שחיטת	ש ח י ט ת
שטאנדפּונקט	ש ט א נ ד פּ ו נ ק ט
שטונה-עשרה	ש ט ו נ ה - ע ש ר ה
שטופּט	ש ט ו פּ ט
שטופּען	ש ט ו פּ ע ן
שטי	ש ט י
שטיף	ש ט י ף
שטעדטישע	ש ט ע ד ט י ש ע
שטעכ	ש ט ע כ
שטעלונגס	ש ט ע ל ו נ ג ס
שטײ	ש ט ײ
שטאַנדפּונקט	ש ט אַ נ ד פּ ו נ ק ט
שטאָהל-קאַצענע	ש ט אָ ה ל - ק אַ צ ע נ ע
שיפס-קאַרטע	ש י פ ס - ק אַ ר ט ע
שלחן-ערוך	ש ל ח ן - ע ר ו ך
שליסעל-לאָבּ	ש ל י ס ע ל - ל אָ בּ
שלעפּט	ש ל ע פּ ט
שלעפּען	ש ל ע פּ ע ן
שלעפּענדיק	ש ל ע פּ ע נ ד י ק
שלש-סעודות	ש ל ש - ס ע ו ד ו ת
שלײער	ש ל ײ ע ר
שמונה-עשרה	ש מ ו נ ה - ע ש ר ה
שמחת-תורה	ש מ ח ת - ת ו ר ה
שמעק-פלעשעלע	ש מ ע ק - פ ל ע ש ע ל ע
שנאת-מות	ש נ א ת - מ ו ת
שניפּס	ש נ י פּ ס
שנײד	ש נ ײ ד
שנײד-מעסערס	ש נ ײ ד - מ ע ס ע ר ס
שעפּסען	ש ע פּ ס ע ן
שרײב	ש ר ײ ב
שראַנק	ש ר אַ נ ק
שװא	ש װ א
שװײגעניש	ש װ ײ ג ע נ י ש
שײבעל	ש ײ ב ע ל
שײנענדיגער	ש ײ נ ע נ ד י ג ע ר
שאַפּ	ש אַ פּ
שאַפּען	ש אַ פּ ע ן
שאָקאָלאַד-קאָליער	ש אָ ק אָ ל אַ ד - ק אָ ל י ע ר
שאָפּ	ש אָ פּ
שאָפּען-פּעלץ	ש אָ פּ ע ן - פּ ע ל ץ
שאָפּענע	ש אָ פּ ע נ ע
שפּחה	ש פּ ח ה
שפּיגעלט	ש פּ י ג ע ל ט
שפּיל-פּלאַץ	ש פּ י ל - פּ ל אַ ץ
שפּילען	ש פּ י ל ע ן
שפּינט	ש פּ י נ ט
שפּינערײען	ש פּ י נ ע ר ײ ע ן
שפּיעגעלט	ש פּ י ע ג ע ל ט
שפּיעל	ש פּ י ע ל
שפּיעלט	ש פּ י ע ל ט
שפּיעלען	ש פּ י ע ל ע ן
שפּיעען	ש פּ י ע ע ן
שפּיץ	ש פּ י ץ
שפּיצלעך	ש פּ י צ ל ע ך
שפּיצען	ש פּ י צ ע ן
שפּעזען	ש פּ ע ז ע ן
שפּעט	ש פּ ע ט
שפּעטסטען	ש פּ ע ט ס ט ע ן
שפּעטער	ש פּ ע ט ע ר
שפּער	ש פּ ע ר
שפּראך	ש פּ ר א ך
שפּרינגט	ש פּ ר י נ ג ט
שפּראַך	ש פּ ר אַ ך
שפּײז	ש פּ ײ ז
שפּײזען	ש פּ ײ ז ע ן
שפּײט	ש פּ ײ ט
שפּײכלער	ש פּ ײ כ ל ע ר
שפּײכשר	ש פּ ײ כ ש ר
שפּאַלט	ש פּ אַ ל ט
שפּאַלטען	ש פּ אַ ל ט ע ן
שפּאַנען	ש פּ אַ נ ע ן
שפּאַסען	ש פּ אַ ס ע ן
שפּאַציערט	ש פּ אַ צ י ע ר ט
שפּאַציערען	ש פּ אַ צ י ע ר ע ן
שפּאַצירט	ש פּ אַ צ י ר ט
שפּאַצירען	ש פּ אַ צ י ר ע ן
שפּאַציתן	ש פּ אַ צ י ת ן
שפּאַרען	ש פּ אַ ר ע ן
שפּאָר	ש פּ אָ ר
תורה	ת ו ר ה
װעגס	װ ע ג ס
װעיקטי	װ ע י ק ט י
װעכטער	װ ע כ ט ע ר
װעלטיג	װ ע ל ט י ג
װערימלע	װ ע ר י מ ל ע
װעש	װ ע ש
װאַטען	װ אַ ט ע ן
װאַרשױ	װ אַ ר ש ױ
װאָלקענ	װ אָ ל ק ע נ
אַ5	אַ 5
אַ8	אַ 8
אַחרונים	אַ ח ר ו נ י ם
אַנטפּלעקט	אַ נ ט פּ ל ע ק ט
אַרומגעכאַפּט	אַ ר ו מ ג ע כ אַ פּ ט
אַרומגעשלעפּט	אַ ר ו מ ג ע ש ל ע פּ ט
אַרומגעשפּאַציערט	אַ ר ו מ ג ע ש פּ אַ צ י ע ר ט
אַרומשלעפּען	אַ ר ו מ ש ל ע פּ ע ן
אַרונטדגע	אַ ר ו נ ט ד ג ע
אַרױסגעשפּראָצט	אַ ר ױ ס ג ע ש פּ ר אָ צ ט
אַרױסשלעפּען	אַ ר ױ ס ש ל ע פּ ע ן
אַרײגצושלעפּען	אַ ר ײ ג צ ו ש ל ע פּ ע ן
אַרײנגעכאַפּט	אַ ר ײ נ ג ע כ אַ פּ ט
אַרײנגעקלאַפּט	אַ ר ײ נ ג ע ק ל אַ פּ ט
אַראָפּ	אַ ר אָ פּ
אַראָפּגעגאנגען	אַ ר אָ פּ ג ע ג א נ ג ע ן
אַװעקשטופּענדיק	אַ װ ע ק ש ט ו פּ ע נ ד י ק
אַפּיקורס	אַ פּ י ק ו ר ס
אַפּיקורסות	אַ פּ י ק ו ר ס ו ת
אַפּנים	אַ פּ נ י ם
אָבגעברענטע	אָ ב ג ע ב ר ע נ ט ע
אָבגעשטופּט	אָ ב ג ע ש ט ו פּ ט
אָבפוהר	אָ ב פ ו ה ר
אָל	אָ ל
אָל-ראַיט	אָ ל - ר אַ י ט
אָנגעטשעפּעט	אָ נ ג ע ט ש ע פּ ע ט
אָנגעכאַפּט	אָ נ ג ע כ אַ פּ ט
אָנגעקלאַפּט	אָ נ ג ע ק ל אַ פּ ט
אָנגעקלאַפּטע	אָ נ ג ע ק ל אַ פּ ט ע
אָנגעשטאָפּט	אָ נ ג ע ש ט אָ פּ ט
אָנגעפּאַקט	אָ נ ג ע פּ אַ ק ט
אָקסען	אָ ק ס ע ן
אָרגען	אָ ר ג ע ן
אָאַ	אָ אַ
אָפּג	אָ פּ ג
אָפּגעגאַנגען	אָ פּ ג ע ג אַ נ ג ע ן
אָפּגעגאָלטע	אָ פּ ג ע ג אָ ל ט ע
אָפּגעהאַקט	אָ פּ ג ע ה אַ ק ט
אָפּגעזעסען	אָ פּ ג ע ז ע ס ע ן
אָפּגעטון	אָ פּ ג ע ט ו ן
אָפּגעלאָפען	אָ פּ ג ע ל אָ פ ע ן
אָפּגעמרט	אָ פּ ג ע מ ר ט
אָפּגעמאָסטען	אָ פּ ג ע מ אָ ס ט ע ן
אָפּגעקלונגען	אָ פּ ג ע ק ל ו נ ג ע ן
אָפּגערעדט	אָ פּ ג ע ר ע ד ט
אָפּגעשײדט	אָ פּ ג ע ש ײ ד ט
אָפּגעבּען	אָ פּ ג ע בּ ע ן
אָפּגרונד	אָ פּ ג ר ו נ ד
אָפּען	אָ פּ ע ן
אָפּרוהען	אָ פּ ר ו ה ע ן
בּעװאקסענע	בּ ע װ א ק ס ע נ ע
בּעװאָנסטע	בּ ע װ אָ נ ס ט ע
בּפּהמען	בּ פּ ה מ ע ן
כּלי	כּ ל י
כּנסת	כּ נ ס ת
פּ	פּ
פּא	פּ א
פּאות	פּ א ו ת
פּאותלעך	פּ א ו ת ל ע ך
פּאותלער	פּ א ו ת ל ע ר
פּאט	פּ א ט
פּאמעליך	פּ א מ ע ל י ך
פּאסט	פּ א ס ט
פּאסען	פּ א ס ע ן
פּודער	פּ ו ד ע ר
פּון	פּ ו ן
פּונקט	פּ ו נ ק ט
פּוסט	פּ ו ס ט
פּוסטער	פּ ו ס ט ע ר
פּוערים	פּ ו ע ר י ם
פּורים	פּ ו ר י ם
פּותר	פּ ו ת ר
פּחה	פּ ח ה
פּיהרען	פּ י ה ר ע ן
פּים	פּ י ם
פּין	פּ י ן
פּינקע	פּ י נ ק ע
פּיעטשע	פּ י ע ט ש ע
פּיקען	פּ י ק ע ן
פּלולגנ	פּ ל ו ל ג נ
פּלוצים	פּ ל ו צ י ם
פּלוצלונג	פּ ל ו צ ל ו נ ג
פּלוצלינגער	פּ ל ו צ ל י נ ג ע ר
פּלוצלעע	פּ ל ו צ ל ע ע
פּלוצמנג	פּ ל ו צ מ נ ג
פּליטה	פּ ל י ט ה
פּללונג	פּ ל ל ו נ ג
פּלעגט	פּ ל ע ג ט
פּלענער	פּ ל ע נ ע ר
פּלעצער	פּ ל ע צ ע ר
פּלױט	פּ ל ױ ט
פּלײצעס	פּ ל ײ צ ע ס
פּלאַץ	פּ ל אַ ץ
פּלאַצט	פּ ל אַ צ ט
פּלאָגען	פּ ל אָ ג ע ן
פּלאָכטען	פּ ל אָ כ ט ע ן
פּלאָצקער	פּ ל אָ צ ק ע ר
פּני-יהושע	פּ נ י - י ה ו ש ע
פּנים	פּ נ י ם
פּניםער	פּ נ י ם ע ר
פּנימער	פּ נ י מ ע ר
פּסוק	פּ ס ו ק
פּסח	פּ ס ח
פּסקנט	פּ ס ק נ ט
פּעחונען	פּ ע ח ו נ ע ן
פּעלץ	פּ ע ל ץ
פּעלצלעך	פּ ע ל צ ל ע ך
פּעלצען	פּ ע ל צ ע ן
פּעלצעןדפעלכלעך	פּ ע ל צ ע ן ד פ ע ל כ ל ע ך
פּעלצעןפעלכלעך	פּ ע ל צ ע ן פ ע ל כ ל ע ך
פּעלצענמאַכער	פּ ע ל צ ע נ מ אַ כ ע ר
פּען	פּ ע ן
פּעק	פּ ע ק
פּעקיך	פּ ע ק י ך
פּעקיל	פּ ע ק י ל
פּעקליך	פּ ע ק ל י ך
פּעקלעך	פּ ע ק ל ע ך
פּעקעל	פּ ע ק ע ל
פּעקעלעך	פּ ע ק ע ל ע ך
פּערזענליכקײט	פּ ע ר ז ע נ ל י כ ק ײ ט
פּעריל	פּ ע ר י ל
פּערל	פּ ע ר ל
פּערשעמט	פּ ע ר ש ע מ ט
פּרובט	פּ ר ו ב ט
פּרובען	פּ ר ו ב ע ן
פּרוטה	פּ ר ו ט ה
פּרובּירען	פּ ר ו בּ י ר ע ן
פּרינען	פּ ר י נ ע ן
פּרינציפּיעלע	פּ ר י נ צ י פּ י ע ל ע
פּריץ	פּ ר י ץ
פּריװאַטען	פּ ר י װ אַ ט ע ן
פּריװאַטקאַבּינעט	פּ ר י װ אַ ט ק אַ בּ י נ ע ט
פּרנסה	פּ ר נ ס ה
פּרעגט	פּ ר ע ג ט
פּרעטענזיע	פּ ר ע ט ע נ ז י ע
פּרעטענזיעס	פּ ר ע ט ע נ ז י ע ס
פּרעקטען	פּ ר ע ק ט ע ן
פּראַקטיק	פּ ר אַ ק ט י ק
פּראָטעסטירט	פּ ר אָ ט ע ס ט י ר ט
פּראָסט	פּ ר אָ ס ט
פּראָסטער	פּ ר אָ ס ט ע ר
פּראָשעניעס	פּ ר אָ ש ע נ י ע ס
פּשוט	פּ ש ו ט
פּשוטע	פּ ש ו ט ע
פּשוטען	פּ ש ו ט ע ן
פּשטעל	פּ ש ט ע ל
פּשער	פּ ש ע ר
פּשאַ	פּ ש אַ
פּױליש	פּ ױ ל י ש
פּױער	פּ ױ ע ר
פּױערטעס	פּ ױ ע ר ט ע ס
פּױערים	פּ ױ ע ר י ם
פּױערם	פּ ױ ע ר ם
פּױערס	פּ ױ ע ר ס
פּױערש	פּ ױ ע ר ש
פּײ	פּ ײ
פּײן	פּ ײ ן
פּײניגט	פּ ײ נ י ג ט
פּײערן	פּ ײ ע ר ן
פּאַטיע	פּ אַ ט י ע
פּאַטש	פּ אַ ט ש
פּאַטשט	פּ אַ ט ש ט
פּאַטשען	פּ אַ ט ש ע ן
פּאַלטאָס	פּ אַ ל ט אָ ס
פּאַמעליך	פּ אַ מ ע ל י ך
פּאַניע	פּ אַ נ י ע
פּאַס	פּ אַ ס
פּאַסט	פּ אַ ס ט
פּאַסיג	פּ אַ ס י ג
פּאַסירט	פּ אַ ס י ר ט
פּאַסען	פּ אַ ס ע ן
פּאַרע	פּ אַ ר ע
פּאַרשטאַנען	פּ אַ ר ש ט אַ נ ע ן
פּאַרװוּנדערט	פּ אַ ר װ וּ נ ד ע ר ט
פּאַראַד	פּ אַ ר אַ ד
פּאַשעט	פּ אַ ש ע ט
פּאַשען	פּ אַ ש ע ן
פּאַװאָלע	פּ אַ װ אָ ל ע
פּאַפּיער	פּ אַ פּ י ע ר
פּאַפּיערלעך	פּ אַ פּ י ע ר ל ע ך
פּאַפּיערען	פּ אַ פּ י ע ר ע ן
פּאָטע	פּ אָ ט ע
פּאָליצע	פּ אָ ל י צ ע
פּאָלניש	פּ אָ ל נ י ש
פּאָסטענס	פּ אָ ס ט ע נ ס
פּאָר	פּ אָ ר
תּלימפּערען	תּ ל י מ פּ ע ר ע ן