אַאַװע	אַהבֿה
אַאַװעס־האַבריִעס	אַהבֿת־הבריות
אַאַװעס־האַמאָקעם	אַהבֿת־המקום
אַאַװעס־ײִסראָעל	אַהבֿת־ישׂראל
אַאַװעס־נעפֿעש	אַהבֿת־נפֿש
אַאַװע־ראַבע	אַהבֿה־רבה
אַבוהאַװ	אַבוהבֿ —> מנורת־המאור: ר׳ יצחק אַבוהבֿ
אַבע	אַבא
אַגאָדע	אַגדה
אַגאָדעס	אַגדות —> אַגדה
אַגאַדעטע	אַגדתּא
אַגאַדעטעס	אַגדתּות —> אַגדתּא
אַגאָלע	עגלה
אַגאָלעס	עגלות —> עגלה
אַגודע	אַגודה
אַגודעס	אַגודות —> אַגודה
אַגודעניק	אַגודהניק
אַגודעניקעס	אַגודהניקעס —> אַגודהניק
אַגודעס־ײִסראָעל	אַגודת־ישׂראל
אַגונים	עגונים —> עגון
אַגונע	עגונה
אַגונעס	עגונות —> עגונה
אָגל־װעעסמעך	אָגיל־ואשׂמח
אָג־מײלעך־האַבאָשן	עוג־מלך־הבשן
אַגמעס־נעפֿעש	עגמת־נפֿש
אַגמעס־נעפֿעשן	עגמת־נפֿשן —> עגמת־נפֿש
אָגן	עגון
אַגעװ	אַגבֿ
אַגעװ־אורכע	אַגבֿ־אורחא
אַגעװ־אורכעדיק	אַגבֿ־אורחאדיק
אַד	עד
אָדאָם	אָדם
אַדאָמע	אַדמה
אַד־בלי־דײַ	עד־בלי־די
אַד־בעלי־דײַ	עד־בלי־די
אַד־גמירע	עד־גמירא
אַד־האַיאָם־האַזע	עד־היום־הזה
אַד־הײַעם	עד־היום
אַדױן־אױלעם	אַדון־עולם
אַדױני	אַדוני
אַדױנײנו מױרײנו װעראַבײנו	אַדוננו מורנו ורבנו —> אַדמו״ר
אַדױנים	אַדונים —> אָדון
אַדױנים־האַגדױלים	אַדונים־הגדולים —> אָדון־הגדול
אַדױשעם	ה׳
אַד־יאַאַװױר־זאַאַם	עד־יעבֿור־זעם
אַדײַעם	עד־היום
אַדיר	אַדיר
אַדירים	אַדירים —> אַדיר
אַד־כאַצי־האַמאַלכעס	עד־חצי־המלכות
אַד־כאָרמע	עד־חרמה
אַד־לאַפּאַק	עד־לפּ״ק
אַד־לאַשאָמאַיִם	עד־לשמים
אַד־ליפּראַט־קאָטן	עד־לפּרט־קטן —> עד־לפּ״ק
אַד־ליפּרוטע־קטאַנע	עד־לפּרוטה־קטנה —> עד־לפּ״ק
אַד־לעװ־האַשאָמאַיִם	עד־לבֿ־השמים
אַד־לעװ־שאָמאַיִם	עד־לבֿ־שמים
אַד־לעכעזשבם	עד־לחשבון
אַד־לעכעזשבן	עד־לחשבון
אַד־מאָסײַ	עד־מתי
אַדמאָר	אַדמו״ר
אַד־מײע־װעעסרים	עד־מאה־ועשׂרים
אַד־מײע־װעעסרים־שאָנע	עד־מאה־ועשׂרים־שנה
אָדן	אָדון
אָדן־בעפֿאָקדעכאָ	אָדון־בפֿקדך
אָדן־האַגאָדל	אָדון־הגדול
אַד־סאָף־קאָלהאַדױרעס	עד־סוף־כּל־הדורות
אָדעם	אָדם
אָדעם האָרישן	אָדם הראשון
אָדער	אָדר
אַדעראַבע	אַדרבה / אַדרבא
אַדעראַבע־װעאַדעראַבע	אַדרבה־ואַדרבה / ‎אַדרבא־ואַדרבא
אָדער אַלעף	אָדר א׳
אָדער בײס	אָדר ב׳
אָדער װײאָדער	אָדר ואָדר
אַד־קאַן	עד־כּאַן
אַד־קאַן אָמרים בעשאַבעס־האַגאָדל	עד־כּאַן אומרים בשבת־הגדול
אַד־קיקער־לעכעם	עד־כּיכּר־לחם
אַדראַבע	אַדרבה / אַדרבא
אַהאַװע	אַהבֿה
אַהאַװעס־האַבריִעס	אַהבֿת־הבריות
אַהאַװעס־האַמאָקעם	אַהבֿת־המקום
אַהאַװעס־ײִסראָעל	אַהבֿת־ישׂראל
אַהאַװעס־נעפֿעש	אַהבֿת־נפֿש
אַהאַװע־ראַבע	אַהבֿה־רבה
אָהאָלעס	אָהלות
או…	ו…
אובאָרים	עוברים —> עובר
אובער	עובר
אָװ 	אָבֿ
אָװ 	אָבֿ
אַװאָדים	עבֿדים —> עבֿד
אַװאָדים־האָיִנו	עבֿדים־הײנו
אַװאָדים־קנאַאַנים	עבֿדים־כּנענים —> עבֿד־כּנעני
אַװאָדים־קנײַנים	עבֿדים־כּנענים —> עבֿד־כּנעני
אָװאַדיע	עבֿדיה
אַװאַדע	אַװדאי
אַװאָנים־טױװעס	אבֿנים־טובֿות —> אבֿן־טובֿ
אַװ־בעזדן	אַבֿ־בית־דין
אַװ־בעזן	אַבֿ־בית־דין
אַװדעס	עבֿדות
אָװדע־קױכאָװים־אומאַזאָלעס	עובֿדי־כּוכבֿים־ומזלות —> עובֿד־כּוכבֿים־ומזלות
אַװ־האָראַכמים	אַבֿ־הרחמים
אוּװדע	עובֿדהû / עובֿדאý
אוּװדעס	עובֿדות —> עובֿדהû / עובֿדאý
אַװױדע	עבֿודה
אַװױדעס	עבֿודות —> עבֿודה
אַװױדע־בזוּיע	עבֿודה־בזױה
אַװױדע־זאָרע	עבֿודה־זרה
אַװױדע־זאָרעס	עבֿודה־זרהס —> עבֿודה־זרה
אַװױדעס־בזוּיעס	עבֿודות־בזױות —> עבֿודה־בזױה
אַװױדעס־האַבױרע	עבֿודת־הבורא
אַװױדעס־האַקױדעש	עבֿודת־הקודש
אַװױדעס־האַשעם	עבֿודת־השם
אַװױדעס־פּערעך	עבֿודת־פּרך
אַװױנעס	עװנות —> עװן
אוּװכײן	ובֿכן
אַװי־אַװאָס־האַטומע	אַבֿי־אַבֿות־הטומאה
אַװיגדער	אַבֿיגדור
אַװײדע	אַבֿדה
אַװײדעס	אַבֿדות —> אַבֿדה
אַװײלים	אַבֿלים —> אָבֿל
אַװײלעס	אַבֿלות
אַװי־יעסױמים	אַבֿי־יתומים
אַװײרע	עבֿירה
אַװײרעס	עבֿירות —> עבֿירה
אַװײרעס שעבײן־אָדעם־לאַמאָקעם	עבֿירות שבין־אָדם־למקום
אַװײרעס שעבײן־אָדעם־לעכאַװײרע	עבֿירות שבין־אָדם־לחבֿרו
אָװינו־מאַלקײנו	אָבֿינו־מלכּנו
אַװישאָלעם	אַבֿישלום
אָװל	אָבֿל
אָװל־װאַכאַפֿוּי־ראָש	אָבֿל־וחפֿױ־ראָש
אָװלטע	אָבֿלטע
אָװלטעס	אָבֿלטעס —> אָבֿלטע
אַװלע	עװלה
אַװלעס	עװלות —> עװלה
אָװן	עװן
אַװנע־נעגעף	אבֿני־נגף —> אבֿן־נגף
אָװעס	אָבֿות
אָװעס־אַװױסאָװ	אָבֿות־אַבֿותיו
אָװעס־אַװױסײנו	אָבֿות־אַבֿותינו
אַװער	אַװיר
אָװער	עבֿר
אָװער־זמאַן	עבֿר־זמן
אַװערן	אַװירן
אַװערסט	אַװירסט —> אַװירן
אַװערט	אַװירט —> אַװירן
אַװערנדיק	אַװירנדיק —> אַװירן
געאַװערט	געאַװירט —> אַװירן
אַװראָהאָם אָװינו	אַבֿרהם אָבֿינו
אַװראָם	אַבֿרהם
אַװראָם אָװינו	אַבֿרהם אָבֿינו
אַװרעמל	אַבֿרהמל  —> אַבֿרהם
אַװשאָלעם	אַבֿשלום
אױדעף	עודף
אױהאָלים	אוהלים —> אוהל
אױהעװ־בעצע	אוהבֿ־בצע
אױהעװ־ײִסראָעל	אוהבֿ־ישׂראל
אױהעװע־ײִסראָעל	אוהבֿי־ישׂראל —> אוהבֿ־ישׂראל
אױהעל	אוהל
אױװעד־קױכאָװים־אומאַזאָלעס	עובֿד־כּוכבֿים־ומזלות
אױװער	עובֿר —> עובֿר זײַן
אױװער־אוּװאָטל	עבֿר־ובֿטל
אױװער־אַל־דאַס	עובֿר־על־דת
אױװערבאָטל 	עובֿר־בטל
אױװערבאָטעלן	עובֿר־בטלן —> עובֿר־בטל
אױװערבאָטעלע	עובֿר־בטלע —> עובֿר־בטל
אױװערבאָטעלער	עובֿר־בטלער —> עובֿר־בטל
אױװערבאָטל 	עובֿר־בטל
אױװערבאָטלס	עובֿר־בטלס —> עובֿר־בטל
אױװערבאָטלניצע	עובֿר־בטלניצע
אױװערבאָטלניצעס	עובֿר־בטלניצעס —> עובֿר־בטלניצע
אױװערבאָטלניק	עובֿר־בטלניק
אױװערבאָטלניקעס	עובֿר־בטלניקעס —> עובֿר־בטלניק
אױװער־באָטל 	עובֿר־בטל
אױװער־באָטעלן	עובֿר־בטלן —> עובֿר־בטל
אױװער־באָטעלע	עובֿר־בטלע —> עובֿר־בטל
אױװער־באָטעלער	עובֿר־בטלער —> עובֿר־בטל
אױװער־באָטל 	עובֿר־בטל
אױװער־באָטלס	עובֿר־בטלס —> עובֿר־בטל
אױװער־באָטלניצע	עובֿר־בטלניצע
אױװער־באָטלניצעס	עובֿר־בטלניצעס —> עובֿר־בטלניצע
אױװער־באָטלניק	עובֿר־בטלניק
אױװער־באָטלניקעס	עובֿר־בטלניקעס —> עובֿר־בטלניק
אױװער־לעסױכער	עובֿר־לסוחר
אױװער־קרישמע	עובֿר־קריאת־שמע —> עובֿר־קריאת־שמע זײַן
אױװער־שװוּע	עובֿר־שבֿועה —> עובֿר־שבֿועה זײַן
אױזער	עוזר
אױכער־ײִסראָעל	עוכר־ישׂראל
אױלאָמעס	עולמות —> עולם
אױלים	עולים —> עולה
אױלע 	עולה
אױלע 	עולה
אױלע 	עולה —> עולה זײַן
אױלע־טמימע	עולה־תּמימה
אױלע־יאָפֿע	עולה־יפֿה —> עולה־יפֿה זײַן
אױלע־לאַטױרע	עולה־לתּורה —> עולה־לתּורה זײַן
אױלע־ליגדולע	עולה־לגדולה —> עולה־לגדולה זײַן
אױלעם 	עולם
אױלעם 	עולם
אױלעם־אומלױע	עולם־ומלואו
אױלעם־גױלעם	עולם־גולם
אױלעם־האָאַצילעס	עולם־האַצילות
אױלעם־האַבע	עולם־הבא
אױלעם־האַדימיען	עולם־הדמיון
אױלעם־האַזימרע	עולם־הזימרה
אױלעם־האַזע	עולם־הזה
אױלעם־האַזעניצע	עולם־הזהניצע
אױלעם־האַזעניצעס	עולם־הזהניצעס —> עולם־הזהניצע
אױלעם־האַזעניק	עולם־הזהניק
אױלעם־האַזעניקעס	עולם־הזהניקעס —> עולם־הזהניק
אױלעם־האַטאַכטן	עולם־התּחתּון
אױלעם־האַטױע	עולם־התּוהו
אױלעם־האַנעגינע	עולם־הנגינה
אױלעם־האָעליען	עולם־העליון
אױלעם־האָעמעס	עולם־האמת
אױלעם־האָפֿעך	עולם־הפֿוך
אױלעם־האַצאַכצאָכעס	עולם־הצחצחות
אױלעם־האַשאָפֿל	עולם־השפֿל
אױלעם־האַשעקער	עולם־השקר
אױלעם־מאָלע	עולם־מלא
אױלעם־עליען	עולם־עליון
אױלעמעס 	עולמות —> עולם
אױלעמעס 	עולמות
אױלעמעס־האָעליױנים	עולמות־העליונים —> עולם־העליון
אױלעמעס־עליױנים	עולמות־עליונים —> עולם־עליון
אױלעם־קאָטן	עולם־קטן
אױלעס	עולות —> עולה
אױלע־רעגל	עולה־רגל —> עולה־רגל זײַן
אױמעד־אַל־דאַטע	עומד־על־דעתּו
אױמעד־בעדיבורע	עומד־בדיבורו
אױמעד־בעמירדע	עומד־במרדו
אױמעד־בעניסױען	עומד־בנסיון —> עומד־בנסיון זײַן
אױמער	עומר
אױמער־װעױסע	אומר־ועושׂה
אױנעג	עונג
אױנעג־רוכני	עונג־רוחני
אױנעג־שאַבעס	עונג־שבת
אױנעס	אונס
אױנעש	עונש
אױסבאַטלען	אױסבטלען
אױסגעבאַטלט	אױסגעבטלט —> אױסבטלען
אױסבאַטלענדיק	אױסבטלענדיק —> אױסבטלען
אױסטײַנען	אױסטענהן —> אױסטענהן זיך
אױסגעטײַנעט	אױסגעטענהט —> אױסטענהן זיך
אױסטײַנענדיק	אױסטענהנדיק —> אױסטענהן זיך
אױסיעס	אותיות —> אות
אױסיעס מאַכקימעס	אותיות מחכּימות
אױסיעס־מערובאָעס	אותיות־מרובעות
אױססאַדערן	אױססדרן
אױסגעסאַדערט	אױסגעסדרט —> אױססדרן
אױססאַדערנדיק	אױססדרנדיק —> אױססדרן
אױסע־איש	אותו־איש
אױסע־האָיִש	אותו־האיש
אױסע־האַמאָקעם	אותו־המקום
אױסע־מאָקעם	אותו־מקום
אױסעס־אומאָפֿסים	אותות־ומופֿתים
אױסעק	עוסק —> עוסק זײַן
אױסעק־בעמיצװע	עוסק־במיצװה
אױסעק־בעצאָרכע־ציבער	עוסק־בצרכי־ציבור
אױסע־רעגע	אותו־רגע
אױסע־שאָלעם	עושׂה־שלום
אױסע־שאָלעם־בימרױמאָװ	עושׂה־שלום־במרומיו
אױסשײגעצן	אױסשגצן
אױעװ־בעצע	אוהבֿ־בצע
אױעװ־ײִסראָעל	אוהבֿ־ישׂראל
אױעװע־ײִסראָעל	אוהבֿי־ישׂראל —> אוהבֿ־ישׂראל
אױעל	אוהל
אױפֿאַנים 	אופֿנים —> אופֿן
אױפֿאַנים 	אופֿנים
אױפֿן	אופֿן
אױפֿעס	עופֿות —> עוף
אױפֿעס־טמעיִם	עופֿות־טמאים
אױפֿעס־טעהױרים	עופֿות־טהורים
אױצער	אוצר
אױצרעס	אוצרות —> אוצר
אױקעץ	עוקץ
אױקער	עוקר —> עוקר זײַן
אױקער־האָרים	עוקר־הרים
אױקער־מין־האַשױרעש	עוקר־מן־השורש —> עוקר־מן־השורש זײַן
אױר	אור
אױר־האַגאָנעז	אור־הגנוז
אױרעך	אורח
אױרעך־האָגן	אורח־הגון
אױרעכטע	אורחטע
אױרעכטעס	אורחטעס —> אורחטע
אױרעך־כאַיִם	אורח־חײם
אױשער	עושר
אוכדױמע	וכדומה
אולײַ־יעראַכעם	אולי־ירחם
אולמײַ נאַפֿקע־מינע	ולמאַי נפֿקא־מינה
אומבעטאַרבעסדיק	אומבתּרבותדיק
אומבעטאַרבעסדיקן	אומבתּרבותדיקן —> אומבתּרבותדיק
אומבעטאַרבעסדיקע	אומבתּרבותדיקע —> אומבתּרבותדיק
אומבעטאַרבעסדיקער	אומבתּרבותדיקער —> אומבתּרבותדיק
אומבעראַכמאָנעסדיק	אומברחמנותדיק
אומבעראַכמאָנעסדיקן	אומברחמנותדיקן —> אומברחמנותדיק
אומבעראַכמאָנעסדיקע	אומברחמנותדיקע —> אומברחמנותדיק
אומבעראַכמאָנעסדיקער	אומברחמנותדיקער —> אומברחמנותדיק
אומכײן	אומחן
אומנעס	אומנות
אומנעסן	אומנותן —> אומנות
אומע	אומה
אומע־װעלאָשן	אומה־ולשון
אומען	אומן
אומען־יאַד	אומן־יד
אומעס	אומות —> אומה
אומעס־האָױלעם	אומות־העולם
אונטערגאַנװענען	אונטערגנבֿענען —> אונטערגנבֿענען זיך
אונטערגעגאַנװעט	אונטערגעגנבֿעט —> אונטערגנבֿענען זיך
אונטערגאַנװענענדיק	אונטערגנבֿענענדיק —> אונטערגנבֿענען זיך אונטערקאָל	אונטערקול
אונסאַנע־טױקעף	ונתנה־תּוקף
אוקצין	עוקצין
אורװע פּאָרעך	עורבֿא פּרח
אורים־װעטומים	אורים־ותּומים
אוריִעל	אוריאל
אושפּיזן	אושפּיזין
אַזאָזל	עזאזל
אַזהאָרע	אַזהרה
אַזהאָרעס	אַזהרות —> אַזהרה
אַזױװ־טאַזױװ	עזובֿ־תּעזובֿ
אָז־יאָשער	אָז־ישיר
אַזעס	עזות
אַזעס־מעכוצעף־פּאָנעם	עזות־מחוצף־פּנים
אַזעס־פּאָנעם	עזות־פּנים
אַזעס־פּאָנעמטע	עזות־פּנימטע
אַזעס־פּאָנעמטעס	עזות־פּנימטעס —> עזות־פּנימטע
אַזעס־פּענעמער	עזות־פּנימער —> עזות־פּנים
אַזריִעל	עזריאל
אַטאָ	אַתּה
אַטאָ־בעכאַרטאָנו	אַתּה־בחרתּנו
אַטאָ־בעכאַרטאָנוניק	אַתּה־בחרתּנוניק
אַטאָ־בעכאַרטאָנוניקעס	אַתּה־בחרתּנוניקעס —> אַתּה־בחרתּנוניק
אַטאָ־האָרײסאָ	אַתּה־הראית
אַטאָ־װעכאַרטאָנו	אַתּה־בֿחרתּנו
אַטאָרע	עטרה
אַטאָרעס	עטרות —> עטרה
אַטיקע	עתּיקא
אַטע	אַתּה
אַטעק־יױמין	עתּיק־יומין
איבן־פּעקודע	אבן־פּקודה —> חובֿות־הלבֿבֿות
איבעד	איבוד
איבער	עיבור
איבער־יאָר	עיבור־יאָר
איבערכאַזערן 	איבערחזרן
איבערכאַזערן 	איבערחזרן —> איבערחזרן זיך
איבערגעכאַזערט	איבערגעחזרט —> איבערחזרן (זיך)
איבערכאַזערנדיק	איבערחזרנדיק —> איבערחזרן (זיך)
איגולים	עיגולים —> עיגול
איגל	עיגול
איװריט	עבֿריתּ
איװרע	עבֿרי
איװרע־טײַטש	עבֿרי־טײַטש
איזאָװן	עזבֿון
איזװױנעס	עזבֿונות —> עזבֿון
איזרעעל	יזרעאל —> עמק
אײבערהאַזבאָרע	אײבערהסברה
אײבערהאַזבאָרעס	אײבערהסברות —> אײבערהסברה
אײבערהאַסבאָרע	אײבערהסברה
אײבערהאַסבאָרעס	אײבערהסברות —> אײבערהסברה
אײבערקאָל	אײבערקול
אײגל	עגל
אײגל־האַזאָהעװ	עגל־הזהבֿ
אײד	עד
אײדוּיעס	עדױות
אײדים	עדים —> עד
אײד־מיפּי־אײד	עד־מפּי־עד
אײדע	עדה
אײדעס 	עדות —> עדה
אײדעס 	עדות
אײדעסטע	עדותטע
אײדעסטעס	עדותטעס —> עדותטע
אײדעסן	עדותן —> עדותן זיך
אײדעסט	עדותט —> עדותן זיך
געײדעסט	געעדותט —> עדותן זיך
געאײדעסט	געעדותט —> עדותן זיך
אײדעסנדיק	עדותנדיק —> עדותן זיך
אײדעסשאַפֿט	עדותשאַפֿט
אײדעסשאַפֿטן	עדותשאַפֿטן —> עדותשאַפֿט
אײדע־ריִע	עדי־ראיה —> עד־ראיה
אײד־ריִע	עד־ראיה
אײװל־װעסוגע	אבֿל־ותוגה
אײװער	אבֿר
אײװער־מין־האַכײַ	אבֿר־מן־החי
אײװרים	אבֿרים —> אבֿר
אײזער־קענעגדע	עזר־כּנגדו
אײכע	איכה
אײכעס	איכות
אײל	אל
אײל־מאָלע־ראַכמים	אל־מלא־רחמים
אײל־נעקאָמעס	אל־נקמות
אײלע טאָלדעס	אלה תּולדות
אײַלעניס	אַילונית
אײַלעניסן	אַילוניתן —> אַילונית
אײל־ראַכום־װעכאַנון	אל־רחום־וחנון
אײמע	אימה
אײמעס־מאָװעס	אימת־מװת
אײמעסע־דעציבורע	אימתא־דציבורא
אײמעק	עמק
אײמעק־איזרעעל	עמק־יזרעאל —> עמק
אײמעק־האַבאָכע	עמק־הבכה
אײן	אין
אײן אױנעס	אין אונס
אײן אײצע װעײן טװוּנע	אין עצה ואין תּבֿונה
אײנאַיִם	עינים
אײן־באַיִס	אין־בית
אײן־ברײרע	אין־ברירה
אײַנגעכױשעכט	אײַנגעחושכט
אײַנגעכױשעכטן	אײַנגעחושכטן —> אײַנגעחושכט
אײַנגעכױשעכטע	אײַנגעחושכטע —> אײַנגעחושכט
אײַנגעכױשעכטער	אײַנגעחושכטער —> אײַנגעחושכט
אײנהאָרעניצע	עין־הרעניצע
אײנהאָרעניצעס	עין־הרעניצעס —> עין־הרעניצע
אײנהאָרעניק	עין־הרעניק
אײנהאָרעניקעס	עין־הרעניקעס —> עין־הרעניק
אײן־יאַנקעװ	עין־יעקבֿ
אײן יױצע װעײן באָ	אין יוצא ואין באָ
אײַנכאַזערן	אײַנחזירן
אײַנגעכאַזערט	אײַנגעחזירט —> אײַנחזירן
אײַנכאַזערנדיק	אײַנחזירנדיק —> אײַנחזירן
אײן כאָכמע װעײן טװוּנע נעגעד	אין חכמה ואין תּבֿונה נגד
אײן־לי	אין־לי
אײן־לעשאַער	אין־לשער
אײן־לעשאַער װעײן־לעסאַפּער	אין־לשער ואין־לספּר
אײן מאַזל לעײִסראָעל	אין מזל לישׂראל
אײנסאָף	אין־סוף
אײן־סאָף	אין־סוף
אײנע־ײִסראָעל	אינו־ישׂראל
אײנענו	איננו
אײנע־נירע	אינו־ניראה
אײנע־נירעס	אינו־ניראהס —> אינו־ניראה
אײן קאָל װעײן אױנע	אין קול ואין עונה
אײס־כעדװע	עת־חדװה
אײס־לאַאַסױס	עת־לעשׂות
אײסעװ	עשׂו
אײסעק	עסק
אײסעקן	עסקן —> עסקן זיך
אײס־צאָרע	עת־צרה
אײס־צאָרע־לעיאַנקעװ	עת־צרה־ליעקבֿ
אײס־ראָצן	עת־רצון
}אײַען 	ע‎
אײַען 	עין
אײפֿעד	אפֿוד
אײפֿעלע	עופֿעלע
אײפֿעלעך	עופֿעלעך —> עופֿעלע
אײץ־האַדאַאַס	עץ־הדעת
אײץ־האַכאַיִם	עץ־החײם
אײצים־װעיִלאָנעס	עצים־ואילנות
אײץ־כאַיִם	עץ־חײם
אײצע	עצה
אײצע־טױװע	עצה־טובֿה
אײצען 	עצהן
אײצעסט	עצהסט —> עצהן
אײצעט	עצהט —> עצהן
געאײצעט	געעצהט —> עצהן
געײצעט	געעצהט —> עצהן
אײצענדיק	עצהנדיק —> עצהן
 אײצען 	עצהן —> עצהן זיך
אײצעס	עצות —> עצה
אײקעװ	עקבֿ
אײרוּװים	עירובֿים —> עירובֿ
אײרוּװן	עירובֿין
אײרוּװין	עירובֿין
אײרעװ	עירובֿ
אײרעװן	עירובֿן —> עירובֿ
אײרעװ־טאַװשילין	עירובֿ־תּבֿשילין
אײרעװ־טאַפֿשילן	עירובֿ־תּבֿשילין
אײרעװ־טכומין	עירובֿ־תּחומין
אײרעװ־טכומען	עירובֿ־תּחומין
אײש־לעהאָװע	אש־להבֿה
אײשעס־איש	אשת־איש
אײשעס־אישניצע	אשת־אישניצע
אײשעס־אישניצעס	אשת־אישניצעס —> אשת־אישניצע
אײשעס־אישניק	אשת־אישניק
אײשעס־אישניקעס	אשת־אישניקעס —> אשת־אישניק
אײשעס־כאַיִל	אשת־חיל
אילױִם	עילוײם —> עילױ
אילױִש	עילוײִש
אילױִשן	עילוײִשן —> עילוײִש
אילױִשע	עילוײִשע —> עילוײִש
אילױִשער	עילוײִשער —> עילוײִש
אילע	עילױ
אים 	אם
אים 	עם
אימאָנועל	עמנואל
אימאָעס	אמהות
אים־ײִרצע־האַשעם	אם־ירצה־השם
אים לױ אַכשאָװ אײמאָסײַ	אם לא עכשיו אימתי
אים לױ יאָיִל לױ יאַזיק	אם לא יועיל לא יזיק
אים־קאָל־האַנעאָרים	עם־כּל־הנערים
אימקײן	אם־כּן
אַיִן־בעאַיִן	עין־בעין
אינױִם	עינוײם —> עינױ
אינױִם־קאָשים	עינוײם־קשים
אַיִן טאַכעס אַיִן	עין תּחת עין
איניאָנים	ענינים —> ענין
איניען	ענין
אינע	עינױ
איסאָמער	איתמר
איסורים	איסורים —> איסור
איסיִיִ	איסײ
איסיִיִם	איסײם —> איסײ
איסער 	איסור
איסער 	איסר
איסרע־כאַג	איסרו־חג
איִעװ	איובֿ
איִעװ־בסורע	איובֿ־בשׂורה
איִעװ־בסורעס	איובֿ־בשׂורות —> איובֿ־בשׂורה
איִעװ־פּסורע	איובֿ־בשׂורה
איִעװ־פּסורעס	איובֿ־בשׂורות —> איובֿ־בשׂורה
איִער	אײר
איפּכע־מיסטאַברע	איפּכא־מסתּברא
איפּכע־מיסטאַברעניק	איפּכא־מסתּבראניק
איפּכע־מיסטאַברעניקעס	איפּכא־מסתּבראניקעס —> איפּכא־מסתּבראניק
איפּכע־מיסטאַברעניצע	איפּכא־מסתּבראניצע —> איפּכא־מסתּבראניק
איפּכע־מיסטאַברעניצעס	איפּכא־מסתּבראניצעס —> איפּכא־מסתּבראניק
איפּעש	עיפּוש
איצטעלע־דעראַבאָנען	איצטלא־דרבנן
איקוּװים	עיכּובֿים —> עיכּובֿ
איקעװ	עיכּובֿ
איקער	עיקר
איקער־	עיקר־
איקער־האָיִקרים	עיקר־העיקרים
איקער־האַמײַסע	עיקר־המעשׂה
איקער־שאָכאַכטי	עיקר־שכחתּי
איקרים	עיקרים —> עיקר
איר־האַבירע	עיר־הבירה
איר־האַמיקלעט	עיר־המיקלט
איר־האַמלוכע	עיר־המלוכה
איר־האַמעלוכע	עיר־המלוכה
אירװוּװיע	ערבֿובֿיה
איר־װעײם	עיר־ואם
איר־װעײם־בעיִסראָעל	עיר־ואם־בישׂראל
איר־מיקלעט	עיר־מיקלט
איש	איש
איש־יאָשער	איש־ישר
איש־כאָשעװ	איש־חשובֿ
איש־מעהײמען	איש־מהימן
איש־מעפּי־איש	איש־מפּי־איש
אישע	אישה
אישע־צנוע	אישה־צנועה
אַכאַד־האָאָם	אַחד־העם
אַכאָװ	אַחאָבֿ
אַכאַס־װעאַכאַס	אַחת־ואַחת
אַכאַשװײרעש	אַחשװרוש
אַכאַשטראָנים	אַחשתּרנים
אַכבאָרים	עכברים —> עכבר
אַכבער	עכבר
אַכבעראָש	עכבראָש
אַכבעראָשים	עכבראָשים —> עכבראָש
אַכדעס	אַחדות
אַכדעס־האַבױרע	אַחדות־הבורא
אַכױראַיִם	אַחורײם —> אָחור
אַכוץ	אַחוץ
אַכזאָרים	אַכזרים —> אַכזר
אַכזאָריעס	אַכזריות
אַכזער	אַכזר
אָכי	אָחי
אַכיזע	אַחיזה
אַכיזעס	אַחיזות —> אַחיזה
אַכיזעס־אײנאַיִם	אַחיזת־עינים
אַכײנו־בנײ־ײִסראָעל	אַחינו־בני־ישׂראל
אַכילע	אַכילה
אַכילע־אושטיִע	אַכילה־ושתּיה
אַכים־לעצאָרע	אַחים־לצרה —> אָח־לצרה
אַכלאָנים	אַכלנים —> אַכלן
אַכלען 	אַכלן
אַכלען 	אַכלען
אַכל	אַכל —> אַכלען
אַכלסט	אַכלסט —> אַכלען
אַכלט	אַכלט —> אַכלען
געאַכלט	געאַכלט —> אַכלען
אַכלענדיק	אַכלענדיק —> אַכלען
אָך־לעצאָרע	אָח־לצרה
אַכסאַניע	אַכסניאû / אַכסניהý
אַכסאַניעס	אַכסניות —> אַכסניא
אָכער	אָחור
אַכער	אַחר
אַכער־האַמײַסע	אַחר־המעשׂה
אַכער־מײע־שאָנים	אַחר־מאה־שנים
אָכערס	אָחורס —> אָחור
אַכרױנים	אַחרונים —> אַחרון
אַכרײ־מױס	אַחרי־מות
אַכרײַעס	אַחריות
אַכרײ־קיכלױס־האַקל	אַחרי־כּכלות־הכּל
אַכרען	אַחרון
אַכרען אַכרען כאָװיװ	אַחרון אַחרון חבֿיבֿ
אַכרען־שעל־פּײסעך	אַחרון־של־פּסח
אַכרעס־האַיאָמים	אַחרית־הימים
אַל 	אַל
אַל 	על
אָל	עול
אָלן	עולן —> עול
אַלאַכסן	אַלכסון
אַלאַכסנס	אַלכסונס —> אַלכסון
אַלאַכעס־קאַמע־װעקאַמע	על־אַחת־כּמה־וכּמה
אַלאָס־האַשאַכער	עלות־השחר
אַל־אַפּי װעאַל־כאַמאָסי	על־אַפּי ועל־חמתי
אַל־אַפּע װעאַל־כאַמאָסע	על־אַפּו ועל־חמתו
אַל־אַפּעם װעאַל־כאַמאָסעם	על־אַפּם ועל־חמתם
אַלאָפֿים	אַלפֿים —> אלף
אַל דאַאַטײפֿט אַטפֿוך	על דאַטפֿתּ אַטפֿוך
אַלדאַאַס־	על־דעת־
אַל־דאַאַס־	על־דעת־
 אַלדאַאַס־אַצמע	על־דעת־עצמו
אַל־דאַאַס־אַצמע	על־דעת־עצמו
אַל־האַטױרע װעאַל־האָאַװױדע	על־התּורה ועל־העבֿודה
אַל־האָײצים װעאַל־האָאַװאָנים	על־העצים ועל־האַבֿנים
אַל־האָײצים װעאַל־האַבײצים	על־העצים ועל־הביצים
אַל־האַניסים	על־הנסים
אַל־האַשעם װעאַל־מעשיכע	על־ה׳ ועל־משיחו
אַלופֿים	אַלופֿים —> אַלוף
אַל טאַשליכײנו לעײס־זיקנע	אַל תּשליכנו לעת־זיקנה
אַל טיסטאַקל בעקאַנקן	אַל תּסתּכּל בקנקן
אַל טיפֿטאַך פּע לאַסאָטן	אַל תּפֿתּח פּה לשׂטן
אַלטנײַ	על־תּנאַי
אַל־טנײַ	על־תּנאַי
אָלײַ װעאַל צאַװאָרי	עלי ועל צװאָרי
אַלײכעם־װעאַל־בנײכעם	עליכם־ועל־בניכם
אַלײכעם־שאָלעם	עליכם־שלום
אָלײנו	עלינו
אַלײעם־האַשאָלעם	עליהם־השלום
אַלילעס־דאַם	עלילת־דם
אַלילעס־שאָװ	עלילת־שוא
אַליִע	עליה
אַליִעס	עליות —> עליה
אַליִעס־נעשאָמע	עלית־נשמה
אַל־כעזשבױנע	על־חשבונו
אַל־כעזשבם	על־חשבון
אַל־כעזשבן	על־חשבון
אַלכעט (שעכאָטאָסי)	על־חטא (שחטאָתי)
אָל־מאַלכעס־שאָמאַיִם	עול־מלכות־שמים
אַלמאָנע	אַלמנה
אַלמע־דיקשױט	עלמא־דקשוט
אַלמען	אַלמן
אַל־מענאַס לעהאַכזער	על־מנת להחזיר
אַל־מענאַס לעקאַבל פּראַס	על־מנת לקבל פּרס
אַל־מענאַס שעלױ לעקאַבל פּראַס	על־מנת שלא לקבל פּרס
אָלעהאַשאָלעם	עליה־השלום
אָלעװאַשאָלעם	עליו־השלום
אָלעװ־האַשנאָבל	עליו־השנאָבל
אַלעװײַ	הלװאַי
אָלעל	עלול
אַלעמײַ	אַלמאַי
אַלעף	א
אַלעף	אַלוף
אַלעף	אַלף
אַלעפֿבײס	אַלף־בית
אַלעקסאַנדער	אַלכּסנדר
אַלעקסאַנדער מאָקדן	אַלכּסנדר מוקדון
אָלעשאָלעם	עליה־השלום
אַל־פּאָראָשעס־דראָכים	על־פּרשת־דרכים
אָל־פּאַרנאָסע	עול־פּרנסה
אַלפּי	על־פּי
אַלפּי־גױרל	על־פּי־גורל
אַלפּי־דין	על־פּי־דין
אַלפּי־דינײהעם	על־פּי־דיניהם
אַלפּי־דערעך־האַטעװע	על־פּי־דרך־הטבֿע
אַלפּי־האַטכאַק	על־פּי־הדחק
אַלפּי־טאָעס	על־פּי־טעות
אַלפּי־יױשער	על־פּי־יושר
אַלפּי־כקירע	על־פּי־חקירה
אַלפּי־מיקרע	על־פּי־מיקרה
אַלפּי־נעס	על־פּי־נס
אַלפּי־סװאָרע	על־פּי־סבֿרה
אַלפּי־סײכל	על־פּי־שׂכל
אַלפּי־פּשאַט	על־פּי־פּשט
אַלפּי־ראָװ	על־פּי־רובֿ
אַלפּי־רעמעז	על־פּי־רמז
אַל־פּי	על־פּי
אַל־פּי־גױרל	על־פּי־גורל
אַל־פּי־דין	על־פּי־דין
אַל־פּי־דינײהעם	על־פּי־דיניהם
אַל־פּי־דערעך־האַטעװע	על־פּי־דרך־הטבֿע
אַל־פּי־האַטכאַק	על־פּי־הדחק
אַל־פּי־טאָעס	על־פּי־טעות
אַל־פּי־יױשער	על־פּי־יושר
אַל־פּי־כקירע	על־פּי־חקירה
אַל־פּי־מיקרע	על־פּי־מיקרה
אַל־פּי־נעס	על־פּי־נס
אַל־פּי־סװאָרע	על־פּי־סבֿרה
אַל־פּי־סײכל	על־פּי־שׂכל
אַל־פּי־פּשאַט	על־פּי־פּשט
אַל־פּי־ראָװ	על־פּי־רובֿ
אַל־פּי־רעמעז	על־פּי־רמז
אַל־פּע	על־פּה
אַלפֿײ־אַלאָפֿים	אַלפֿי־אַלפֿים
אַלצאַד־האַיױסערטאָװ	על־צד־היותר־טובֿ
אַלקאָלפּאָנעם	על־כּל־פּנים
אַל קאָל צאָרע שעלױ־סאָװױ	על כּל צרה שלא־תבֿוא
אַלקידעש־האַשעם	על־קידוש־השם
אַלקײן	על־כּן
אַלקלפּאָנעם	על־כּל־פּנים
אַלקן	על־כּן
אַל־קערן־האַצװי	על־קרן־הצבֿי
אַל רישן רישן װעאַל אַכרען אַכרען	על ראשון ראשון ועל אַחרון אַחרון
אַל־רעגל־אַכעס	על־רגל־אַחת
אַם	עם
אַמאָלײקים	עמלק
אַמאָלעק	עמלק
אָמאַר	אָמר
אַמאָרעץ	עם־האָרץ
אַמאָרעץ־דעױרײַסאָ	עם־האָרץ־דאורײַתא
אַם־האַסײפֿער	עם־הספֿר
אַמודים	עמוד
אַמױן	עמון
אַמױראָיִם	אַמורא
אַמױרע	אַמורא
אָמײן	אָמן
אָמײן־סעלאָ	אָמן־סלה
אָמײן פֿכײן יעהי ראָצן	אָמן וכן יהי רצון
אַם ײִסראָעל כײַ	עם ישׂראל חי
אַמכאָ	עמך
אַם־כאָכעם־װענאָװן	עם־חכם־ונבֿון
אַמנען	אַמנון
אָמעד	עמוד
אַמעד־אָנען	עמוד־ענן
אַמעד־האַטאָװעך	עמוד־התּװך
אַמעד־האָײש	עמוד־האש
אַמעד־העאָנען	עמוד־הענן
אַמעדײש	עמוד־אש
אָמעס	עמוס
אַמע־פּעזיזע	עמא־פּזיזא
אָמעק	עמוק
אַמעראַצים	עם־האָרץ
אַמעראַציש	עם־הארציש
אַמעראַצעס	עם־הארצות
אַמקאָנים	עמקן
אַמקן	עמקן
אַמקעס	עמקות
אַם־קשײ־אױרעף	עם־קשה־עורף
אַנאָװים	ענװ
אַנאָװע	ענװה
אַנאָשים	איש
אָנאָשים	עונש
אַנאָשים־כ(אַ)שוּװים	איש־חשובֿ
אַנאָשים נאָשים װעטאַף	אַנשים נשים וטף
אַנדרױגינעס	אַנדרוגינוס
אָנױכי	אָנוכי
אַנוסים	אָנוס
אַנטיִאָכעס (האַראָשע)	אַנטיוכוס (הרשע)
אָני	עני
אָני־באַפּעסעך	עני־בפּתח
אָני־האָגן	עני־הגון
אַני־האַקאָטן	אַני־הקטן
אַניװעס	עניװת
אָני־װעעװיען	עני־ואבֿיון
אַניִיִם	עני
אַניִיִם־האַגונים	עני־הגון
אַניִיִם־װעעװיױנים	עני־ואבֿיון
אַניִיִם־מעדוקאָיִם	עני־מדוכּא
אַני־מײַמען	אַני־מאמין
אָני־מעדוקע	עני־מדוכּא
אַניִעס	עניות
אַני שלױמע	אַני שלמה
אָני־שעבאַאַניִיִם	עני־שבענײם
אָנכאַזערן	אָנחזירן
אָנכידעשן	אָנחידושן —> אָנחידושן זיך
אָנעװ	ענװ
אָנעס	אָנוס
אָנשיקערן	אָנשיכּורן
אַנשע	אַנשי־
אַנשע־מײַסע	אַנשי־מעשׂה
אַנשע־קנעסעס־האַגדױלע	אַנשי־כּנסת־הגדולה
אַנשע־שלױמײנו	אַנשי־שלומנו
אָס	אות
אַסאָקים	עסק
אַסאָרע־בעטײװעס	עשׂרה־בטבֿת
אַסאָרע־האַרוגע־מאַלכעס	עשׂרה־הרוגי־מלכות
אַסאָרע־רישױנים	עשׂרה־ראשונים
אָס־בעאָס	אות־באות
אַסוסע	אַסותא
אַסורים	אָסור
אַסורע	אָסור : אַסורה
אַסיפֿע	אַסיפֿה
אַסכאַלטע־דעגעולע	אַתחלתּא־דגאולה
אַסמאַכטע	אַסמכתּא
אַסנע	אַסנה
אָסעד	עתיד
אָסעד ליטױל עס האַדין	עתיד לטול את הדין
אָסער	אָסור
אָסער	אָסור
אָסער־כאַזער	אָסור־חזיר
אָסער־לעדאַבער	אָסור־לדבר
אָסער־לעראַכעם	אָסור־לרחם
אַסערן	אַסרן
אַסערעס־בנײ־האָמען	עשׂרת־בני־המן
אַסערעס־האַדיברעס	עשׂרת־הדיברות
אַסערעס־האַשװאָטים	עשׂרת־השבֿטים
אַסערעס־יעמײ־טשוּװע	עשׂרת־ימי־תּשובֿה
אַסקאָנים	עסקן
אָסקים־בעמיצװעס	עוסק־במיצװה
אָסקים־בעצאָרכע־ציבער	עוסק־בצרכי־ציבור
אַסקן	עסקן
אַסקערע	אַסכּרה
אָף	עוף
אָפּגעכױמערט	אָפּגעחומרט
אַפּױטיקע	אַפּותּיקא / אַפּותּיקי
אַפּיקאָרסים	אַפּיקורס
אַפּיקאָרסיש	אַפּיקורסיש
אַפּיקאָרסעס	אַפּיקורסות
אַפּיקױרעס	אַפּיקורס
אַפּיקױרעסטע	אַפּיקורסטע
אָפּכױרעשן	אָפּחורשן
אָפּכױשעכן	אָפּחושכן
אָפּכײַען	אָפּחיען
אָפּמאָשלען	אָפּמשלען
אַפּעטראָפּסים	אַפּוטרופּ(ו)ס
אַפּעטראָפּסעס	אַפּוטרופּסות
אַפּעטראָפּעס	אַפּוטרופּ(ו)ס
אָפּפּאַטערן	אָפּפּטרן
אַפּשיטע	אַפּשיטא
אַפֿילע	אַפֿילו
אַפֿיקױמען	אַפֿיקומן
אָפֿער־װאָײפֿער	עפֿר־ואפֿר
אַפֿרע־דעאַרע	עפֿרא־דאַרעא
אַצאָמעס	עצמות
אַצאָמעס־האַיעװײשעס	עצמות־היבֿשות
אַצאָסי	עצתי
אַצװעס	עצבֿות
אַצװעסניצע	עצבֿותניצע
אַצװעסניק	עצבֿותניק
אַצילעס	אַצילות
אַצירעס	עצירות
אָץ־קױצעץ	אָץ־קוצץ
אַקאָרים	עקר
אַקאָרע	עקרה
אַקאָרעס	עקרות
אַקדאָמעס	אַקדמות
אַקודים נעקודים אוּװרודים	עקודים נקודים ובֿרודים
אַקום	עכּו״ם
אָקיאָנעס	אוקינוס
אַקיװע	עקיבֿא
אַקײדע	עקדה
אַקײדעס־ײִצכאָק	עקדת־יצחק
אָקער	עקר
אַקערעס־האַבאַיִס	עקרת־הבית
אַקרעװ	מזל עקרבֿ
אַקרעװ	עקרבֿ
אַקרען	עקרען
אַקשאָנים	עקשן
אַקשאָנעס	עקשנות
אַקשן	עקשן
אַקשנטע	עקשנטע
אַקשענען	עקשנען —> עקשנען זיך
אַראָװע	ערבֿה
אַראָכין	ערכין
אַראַם	אַרם
אַראַמי	אַרמי
אַראַמיש	אַרמיש
אַראַם־נאַהאַראַיִם	אַרם־נהרים
אַראָראַט	אַררט
אַרבאָיִם	אַרבעים
אַרבאָע־באָנים	אַרבעה־בנים
אַרבאָע־טורים	בעל־הטורים: אַרבעה־טורים
אַרבע	אַרבה
אַרבע	דצ״ך עד״ש באח״ב: אַרבה
אַרבע־טורים	בעל־הטורים: אַרבעה־טורים
אַרבע־מיסעס־בעז(ד)ן	אַרבע־מיתות־בית־דין
אַרבע־פּינעס־האָױלעם	אַרבע־פּינות־העולם
אַרבעקאַנפֿעס	אַרבע־כּנפֿות
אַרבע־קױסעס	אַרבע־כּוסות
אַרבע־רוכעס(־האָױלעם)	אַרבע־רוחות(־העולם)
אַרוגע	ערוגה
אָרװים	ערבֿ
אָרװעס	ערבֿות
אַרױנעס	אָרון
אַרױספּאַטערן	אַרױספּטרן
אַרױעס	עריות
אַרורים	אָרור
אַרורע	אַרורה
אַרי	אַר״י
אַריבערגאַנװענען	אַריבערגנבֿענען
אַרײװים	ערבֿ
אַרײװעס	ערבֿות
אַרײלים	ערל
אַרײלעס	ערלית
אַרײַנגאַנװענען	אַרײַנגנבֿענען
אַרײַנגאַנװענען	אַרײַנגנבֿענען —> אַרײַנגנבֿענען זיך
אַרײַניאַשװע(נע)ן	אַרײַנישבֿע(נע)ן
אַרײַעס	עריות
אַריכעס־יאָמים	אַריכות־ימים
אַריע	אַריה
אַריע	מזל אַריה
אַרי־שעבאַכאַװוּרע	אַרי־שבחבֿורה
אָרכים	אורחים —> אורח
אָרכים־האַגונים	אורחים־הגונים —> אורח־הגון
אָרכעפּאָרכע	אָרחי־פּרחי
אָרל	ערל
אָרלטע	ערלטע
אָרלע	ערלה
אָרמע	ערמה
אַרן	אַהרן
אָרן	אָרון
אַרן האַקױען	אַהרן הכּהן
אָרנקױדעש	אָרון־קודש
אָרעװ	דצ״ך עד״ש באח״ב: ערובֿ
אָרעװ	ערבֿ
אָרעװ	ערבֿ —> ערבֿ זײַן
אָרעװטע	ערבֿטע
אָרעװניצע	ערבֿניצע
אָרעװניק	ערבֿניק
אָרעװ־קאַבלען	ערבֿ־קבלן
אָרעם־באָכער	אָרעם־בחור —> בחור
אָרע־מיקלעט	ערי־מיקלט —> עיר־מיקלט
אָרער	אָרור
אָרער	אָרור
אָרצע	אָרצה
אָשאַמנו (באָגאַדנו גאָזאַלנו)	אָשמנו (בגדנו גזלנו)
אַשור	אַשור
אַשירים	עושר
אַשירים	עשיר
אַשירעס	עשירות
אַשמױרע	אַשמורה
אַשמעדײַ	אַשמדאַי
אָשער	אָשר
אָשער	עשיר
אַשער־יאָצער	אַשר־יצר
אַשער־יאָצערל	אַשר־יצרל
אַשעריאָצער־פּאַפּיר	אַשר־יצר־פּאַפּיר
אַשער לױ …ו אַװױסײנו	אַשר לא …ו אַבֿותנו
אַשפּע	אַשפּה
אַשקענאַז	אַשכּנז
אַשקענאַזי	אַשכּנזי
אַשקענאַזיס	הבֿרה: הבֿרה־אַשכּנזית
אַשקענאַזיש	אַשכּנזיש
אַשקענאַזער	אַשכּנזער
אַשרײ	אַשרי
אַשרײ האַמײַמען	אַשרי המאמין

באַ…	ב…
באַאַװלען	באַעװלען
באַאַכילע	באַכילה
באַאַל	בעל
באַאַלי	בעלי
באַאַלע	בעלה
באַאַמידע	בעמידה
באָבע־מײַסע	בבֿא־מעשׂה
באָגאַדנו	אָשמנו (בגדנו גזלנו)
באָגדים	בוגד
באָגרים	בוגר
באָגרעס	בוגרת
באַדאַמען	באַדמען
באַדכאָנים	בדחן
באַדכאָניש	בדחניש
באַדכאָנעס	בדחנות
באַדכן	בדחן
באַדכענען	בדחנען
באָדעק־אומענוסע	בדוק־ומנוסה
באַװױנעסײנו־האָראַבים	בעװנותינו־הרבים
באָװל	בבֿל
באַװלי	בבֿלי
באָװל־סכױרע	בבֿל־סחורה
באָװל־קױנים	בבֿל־קונה
באָװל־קױנע	בבֿל־קונה
באָװע־באַסרע	בבֿא־בתרא
באָװע־מײַסע	בבֿא־מעשׂה
באָװע־מעציִע	בבֿא־מציעא
באָװע־קאַמע	בבֿא־קמא
באָו מאַיִם אַד נעפֿעש	באָו מים עד נפֿש
באָזנײַ שאָמאַטי	באָזני שמעתּי
באָזע	בזױ
באַזע אוּװאַװאָ	בזה ובֿבֿאָ
באַטאַמט	באַטעמט
באַטים	בתּים
באַטכאָנים	בדחן
באַטכאָניש	בדחניש
באַטכאָנעס	בדחנות
באַטכן	בדחן
באַטכענען	בדחנען
באָטל	בטל
באָטל־אומװוּטל	בטל־ומבֿוטל
באַטלאָנים	בטלן
באַטלאָניש	בטלניש
באַטלאָנעס	בטלנות
באָטל־בעשישים	בטל־בשישים
באַטלען	בטלן
באַטלען	בטלען
באַטלענען	בטלענען
באַטל	בטל —> בטלען
באַטלסט	בטלסט —> בטלען
באַטלט	בטלט —> בטלען
באָטע	בית־
באָטע־יעסױמים	בית־יתומים
באָטע־מידראָשים	בית־מדרש
באָטע־קנעסעס	בית־הכּנסת
באַטקע(נע)ן	בדקע(נע)ן
באַיאָמים־האָהײם	בימים־ההם
באַיִס־רישן	בית־ראשון
באַיִס־שײני	בית־שני
באַכורים	בחור
באַכײנט	באַחנט
באָכער	בחור
באָכער־האַזעצער	בחור־הזעצער
באָכערטע	בחורטע
באָכערים	בחור
באָכערעץ	בחורעץ
באַל	בעל־
באַלאַװײרע	בעל־עבֿירה
באַלאַװײרעניצע	בעל־עבֿירהניצע
באַלאַװײרעניק	בעל־עבֿירהניק
באַלאַװלע	בעל־עװלה
באַלאַכסאַניע	בעל־אַכסניא
באַלאַכסן	באַלכסון
באַלאַכרײַעס	בעל־אַחריות
באַלאָנים	בעלן
באַלאָנעס	בעלנות
באַלאַסקן	בעל־עסקן
באַלבאַטיש	בעל־הבתּיש
באַלבאַטישקײט	בעל־הבתּישקײט
באַלבאָסטע	בעל־הביתטע
באַלבאָסער	בעל־בשׂר
באַלביטאָכן	בעל־בטחון
באַלבעטועך	בעל־בטוח
באַלבעכי	בעל־בכי
באַלבריס	בעל־ברית
באַלגוזמע 	בעל־גוזמא
באַלגוף	בעל־גוף
באַלגײַװע	בעל־גאװה
באַלגײַװעטע	בעל־גאװהטע
באַלגײַװעניצע	בעל־גאװהניצע
באַלגײַװעניק	בעל־גאװהניק
באַל־דאַבראָנים	בעל־דברן
באַלדאַברען	בעל־דברן
באַלדאָװער	בעל־דבֿר
באַל־דאַרשאָנים	בעל־דרשן
באַלדאַרשן	בעל־דרשן
באַלדאַרשער	בעל־דרשער
באַלדײע	בעל־דעה
באַל־דימיױנעס	בעל־דמיון
באַלדימיען	בעל־דמיון
באַלדין	בעל־דין
באַלדיקדעק	בעל־דיקדוק
באַל־דערעכערעץ	בעל־דרך־ארץ
באַלהאָזע	בעל־העזה
באַלהאַטורים	בעל־הטורים
באַלהאַכנאָסע	בעל־הכנסה
באַל־האַכנאָסעס־אָרכים	בעל־הכנסת־אורחים
באַלהאַלװאָע	בעל־הלװאה
באַלהאַמצאָע	בעל־המצאה
באַל־האַנעס	מאיר בעל־הנס
באַלהאַשפּאָע	בעל־השפּעה
באַלהױצאָע	בעל־הוצאה
באַלזיקאָרן	בעל־זכּרון
באַלטאַכבולע	בעל־תּחבולה
באַלטאַכלעס	בעל־תּכלית
באַלטאַכלעסניצע	בעל־תּכליתניצע
באַל־טאַקיפֿים	בעל־תּקיף
באַלטאַקסע	בעל־טאַקסע
באַלטאַקעף	בעל־תּקיף
באַל־טאַשכיס	בל־תּשחית
באַלטװיִע	בעל־תּבֿיעה
באַלטױװע	בעל־טובֿה
באַלטױװעניצע	בעל־טובֿהניצע
באַלטײַװע	בעל־תּאװה
באַלטײַװעניצע	בעל־תּאװהניצע
באַלטײַװעניק	בעל־תּאװהניק
באַלטײַנע	בעל־טענה
באַלטענאַך	בעל־תּנך
באַלטעקײע	בעל־תּוקע
באַלטפֿילע	בעל־תּפֿילה
באַל־טפֿילעס	בעל־תּפֿילה
באַלטקיִע	בעל־תּקיעה
באַל־טקיִעס	בעל־תּקיעה
באַל־טקיפֿים	בעל־תּקיף
באַלטשוּװע 	בעל־תּשובֿה
באַל־טשוּװע	בעל־תּשובֿה
באַלטשוּװעטע	בעל־תּשובֿהטע
באַלטשוּװעניצע	בעל־תּשובֿהניצע
באַלטשוּװעניק	בעל־תּשובֿהניק
באַל־טשוּװעס	בעל־תּשובֿה
באַליװרע	בעל־עבֿרי
באַליױװל	בעל־יובֿל
באַליױװלטע	בעל־יובֿלטע
באַליױעץ	בעל־יועץ
באַליױעצטע	בעל־יועצטע
באַלײִכעס	בעל־ײִחוס
באַלײִכעסטע	בעל־ײִחוסטע
באַלײסעק	בעל־עסק
באַלײִעש	בעל־ײִאוש
באַלײצע	בעל־עצה
באַליעכױלעס	בעל־יכולת
באַליעסורים	בעל־יסורים
באַלכאַלױמעס	בעל־חלומות
באַלכאַסענע	בעל־חתונה
באַלכױװ	בעל־חובֿ
באַלכײַ	בעל־חי
באַלכײַעװ	בעל־חײבֿ
באַלכעזשבם	בעל־חשבון
באַלכעסעד	בעל־חסד
באַל־לאָשן	בעל־לשון
באַל־לאָשנקױדעש	בעל־לשון־קודש
באַלמאַגיִע	בעל־מגיה
באַלמאַזל	בעל־מזל
באַלמאַכלױקעס	בעל־מחלוקת
באַלמאַכשאָװעס	בעל־מחשבֿות
באַלמאַפֿטער	בעל־מפֿטיר
באַלמאַצליִעך	בעל־מצליח
באַל־מאָרעשכױרע	בעל־מרה־שחורה
באַלמאַשכיס	בעל־משחית
באַלמױעך	בעל־מוח
באַלמױפֿעס	בעל־מופֿת
באַלמום 	בעל־מום
באַלמוסעף	בעל־מוסף
באַלמוסער	בעל־מוסר
באַלמוצלעך	בעל־מוצלח
באַלמידע	בעל־מידה
באַלמידעס	בעל־מידות
באַלמײכעש	בעל־מיחוש
באַלמיכיע	בעל־מחיה
באַלמילכאָמע	בעל־מלחמה
באַלמיצװע	בעל־מיצװה
באַלמישפּאָכע	בעל־משפּחה
באַלמישפּעט	בעל־מישפּט
באַלמעגאַזעם	בעל־מגזם
באַלמעגאַזעמטע	בעל־מגזמטע
באַלמעדאַקדעק	בעל־מדקדק
באַלמעזעקטאָװ	בעל־מזג־טובֿ
באַל־מעטופּאָלים	בעל־מטופּל
באַלמעטופּל	בעל־מטופּל
באַלמעכאַבער	בעל־מחבר
באַלמעכאַשעף	בעל־מכשף
באַלמעלאָכע	בעל־מלאָכה
באַלמעליצע	בעל־מליצה
באַלמענאַגן	בעל־מנגן
באַלמעפֿאַרנעס	בעל־מפֿרנס
באַלמעפֿוניצע	בעל־מפֿוניצע
באַלמעפֿונעק	בעל־מפֿונק
באַלמעציִעס	בעל־מציאות
באַלמעקאַנע	בעל־מקנא
באַלמעקובל	בעל־מקובל
באַלן	בעלן
באַלנטע	בעלנטע
באַלנילע	בעל־נעילה
באַלניסױען	בעל־נסיון
באַלניצאָכן	בעל־נצחון
באַלנעס	בעל־נס
באַל־נעס	מאיר בעל־נס
באַלסאָד	בעל־סוד
באַלסײכל	בעל־שׂכל
באַלסײכלטע	בעל־שׂכלטע
באַלסימכע	בעל־שׂימחה
באַלסימכעטע	בעל־שׂימחהטע
באַלסימכעניצע	בעל־שׂימחהניצע
באַלע	בעל־
באַלע־אַװײרעס	בעל־עבֿירה
באַלע־אַװלעס	בעל־עװלה
באַלע־איװרע	בעל־עבֿרי
באַלע־אײצעס	בעל־עצה
באַלע־אַכסאַניעס	בעל־אַכסניא
באַלע־אַכרײַעס	בעל־אַחריות
באַלע־אַסאָקים	בעל־עסק
באַלע־אַסקאָנים	בעל־עסקן
באַלעבאַטים	בעל־הבית
באַלעבאַטיש	בעל־הבתּיש
באַלעבאַטישקײט	בעל־הבתּישקײט
באַלעבאַטעװען	בעל־הבתּעװען
באַלעבאָס	בעל־הבית
באַלעבאָסטע	בעל־הביתטע
באַלע־באָסערס	בעל־בשׂר
באַלע־ביטאָכן	בעל־בטחון
באַלע־בעטוכים	בעל־בטוח
באַלע־בעכי	בעל־בכי
באַלעבעסל	בעל־הביתל
באַלע־בריסן	בעל־ברית
באַלעגאָלע	בעל־עגלה
באַלע־גוזמאָעס	בעל־גוזמא
באַלע־גוזמע(ס)	בעל־גוזמא
באַלעגוף	בעל־הגוף
באַלע־גופֿים	בעל־גוף
באַלע־גײַװעס	בעל־גאװה
באַלע־דאַבראָנים	בעל־דברן
באַלע־דאָװער	בעל־דבֿר
באַלע־דאַרשאָנים	בעל־דרשן
באַלע־דײעס	בעל־דעה
באַלע־דימיױנעס	בעל־דמיון
באַלע־דינים	בעל־דין
באַלע־דיקדעק	בעל־דיקדוק
באַלע־דערעכערעץ	בעל־דרך־ארץ
באַלע־האַכנאָסע	בעל־הכנסה
באַלע־האַכנאָסעס־אָרכים	בעל־הכנסת־אורחים
באַלע־האַלװאָעס	בעל־הלװאה
באַלע־האַמצאָעס	בעל־המצאה
באַלע־האַשפּאָע	בעל־השפּעה
באַלע־הױצאָעס	בעל־הוצאה
באַלע־זיקאָרן	בעל־זכּרון
באַלע־טאַכבולעס	בעל־תּחבולה
באַלע־טאַכלײסים	בעל־תּכלית
באַלע־טאַכלעס	בעל־תּכלית
באַלע־טאַקיפֿים	בעל־תּקיף
באַלע־טאַקסעס	בעל־טאַקסע
באַלע־טװיִעס	בעל־תּבֿיעה
באַלע־טױװעס	בעל־טובֿה
באַלע־טױסעפֿעס	בעלי־תּוספֿות
באַלע־טײַװעס	בעל־תּאװה
באַלע־טײַנעס	בעל־טענה
באַלע־טענאַך	בעל־תּנך
באַלע־טפֿילעס	בעל־תּפֿילה
באַלע־טקיִעס	בעל־תּקיעה
באַלע־טקיפֿים	בעל־תּקיף
באַלע־טשוּװע(ס)	בעל־תּשובֿה
באַלע־יױװלס	בעל־יובֿל
באַלע־יױעצים	בעל־יועץ
באַלע־ײִכוסים	בעל־ײִחוס
באַלע־ײִכעס	בעל־ײִחוס
באַלע־ײִעש	בעל־ײִאוש
באַלע־יעכױלעס	בעל־יכולת
באַלע־יעסורים	בעל־יסורים
באַלע־כאַיאָװים	בעל־חײבֿ
באַלע־כאַיִם	בעל־חי
באַלע־כאַלױמעס	בעל־חלומות
באַלע־כאַסענע	בעל־חתונה
באַלע־כױװעס	בעל־חובֿ
באַלע־כסאָדים	בעל־חסד
באַלע־כעזשבױנעס	בעל־חשבון
באַלע־לאָשנקױדעש	בעל־לשון־קודש
באַלע־לעשױנעס	בעל־לשון
באַלע־מאַזאָלעס	בעל־מזל
באַלע־מאַכלױקעס(ן)	בעל־מחלוקת
באַלע־מאַכשאָװעס	בעל־מחשבֿות
באַלע־מאַפֿטער	בעל־מפֿטיר
באַלע־מאָפֿסים	בעל־מופֿת
באַלע־מאַצליכים	בעל־מצליח
באַלע־מאָרעשכױרע	בעל־מרה־שחורה
באַלע־מאַשכיסים	בעל־משחית
באַלע־מױכעס	בעל־מוח
באַלע־מױעך	בעל־מוח
באַלע־מומ(ים)	בעל־מום
באַלע־מוסעף	בעל־מוסף
באַלע־מוסער	בעל־מוסר
באַלע־מידעס	בעל־מידות
באַלע־מײכושים	בעל־מיחוש
באַלע־מײכעשן	בעל־מיחוש
באַלע־מיכיעס	בעל־מחיה
באַלע־מילכאָמעס	בעל־מלחמה
באַלע־מיצװעס	בעל־מיצװה
באַלע־מישפּאָכעס	בעל־משפּחה
באַלע־מישפּעט	בעל־מישפּט
באַלע־מעדאַקדעקים	בעל־מדקדק
באַלע־מעזעקטאָװ	בעל־מזג־טובֿ
באַלע־מעטופּאָלים	בעל־מטופּל
באַלע־מעכאַברים	בעל־מחבר
באַלע־מעכאַשפֿים	בעל־מכשף
באַלע־מעליצעס	בעל־מליצה
באַלע־מענאַגנים	בעל־מנגן
באַלע־מעפֿאַרנעסים	בעל־מפֿרנס
באַלע־מעציִעס	בעל־מציאות
באַלע־מעקאַנים	בעל־מקנא
באַלע־מעקובאָלים	בעל־מקובל
באַלע־נילע	בעל־נעילה
באַלע־ניסיױנעס	בעל־נסיון
באַלע־ניסים	בעל־נס
באַלע־ניצכױנעס	בעל־נצחון
באַלע־סױדעס	בעל־סוד
באַלע־סײכל	בעל־שׂכל
באַלע־סימכעס	בעל־שׂימחה
באַלע־פּאַכדאָנים	בעל־פּחדן
באַלע־פּאַרנאָסע	בעל־פּרנסה
באַלע־פּאַשראָנים	בעל־פּשרן
באַלע־פּױאַלים	בעל־פּועל
באַלע־פּיקדױנעס	בעל־פּקדון
באַלע־פּלײטעס	בעל־פּליטה
באַלע־צדאָקע(ס)	בעל־צדקה
באַלע־צורעס	בעל־צורה
באָלעק	בלק
באַלע־קאַבאָלע	בעל־קבלה
באַלע־קױכעס	בעל־כּוח
באַלע־קױעך	בעל־כּוח
באַלע־קײרע	בעל־קרי
באַלע־קיסים	בעל־כּיס
באַלע־קישרױנעס	בעל־כּישרון
באַלע־קריִע	בעל־קריאה
באַלע־ראַכמאָנים	בעל־רחמן
באַלע־ראַכמאָנעס	בעל־רחמנות
באַלע־ראַכמים	בעל־רחמים
באַלע־שאַכרײסים	בעל־שחרית
באַלע־שאַכרעס	בעל־שחרית
באַלע־שײמעס	בעל־שם
באַלע־שעם	בעל־שם
באַלע־שעפֿע	בעל־שפֿע
באַלפּאַכדן	בעל־פּחדן
באַלפּאַרנאָסע	בעל־פּרנסה
באַלפּאַשרען	בעל־פּשרן
באַלפּױעל	בעל־פּועל
באַלפּיקאָדן	בעל־פּקדון
באַלפּלײטע	בעל־פּליטה
באַלפּע	בעל־פּה
באַלצדאָקע 	בעל־צדקה
באַלצדאָקעטע	בעל־צדקהטע
באַל־צדאָקעס	בעל־צדקה
באַלצורע	בעל־צורה
באַל־צורעס	בעל־צורה
באַלקאַבאָלע	בעל־קבלה
באַלקאָרכאָך	בעל־כּרחך
באַלקאָרכע	בעל־כּרחה
באַלקאָרכע	בעל־כּרחו
באַלקאָרכעכאָ	בעל־כּרחך
באַלקאָרכעכאָ אַטאָ כײַ	בעל־כּרחך אַתּה חי
באַלקױעך	בעל־כּוח
באַלקױרע	בעל־קורא
באַלקײַסן	בעל־כּעסן
באַלקײַסנטע	בעל־כּעסנטע
באַלקײרע	בעל־קרי
באַלקיס	בעל־כּיס
באַלקישרען	בעל־כּישרון
באַלקערי	בעל־קרי
באַלקריִע	בעל־קריאה
באַלראַכמאָנעס	בעל־רחמנות
באַלראַכמים	בעל־רחמים
באַלראַכמען	בעל־רחמן
באַלשאַכרעס	בעל־שחרית
באַלשעם	בעל־שם
באַלשעמטאָװ	בעל־שם־טובֿ
באַלשעפֿע	בעל־שפֿע
באַמידבער	במדבר
באַמע דװאָרים אַמורים	במה דבֿרים אַמורים
באָנים	בן
באָנים־זכאָרים	בן־זכר
באָנים־סכאָרים	בן־זכר
באַנשער	באשר
באַנשער־בעכײן	באשר־בכן
באַס־גיל	בת־גיל
באַס־האַיײַנע	בת־היענה
באַס־האָראַװ	בת־הרבֿ
באַס־האַשאָמאַיִם	בת־השמים
באַס־זקונים	בת־זקונים
באַס־טױװים	בת־טובֿים
באַס־טישים	בת־תּישעים
באַס־יײַנע	בת־יענה
באַס־ײִסראָעל	בת־ישׂראל
באַסיע	בתיה
באַס־יעכידע	בת־יחידה
באַס־יעכיטקע	בת־יחידקע
באַסמאַלקע	בת־מלכּה
באַס־נײַמע	מחלת בת־נעמה
באַס־סקונים	בת־זקונים
באָסער	בשׂר
באָסער־װעדאָגים	בשׂר־ודגים
באָסערװעדאָם	בשׂר־ודם
באָסער קאָשער	בשׂר כּשר
באַס־ציִען	בת־ציון
באַס־קױען	בת־כּהן
באַס־שיװים	בת־שיבֿעים
באַס־שמױנים	בת־שמונים
באַסשעװע	בת־שבֿע
באַקאָשע	בקשה
באַקל־מיקל־קאָל	בכּל־מכּל־כּל
באָקע	בקי
באָקע בעכאָל־כעדרע־טױרע	בקי בכל־חדרי־תּורה
באָקע בעשעװע־כאָכמעס	בקי בשבֿע־חכמות
באָראָד	דצ״ך עד״ש באח״ב: ברד
באַראָנשין	בר־עונשין
באַרבעראַװ	בר־בי־רבֿ
באַרדאַאַס	בר־דעת
באַרוריען	בר־אורין
באַריכעס	באַריכות
באָרכאַבע	ברוך־הבא
באָרכאַשעם	ברוך־השם
באָרכו	ברוך־הוא
באָרכו	ברוך־הוא
באָרכו	ברכו
באָרכים	בורח
באָרכי נאַפֿשי	ברכי נפֿשי
באַרכע(נע)ן	ברחע(נע)ן
באַרמאַזל	בר־מזל
באַרמינאַן	בר־מינן
באַרמיצװע	בר־מיצװה
באַרמיצװע	בר־מיצװה
באַרמיצװע־באָכער	בר־מיצװה־בחור
באַרמיצװעס	בר־מיצװה
באַרמיצװעס	בר־מיצװה
באַרמענען	בר־מינן
באַרנאַש	בר־נש
באַרסאַמכע	בר־סמכא
באָר־סוד	בור־סוד
באַרסײכל	בר־שׂכל
באָרע	ברי
באָרעך	ברוך
באָרעכאַבאָ	ברוך־הבא
באָרעכאַבע	ברוך־הבא
באָרעך־אַטאָ / ־אַטע	ברוך־אַתּה
באָרעכאַשעם	ברוך־השם
באָרעך דײַען (האָ)עמעס	ברוך דײןאמת
באָרעך־האַנימצע	ברוך־הנימצא
באָרעך האַשעם יױם יױם	ברוך השם יום יום
באָרעך־הו	ברוך־הוא
באָרעך שעפּאָטראַני	ברוך שפּטרני
באָרע־לי	ברי־לי
באָרער	ברור
באָרערים	בורר
באָרערעס	בוררות
באָרער־קאַשעמעש	ברור־כּשמש
באַרפּלוקטע	בר־פּלוגתּא
באַר־קאָכבע	בר־כּוכבא
באַר־קוזבע	בר־כּוכבא: שמעון בר־כּוזבא
באָשן	בשן
באַשער	באשר
באַשער־בעכײן	באשר־בכן
בגידע	בגידה
בגידע־בעמאַלכעס	בגידה־במלכות
בדיקע	בדיקה
בדיקעס־כאָמעץ	בדיקת־חמץ
בױ	בא
בױגעד	בוגד
בױגעד	בוגד —> בוגד זײַן
בױגער	בוגר
בױדעק	בודק —> בודק זײַן
בױדעק־כאָמעץ	בודק־חמץ —> בודק־חמץ זײַן
בױכער	בוחר —> בוחר זײַן
בױלעט	בולט
בױעז	בועז
בױעל	בועל —> בועל זײַן
בױקײע־רעקיִיִם	בוקע־רקיעים —> בוקע־רקיעים זײַן
בױרײעך	בורח
בױרע	בורא
בױרע־אױלעם	בורא־עולם
בױרע־מעױרע־האָײש	בורא־מאורי־האש
בױרע־פּרי־האָאַדאָמע	בורא־פּרי־האַדמה
בױרע־פּרי־האַגאָפֿן	בורא־פּרי־הגפֿן
בױרער	בורר
בױשעס־פּאָנעם	בושת־פּנים
בױשעס־פּענעמער	בושת־פּנים
בוּע	בועה
בור	בור
בור־דעױרײַסאָ	בור־דאורײַתא
בורים	בור
בורים־דעױרײַסאָ	בור־דאורײַתא
בושע	בושה
בזױִם	בזױ
בי…	ב…
ביגדע־דאַלעס	בגדי־דלות
ביגדע־יאָנטעװ	בגדי־יום־טובֿ
ביגדע־מאַלכעס	בגדי־מלכות
ביגדע־מעשי	בגדי־משי
ביגדע־קעהונע	בגדי־כּהונה
ביגדע־שאַבעס	בגדי־שבת
ביגזײלע	בגזלה
ביגזײרעס	בגזרת־
ביגנײװע	בגנבֿה
בידמאָעס־שאָלעש	בדמעות־שליש
בידעלײקאָ	בדליכּאָ
ביִורים	ביאור
ביזױען	בזיון
ביזיױנעס	בזיון
ביזײר־אַנפּין	בזעיר־אַנפּין
ביזע־ביזױען	בזי־בזיון
ביזע־ביזיױנעס	בזי־בזיון
ביטאָכן	בטחון
ביטכילע־אורכימע	בדחילו־ורחימו
ביטל	ביטול
ביטל־אײװאָרים / ־אײװרים	ביטול־אבֿרים
ביטל־האַיעש	ביטול־היש
ביטל־טױרע	ביטול־תּורה
ביטמימעס	בתּמימות
ביטמיִע	בתּמיה
ביטנײַ	בתּנאַי
ביטשועס־כײן	בתּשואות־חן
בײז	ב
בײז	בית
בײן	בין
בײן אָדעם לאַמאָקעם	בין אָדם למקום
בײן אָדעם לעכאַװײרע	בין אָדם לחבֿרו
בײן־האַזמאַנים	בין־הזמנים
בײן־האַמצאָרים	בין־המצרים
בײן־האַשמאָשעס	בין־השמשות
בײן יעמינע ליסמױלע / אוסמױלע	בין ימינו לשׂמאלו / ושׂמאלו
בײן־מינכע־לעמײַרעװ	בין־מינחה־למעריבֿ
בײנע־לעבײנע	בינו־לבינו
בײן־קעסע־לעאָסער	בין־כּסא־לעשׂור
בײס	ב
בײס	בית
בײס	בית־
בײס	בעת
בײס־האַכאַיִם	בית־החײם
בײס־האַמיגדעש	בית־המיקדש
בײס־האַקאָװעד	בית־הכּבֿוד
בײס־האַקװאָרעס	בית־הקבֿרות
בײס־האַקיסע	בית־הכּיסא
בײס־האַקנעסעס	בית־הכּנסת
בײס־װאַאַד(־לאַ…)	בית־װעד(־ל…)
בײס־װאַאַד־לאַכאַכאָמים	בית־װעד־לחכמים
בײס־יאַנקעװ	בית־יעקבֿ
בײס־יאַנקעװ לעכו װענײלכאָ	ביל״ו: בית־יעקבֿ לכו ונלכה
בײס־יעסױמים	בית־יתומים
בײס־לעכעם	בית־לחם
בײס־מײַסע	בעת־מעשׂה
בײצים	ביצה
בײצע	ביצה
בײַשאָנים	בײַשן
בײַשאָנעס	בײַשנות
בײַשן	בײַשן
ביכדײ	בכדי
ביכװױדע־אוּװעאַצמע	בכבֿודה־ובֿעצמה
ביכװױדע־אוּװעאַצמע	בכבֿודו־ובֿעצמו
ביכױלעס	ביכולת
ביכידעס	ביחידות
ביכלאַל	בכלל
ביכשיװעס	בחשיבֿות
בילבולים	בילבול
בילבל	בילבול
בילבל־דאַם	בילבול־דם
בילבל־האַמױכעס	בילבול־המוחות
בילהע	בלהה
בילו	ביל״ו
בילטי	בילתּי
בילטי־מעסופּעק	בילתּי־מסופּק
בילעם	בלעם
בימהײרע	במהרה
בימהײרע־בעיעמײנו	במהרה־בימינו
בימזומאָנים	במזומנים
בימזומען	במזומן
בימײ	בימי
בימכילע	במחילה
בימכילע־גמורע	במחילה־גמורה
בימנוכע	במנוחה
בימסױרע	במסורה
בימע	בימה
בימציִעס	במציאות
בימקעם	בימקום
בימקעם	בימקום
בינאָרײנו־אוּװיזקײנײנו	בנערינו־ובֿזקנינו
ביניאָנים	בנין
ביניען	בנין
בינלײַלע	בן־לילה
בינע	בינה
בינעם	בינם
בינקיטעס־כײפֿעץ	בנקיטת־חפֿץ
בינשימע־אַכעס	בנשימה־אַחת
בינשיקע	בנשיקה
ביסכוס	בזכות
ביסכוס־זע	בזכות־זה
ביִע	ביאה
ביִעס־האַגױעל	ביאת־הגואל
ביִער	ביאור
ביִער־כאָמעץ	ביעור־חמץ
ביִעש	ביוש
ביפֿכינעס	בבֿחינת
ביפֿנײ־אַם־װעײדע	בפֿני־עם־ועדה
ביפֿנײ־קאָאָל־װעײדע	בפֿני־קהל־ועדה
ביפֿנײ־קאָל־אַם־װעײדע	בפֿני־כּל־עם־ועדה
ביפֿראַט	בפֿרט
ביפֿראָטיעס	בפֿרטיות
ביפֿרױטרעט	בפֿרוטרוט
ביקװיִעס	בקבֿיעות
ביקורים	ביכּורים
ביקלאַל	בכּלל
ביקסאַװ	בכּתבֿ
ביקער־כױלים	ביקור־חולים
בירמיזע	ברמיזה
בירקעס־האַמאָזן	ברכּת־המזון
בירקעס־קעהאַנים	ברכּת־כּהנים
בירשוס	ברשות־
בישגאָגע	בשגגה
בישטיקע	בשתּיקה
בישכײנעס	בשכנות
בישלײמעס	בשלמות
בכאָר	בכור
בכאָרטע	בכורטע
בכױרים	בכור
בכױרע	בכורה
בכױרעס	בכורות
בכינע	בחינה
בכיִע	בכיה
בכיִע־לעדױרעס	בכיה־לדורות
בכיר	בחיר
בכירע	בחירה
בלאַז	בלע״ז
בלי	בלי־
בלי־גוזמע	בלי־גוזמא
בלי־טנײַ	בלי־תּנאַי
בלי־יעפֿונע	בלי־יפֿונה
בלי־כאַראָטע	בלי־חרטה
בלי־מאַסקאָנע	בלי־מסקנא
בלי־נײדער	בלי־נדר
בלי־סאָפֿעק	בלי־ספֿק
בלי־קאַװאָנע	בלי־כּװנה
בלי־שום־טײַנע	בלי־שום־טענה
בלי־שום־סאָפֿעק	בלי־שום־ספֿק
בלעס־ברײרע	בלית־ברירה
בנױס־גיל	בת־גיל
בנױס־זקונים	בת־זקונים
בנױס־יאַנקעװ	בנות־יעקבֿ
בנױס־ײִסראָעל	בת־ישׂראל
בנױס־סקונים	בת־זקונים
בנױס־ציִען	בת־ציון
בנײאָדעם	בן־אָדם
בנײ־אַניִיִם	בני־ענײם
בנײאַרבאָיִם	בן־אַרבעים
בנײבאַיִס	בן־בית
בנײבריס	בן־ברית
בנײגיל	בן־גיל
בנײדאַאַס	בן־דעת
בנײדאָר	בן־דור
בנײהאָראַװ	בן־הרבֿ
בנײזוג	בן־זוג
בנײזקונים	בן־זקונים
בנײטױװים	בן־טובֿים
בנײטױרע	בן־תּורה
בנײטישים	בן־תּישעים
בנײ־ײִסראָעל	בן־ישׂראל
בנײ־יעכידים	בן־יחיד
בנײ־מױשע	בני־משה
בנײ־מעלאָכים	בן־מלך
בנײ־נױעך	בן־נח
בנײ־נעװיִיִם	בני־נבֿיאים
בנײסקונים	בן־זקונים
בנײ־קאַיאָמע	בן־קימא
בנײ־ראַכמאָנים	בני־רחמנים
בנײשיװים	בן־שיבֿעים
בנײשישים	בן־שישים
בנײשמױנים	בן־שמונים
בנעיאָדעם	בני־אָדם
בנעיִר	בן־עיר
בסאָמים	בשׂמים
בסאָמים־ביקס	בשׂמים־ביקס
בסולים	בתולים
בסולע	בתולה
בסורע	בשׂורה
בסורע־טױװע	בשׂורה־טובֿה
בסורע־ראָע	בשׂורה־רעה
בע…	ב…
בעאַהאַװע	באַהבֿה
בעאָזנײַ שאָמאַטי	באָזני שמעתּי
בעאַלמע	בעלמא
בעאַלמע דיקשױט	בעלמא דקשוט
בעאַלפּע	בעל־פּה
בעגאָדים	בגד
בעגאָלע	בגלױ
בעגאַפּע יאָװע בעגאַפּע ײיצע	בגפּו יבֿוא בגפּו יצא
בעגילופֿן	בגילופֿין
בעגילע	בגילױ
בעגילע בערינע	בגילה ברינה
בעגילע־ראָש	בגילױ־ראָש
בעגימאַטריע	בגימטריא / בגימטריה
בעגעד	בגד
בעדאַלעס	בדלות
בעדאָמאַיִך כאַיִ	בדמיך חײ
בעדאַס	בדעת
בעדױכעק	בדוחק
בעדידי האַװע אוּװדע	בדידי הװה עובֿדה
בעדײע	בדעה
בעדײע־אַכעס	בדעה־אַחת
בעדילאַדאַל	בדיל־(ה)דל
בעדיִעװעד	בדיעבֿד
בעדיִעק	בדיוק
בעדעק־האַבאַיִס	בדק־הבית
בעדערעך־אַגעװ	בדרך־אַגבֿ
בעדערעך־גוזמע	בדרך־גוזמא
בעדערעך־האַטעװע	בדרך־הטבֿע
בעדערעך־האַלאָצע	בדרך־הלצה
בעדערעך־מאָשל	בדרך־משל
בעדערעך־נעס	בדרך־נס
בעדערעך־קלאַל	בדרך־כּלל
בעהאַאַלױסכע	בהעלותך
בעהאַדראָגע	בהדרגה
בעהאַכנאָע	בהכנעה
בעהאַלװאָע	בהלװאה
בעהאָלע	בהלה
בעהאַסמאָדע	בהתמדה
בעהאַקאָפֿע	בהקפֿה
בעהאָקעץ	בהקיץ
בעהאַר	בהר
בעהאַרכאָװע	בהרחבֿה
בעהײמע	בהמה
בעהײמע בעצורעס־אָדעם	בהמה בצורת־אָדם
בעהײמע־גאַסע	בהמה־גסה
בעהײמע־דאַקע	בהמה־דקה
בעהעװל־פּיהעם	בהבֿל־פּיהם
בעהעטער	בהיתּר
בעהעכרעך	בהכרח
בעהען־צידקי	בהן־צידקי
בעהען־שעלי	בהן־שלי
בעהעסעך־האַדאַאַס	בהיסח־הדעת
בעהעסקעם	בהסכּם
בעהעסקעם־קולעם	בהסכּם־כּולם
בעװאַדע	בװדאי
בעװאַס־אַכעס	בבֿת־אַחת
בעױנעס	באונס
בעױסע־האַרעגע	באותו־הרגע
בעױסע־מײַמעד	באותו־מעמד
בעױסע־רעגע	באותו־רגע
בעױסע־שאָ	באותה־שעה
בעױפֿן	באופֿן
בעזאָל	בזול
בעזבושעניצע	בעזבושהניצע
בעזבושעניק	בעזבושהניק
בעזדן	בית־דין
בעזדן־צעדעק	בית־דין־צדק
בעזדן־שאַמאָסים	בית־דין־שמשׂ
בעזדן־שאַמעס	בית־דין־שמשׂ
בעזדן־שטוב	בית־דין־שטוב
בעזדן־שעל־מײַלע	בית־דין־של־מעלה
בעזײעס־אַפּעכאָ	בזעת־אַפּיך
בעזיל־(האַ)זאָל	בזיל־(ה)זול
בעזן	בית־דין
בעזן־צעדעק	בית־דין־צדק
בעזן־שאַמאָסים	בית־דין־שמשׂ
בעזן־שאַמעס	בית־דין־שמשׂ
בעזן־שטוב	בית־דין־שטוב
בעזן־שעל־מײַלע	בית־דין־של־מעלה
בעזע־האָױפֿן	בזה־האופֿן
בעזע־האַלאָשן	בזה־הלשון
בעזרעס־האַשעם	בעזרת־השם
בעזרעס־האַשעם־ײִסבאָרעך	בעזרת־השם־יתברך
בעטאָך	בתּוך
בעטאַכלעס־האַ	בתּכלית־ה…
בעטאַכלעס־האַסינע	בתּכלית־ה…: בתּכלית־השׂינאה
בעטאַכלעס־האַפּאַשטעס	בתּכלית־ה…: בתּכלית־הפּשטות
בעטאַר	ביתּ״ר
בעטאַר	ביתּר
בעטױרעס	בתּורת
בעטוכים	בטוח
בעטוכעס	בטוחות
בעטועך	בטוח
בעטועך	בטוח
בעטופּים־אוּװימכױלעס	בתּופּים־ובֿמחולות
בעטעװע	בטבֿע
בעטער	ביתּר
בעיאַד	ביד
בעיאָדאַיִם	בידים
בעיאַד־כאַזאָקע	ביד־חזקה
בעיאַד־ראָמע	ביד־רמה
בעיאַד־רעכאָװע	ביד־רחבֿה
בעיאַד־רעכאָװע־אומלײע	ביד־רחבֿה־ומלאה
בעיױדים	ביודעים
בעיױקער	ביוקר
בעיִטע	בעתּו
בעײן־אױפֿן	באין־אופֿן
בעײן־ברײרע	באין־ברירה
בעײנײַ ראָיִסי	בעיני ראָיתי
בעײרעם־אוּװכױסער־קאָל	בעירום־ובֿחוסר־כּל
בעיִם	באם
בעיִסער	באיסור
בעיערושע	בירושה
בעיִקער	בעיקר
בעכאַדראַג	בחדר״ג
בעכאַדרע־כאַדאָרים	בחדרי־חדרים
בעכאַװרוסע	בחבֿרותא
בעכאַזאָקע	בחזקה
בעכאַזאָרע	בחזרה
בעכאָל־אױפֿן	בכל־אופֿן
בעכאָל־טפֿוצעס־ײִסראָעל	בכל־תּפֿוצות־ישׂראל
בעכאָל־כעדרע־טױרע	בקי בכל־חדרי־תּורה
בעכאָצע־כינעם	בחצי־חינם
בעכאַרפּאָסע	בחרפּתו
בעכאַרפּע	בחרפּה
בעכױמער־אוּװילװײנים	בחומר־ובֿלבֿנים
בעכוקױסײַ	בחקותי
בעכוש	בחוש
בעכי־טױװ	בכי־טובֿ
בעכײן	בכן
בעכײַע עװן־פּעקודע	חובֿות־הלבֿבֿות: רבנו בחײ אבן־פּקודה
בעכײרעם	בחרם
בעכינעם	בחינם
בעכיפּאָזן	בחפּזון
בעכען	בכן
בעכעסקעס	בחזקת־
בעלאַז	בלע״ז
בעלאַכעש	בלחש
בעלאָשן־אַטאָ	בלשון־אַתּה
בעלאָשן־יאָכעד	בלשון־יחיד
בעלאָשן־כיבע	בלשון־חיבה
בעלאָשן־סעגינאָער	בלשון־סגי־נהור
בעלאָשן־ראַבים	בלשון־רבים
בעלױ	בלא
בעלױ־גוזמע	בלא־גוזמא
בעלױ־יױדים	בלא־יודעים
בעלי	בלי־
בעלי־גוזמע	בלי־גוזמא
בעלי־טנײַ	בלי־תּנאַי
בעלי־יעפֿונע	בלי־יפֿונה
בעלי־כאַראָטע	בלי־חרטה
בעלי־מאַסקאָנע	בלי־מסקנא
בעלי־נײדער	בלי־נדר
בעלי־סאָפֿעק	בלי־ספֿק
בעלי־קאַװאָנע	בלי־כּװנה
בעלי־שום־טײַנע	בלי־שום־טענה
בעלי־שום־סאָפֿעק	בלי־שום־ספֿק
בעלעװ־װאָנעפֿעש	בלבֿ־ונפֿש
בעלעס־ברײרע	בלית־ברירה
בעמאַטאָנע	במתּנה
בעמאָקעם שעײן איש	במקום שאין איש
בעמײזיד	במזיד
בעמײלע	במילא
בעמיצװױסאָװ	במיצװתיו
בעמעקעך(־האַשאָװע)	במקח(־השװה)
בעמעשעך	במשך
בען	בן
בענאָדעם	בן־אָדם
בענאָק	בנאָק
בענאַרבאָיִם	בן־אַרבעים
בענבאַיִס	בן־בית
בענבעקוע	בן־פּקועה
בענבריס	בן־ברית
בענגיל	בן־גיל
בענדאַאַס	בן־דעת
בענדאָר	בן־דור
בען־האַנידע	בן־הנידה
בענהאָראַװ	בן־הרבֿ
בענױעג־שעבאָױלעם	בנוהג־שבעולם
בענזאָכער	בן־זכר
בענזוג	בן־זוג
בענזקונים	בן־זקונים
בענטױװים	בן־טובֿים
בענטױרע	בן־תּורה
בענטישים	בן־תּישעים
בעניאָכעד	בן־יחיד
בעניאָמען	בנימין
בעניאַקער	בן־יקיר
בען־ײִסראָעל	בן־ישׂראל
בעניכעסע	בניחותא
בענימעס	בנימוס
בענימעס	בנעימות
בענימצע	בנימצא
בעניר	בן־עיר
בענמײלעך	בן־מלך
בען־מײַמאָן	רמב״ם: רבנו משה בן־מימון
בען־נױעך	בן־נח
בען־נעװאָט	ירבֿעם בן־נבֿט
בען־סױרער־אומױרע	בן־סורר־ומורה
בען־סירע	בן־סירא
בענסקונים	בן־זקונים
בענעגײע	בנוגע
בענעמאָנעס	בנאמנות
בענפּעקוע	בן־פּקועה
בענציִען	בן־ציון
בען־קאַיאָמע	בן־קימא
בענשיװים	בן־שיבֿעים
בענשישים	בן־שישים
בענשמױנים	בן־שמונים
בעסאָד	בסוד
בעסאָד־סױדעס	בסוד־סודות
בעסאָך	בתוך
בעסאַלמען	בית־עלמין
בעסױכעם	בתוכם
בעסױלעם	בית־עולם
בעסיִאַטע־דעשמײַע	בסיעתּא־דשמיא
בעסײװער־פּאָנעם־יאָפֿעס	בסבֿר־פּנים־יפֿות
בעסײסער	בסתר
בעסמעדרעש	בית־מדרש
בעסעכאַקל	בסך־הכּל
בעעלעף־מעכילעס	באלף־מחילות
בעעמונאָסי	באמונתי
בעעמונע	באמונה
בעעמונע־שלײמע	באמונה־שלמה
בעעמעס	באמת
בעעצעם	בעצם
בעערעך	בערך
בעפּאַכײ־נעפֿעש	בפּחי־נפֿש
בעפּאַשטעס	בפּשטות
בעפּױעל	בפּועל
בעפּױעל־מאַמעש	בפּועל־ממש
בעפּישעט־יאָדאַיִם־װעראַגלאַיִם	בפּישוט־ידים־ורגלים
בעפּע־מאָלע	בפּה־מלא
בעפּע־עכעד	בפּה־אחד
בעפֿומבי	בפֿומבי
בעפֿײרעש	בפֿירוש
בעפֿײרעש הוטנע	בפֿירוש הותּנה
בעפֿערעסיע	בפֿרהסיא
בעצאַװאָע	בצװאה
בעצאַלעל	בצלאל
בעצורעס	בצורת־
בעצורעס־אָדעם	בצורת־אָדם
בעציבער	בציבור
בעצימצעם	בצימצום
בעקאַבאָלע	בקבלה
בעקאַװאָנע	בכּװנה
בעקאַװ־האַבריִע	בקװ־הבריאות
בעקאַװ־האַבריִעס	בקװ־הבריאה
בעקאַװ־האַכאַיִם־װעהאַשאָלעם	בקװ־החײם־והשלום
בעקאָװעד	בכּבֿוד
בעקאָװעד־גאָדל	בכּבֿוד־גדול
בעקאָװעדיק	בכּבֿודיק
בעקאָלע־קױלעס	בקולי־קולות
בעקאָל־קױלעס	בקולי־קולות
בעקאָל־ראָם	בקול־רם
בעקאַן	בכּאַן
בעקאַק	בק״ק
בעקאָרעװ	בקרובֿ
בעקױװעד־ראָש	בכּובֿד־ראָש
בעקױעך	בכּוח
בעקיװן	בכּיװן
בעקיִיִם	בקי
בעקיסע בעקױסע בעקײַסע	בכּיסו בכּוסו בכּעסו
בעקיִע	בקיאה
בעקיִעס	בקיאות
בעקיצער	בקיצור
בעקעהילע־קדױשע	בק״ק: בקהילה־קדושה
בעקעשער	בקשר
בעראַבים	ברבים
בעראָװ־אַם	ברובֿ־עם
בעראַכװעסדיק	ברחבֿותדיק
בעראָכל ביטכאָ האַנאַקעטע	ברחל בתּך הנאַקעטע
בעראָכל ביטכאָ האַקטאַנאָ	ברחל בתּך הקטנה
בעראָצן	ברצון
בעראָש	בראָש
בערױשע־װערובע	בראשו־ורובו
בערומע־שעל־אױלעם	ברומו־של־עולם
בערועך־האַקױדעש	ברוח־הקודש
בערײש־געלײ	בריש־גלי
בעריע	בריה
בעריען	בריהן —> בריהן זיך
בעריע־ניפֿלאָע	בריה־נפֿלאה
בעריעש	בריהש
בעריעשאַפֿט	בריהשאַפֿט
בעריעשקײט	בריהשקײט
בערעװעך	ברװח
בערעמעז	ברמז
בעשאַטע	בשעתּה / בשעתּו
בעשאַטעם	בשעתּם
בעשאַלאַך	בשלח
בעשאָלעם	בשלום
בעשאָלעם־װעשאַלװע	בשלום־ושלװה
בעשאַס	בשעת
בעשאַס־האַטכאַק	בשעת־הדחק
בעשאַס־מײַסע	בשעת־מעשׂה
בעשוטפֿעס	בשותּפֿות
בעשױגעג	בשוגג
בעשום־אױפֿן	בשום־אופֿן
בעשט	בעש״ט
בעשײַכעס	בשײַכות
בעשײן־װאָאַיִן	בשן־ועין
בעשעװע־כאָכמעס	בקי בשבֿע־חכמות
בעשעם־אומאַלכעס	בשם־ומלכות
בעשעם־אָמרױ	בשם־אומרו
בעשעם־װעמאַלכעס	בשם־ומלכות
בעשעפֿע	בשפֿע
בראַכיע	ברכיה
בראָכע	ברכה
בראָכע	ברכה
בראָכע־לעװאַטאָלע	ברכה־לבֿטלה
בראָכעס	ברכות
ברױגעז	ברוגז
ברױגעז	ברוגז
ברױגעז	ברוגז־טאַנץ
ברױגעזן	ברוגזן —> ברוגזן זיך
ברױִם	ברואים
ברױִם	בריאה
ברוכים־האַבאָיִם	ברוכים־הבאָים
ברוכים־האַיױשװים	ברוכים־היושבֿים
ברוריע	ברוריה
בריט יאָסעף טרומפּעלדאָר	ביתּ״ר: בריתּ יוסף תּרומפּלדור
ברײַסע	בֿײַתא
ברײרע	ברירה
ברײשעס	בראשית
בריס	ברית
בריס־כאַדאָשע	ברית־חדשה
בריסמילע	ברית־מילה
בריִע	בריאה
בריִעס	בריאות
בריִעס־אױלעם	בריאת־עולם
בריִעס־האַגוף	בריאות־הגוף
בריִעס־האָױלעם	בריאת־העולם

גאַבאָיִם	גבאי
גאַבאָעס	גבאָות
גאַבע	גבאי
גאַבעטע	גבאיטע
גאָג־אומאָגעג	גוג־ומגוג
גאָגמעגאָג	גוג־מגוג
גאָד	גד
גאָדל	גדול
גאָדל	גדול
גאַדלאָנים	גדלן
גאַדלאָנעס	גדלנות
גאָדל־בעיִסראָעל	גדול־בישׂראל
גאָדלדיק	גדולדיק
גאָדל־האַדאָר	גדול־הדור
גאָדלע	גדלע
גאַדלען	גדלן
גאַדלענטע	גדלנטע
גאַדלעס	גדלות
גאַװראָנים	גבֿרן
גאַװריִעל	גבֿריאל
גאַװרען	גבֿרן
גאַװרעס	גבֿרות
גאָזאַלנו	אָשמנו (בגדנו גזלנו)
גאַזלאָנים	גזלן
גאַזלאָניש	גזלניש
גאַזלאָנעס	גזלנות
גאַזלע(נע)ן	גזלע(נע)ן
גאַזלעװױסטװע	גזלעװױסטװע
גאַזלעװױע	גזלעװױע
גאַזלען	גזלן
גאַזלענטע	גזלנטע
גאָיאַלים	גואל
גאָיִם	גױ
גאָיִם־גמורים	גױ־גמור
גאָיִש	גוײִש
גאַלאָכים	גלח
גאַלגאַלים	גלגל
גאַלגל	גלגל
גאַלגל (האַ)כױזער (באָױלעם)	גלגל (ה)חוזר (בעולם)
גאָליעס	גלית
גאַלכעס	גלחות
גאַל־עד	גל־עד
גאַלעך	גלח
גאָלעס	גלות
גאָלעס	גלות־
גאָלעס־באָװל	גלות־בבֿל
גאָלעס־האַשכינע	גלות־השכינה
גאָלעס־מיצראַיִם	גלות־מצרים
גאַל־שעל־אַצאָמעס	גל־של־עצמות
גאַם	גם
גאַם־אַטעם	גם־אַתּם
גאַמזו לעטױװע	גם זו לטובֿה
גאָמער	גמור
גאַנאָװים	גנבֿ
גאַנװענען	גנבֿענען
גאַנײדן	גן־עדן
גאַנײדן־האַטאַכטן	גן־עדן־התּחתּון
גאַנײדן־טאַכטן	גן־עדן־תּחתּון
גאַנײװיש	גנבֿיש / גנבֿהש
גאַנײװע	גנבֿה
גאַנעװ	גנבֿ
גאַנעװטע	גנבֿטע
גאָען	גאָון
גאַרגערעס	גרגרת
גאָרמים	גורם
גאָרעש	גרוש
גאַשמיִעס	גשמיות
גאַשמיִעסדיק	גשמיותדיק
גדאָרים	גדר
גדױלים	גדול
גדױלים	גדול
גדױלים־בעיִסראָעל	גדול־בישׂראל
גדױלע	גדול : גדולה
גדױלע־האַדאָר	גדול־הדור
גװאַר	גבֿר
גװאַר־אַלים	גבֿר־אַלים
גװאַר־כאַלעש	גבֿר־חלש
גװוּל	גבֿול
גװוּרע	גבֿורה
גװיִעס־אײדעס	גבֿית־עדות
גװיר	גבֿיר
גװירטע	גבֿירטע
גװיריש	גבֿיריש
גװירנטע	גבֿירינטע
גוזמאָעס	גוזמא
גוזמע	גוזמא
גוזמעדיק	גוזמאדיק
גױ	גױ
גױ־גאָמער	גױ־גמור
גױװער	גובֿר —> גובֿר זײַן
גױזער	גוזר —> גוזר זײַן
גױזער־טאָנעס	גוזר־תּענית —> גוזר־תּענית זײַן
גױלאָמים	גולם
גױלים	גולה
גױלע	גולה
גױלע	גולי־
גױלעם	גולם
גױלע־ספֿאַרד	גולי־: גולי־ספֿרד
גױמל	גומל
גױנעז	גונז —> גונז זײַן
גױסע(נע)ן	גוסע(נע)ן
גױסעס	גוסס
גױסעסן	גוססן
גױע	גױה
גױעל	גואל
גױעלים	גואל
גױעל־צעדעק	גואל־צדק
גױראָלעס	גורל
גױרל	גורל
גױרלדיק	גורלדיק
גױרעם	גורם
גױרעם	גורם —> גורם זײַן
גױרעס	גורס —> גורס זײַן
גױשן	גושן
גוף	גוף
גוף־האַמײַסע	גוף־המעשׂה
גופֿע	גופֿא
גזאַר	גזר
גזאַרדין	גזר־דין
גזײלע	גזלה
גזײרע	גזירה
גזײרעס־טאַך (װעטאַט)	גזירת־תּ״ח (ותּ״ט)
גזײרע־שאָװע	גזירה־שװה
גיבױרים	גיבור
גיבױריש	גיבוריש
גיבער	גיבור
גיבעריש	גיבוריש
גידופֿים	גידוף
גידל־באָנים	גידול־בנים
גידן	שס״ה גידין
גידעף	גידוף
גיִורים	גיור
גיטין	גיטין
גײַװסאָנים	גאװתן
גײַװסן	גאװתן
גײַװע	גאװה
גײעס	גאות
גײַעס	גײַעס
גײַפֿסאָנים	גאװתן
גײַפֿסן	גאװתן
גײרושים	גירוש
גײרים	גר
גײרעש	גירוש
גײרעש	גרוש
גילגולים	גילגול
גילגל	גילגול
גילגל־האַנעפֿעש	גילגול־הנפֿש
גילגל־מעכילעס	גילגול־מחילות
גילגל־שעלעג	גילגול־שלג
גילױִם	גילױ
גילױען	גליון
גיליױנעס	גליון
גיליען	גליון
גילע	גילױ
גילע־אַרױעס / ־אַרײַעס	גילױ־עריות
גילע־עליאָהו	גילױ־אליהו
גילע־שכינע	גילױ־שכינה
גימאַטריע	גימטריא
גימל	ג
גימל	גימל
גיִער	גיור
גירסאָעס	גירסא
גירסע	גירסא
גירסע־דעיאַנקעסע	גירסא־דינקותא
גלוכים	גלוח
גלילע	גלילה
גמאַר	גמר
גמאַר טאָװ	גמר טובֿ
גמאַר כסימע טױװע	גמר חתימה טובֿה
גמורים	גמור
גמורע	גמור: גמורה
גמילעס־כ(אַ)סאָדים	גמילות־חסד
גמילעס־כ(אַ)סאָדים	גמילות־חסד(ים)
גמילעס־כעסעד	גמילות־חסד
גמילעס־כעסעד	גמילות־חסד(ים)
גניזע	גניזה
גנײַ	גנאַי
גנײװיש	גנבֿיש / גנבֿהש
גנײװע	גנבֿה
גסיסע	גסיסה
געדאַליאָהו	גדליהו
געדאַליע	גדליה
געדולע	גדולה
געדי	גדי
געדי	מזל גדי
געדער	גדר
געהענעם	גיהנום
געװיר	גבֿיר
געװירטע	גבֿירטע
געװיריש	גבֿיריש
געװירנטע	גבֿירינטע
געױנײ־האַדאָר	גאוני־הדור
געױנים	גאָון
געױניש	גאוניש
געױנעס	גאונות
געולע	גאולה
געזע	גזע
געט	גט
געטן	גטן
געטן	גיטין
געלועך	גלוח
געמאָרע	גמרא
גענײדעם	גן־עדן
גענײװיש	גנבֿיש / גנבֿהש
גענײװע	גנבֿה
גענעם	גיהנום
געסראָכע	געסרחה
גער	גר
גערטע	גרטע
גער־צעדעק	גר־צדק
גערשן	גרשון / גרשם
געשאָכטן	געשחטן
געשעם	גשם
גרױגרעס־דעראַבי־צאָדעק	גרוגרת־דרבי־צדוק
גרױנעם	גרונם
גרושים	גרוש
גרושע	גרושה
גשאָמים	גשם

דאַאַס	דעת
דאַאַס־האַקאָאָל	דעת־הקהל
דאַבערן	דברן
דאַבראָנים	דברן
דאַברען	דברן
דאָגים	דגים
דאָגים	מזל דגים
דאָגעש	דגוש
דאָגעש	דגש
דאָװ	דובֿ
דאָװיד	דוד
דאָװיד האַמײלעך	דוד המלך
דאָװעראַכער	דבֿר־אַחר
דאָװער־גאָדל	דבֿר־גדול
דאָװער־שעביקדושע	דבֿר־שבקדושה
דאַװקע	דװקא
דאַיאָנים	דײן
דאַיאָנעס	דײנות
דאַײינו	דײנו
דאַכקעס	דחקות
דאַלײסים	דלות
דאַלעט	ד
דאַלעט	דלתּ
דאַלעט אַל דאַלעט	דלתּ על דלתּ
דאַלעט אַמעס	דלתּ אַמות
דאַלעס	דלות
דאַלעס	דלות
דאַלפֿאָנים	דלפֿון
דאַלפֿן	דלפֿון
דאָם	דצ״ך עד״ש באח״ב: דם
דאַם / דאָם	דם
דאָמים	דם
דאַם־נידע	דם־נידה
דאַמסאָנים	דם־שׂונא
דאַמסױנע	דם־שׂונא
דאַמעסעק	דמשׂק
דאָן	דן
דאַן	דן —> דן זײַן
דאַניִעל	דניאל
דאַס	דת
דאַף	דף
דאַפּים	דף
דאַפֿקע	דװקא
דאַקע	דקה
דאַקע־מין־האַדאַקע	דקה־מן־הדקה
דאָר	דור
דאָר־דױרעס	דור־דורות
דאַרדעקע	דרדקי
דאַרדעקע־מעלאַמדים	דרדקי־מלמד
דאַרדעקע־מעלאַמעד	דרדקי־מלמד
דאָר־האַמאַבל	דור־המבול
דאָר־האַמידבער	דור־המידבר
דאָר־האַפֿלאָגע	דור־הפֿלגה
דאָרעם	דרום
דאַרקע־שאָלעם	דרכּי־שלום
דאַרשאָנים	דרשן
דאַרשן	דרשן
דאַרשע(נע)ן	דרשע(נע)ן
דגאָלים	דגל
דגושים	דגוש
דגײשים	דגש
דוגמאָעס	דוגמא
דוגמע	דוגמא
דװאַרטױרע	דבֿר־תּורה
דװאָרים	דבֿרים
דװאָרים־בטײלים	דבֿרים־בטלים
דװאָרים בעגײװ	דבֿרים בגװ
דװאָרים־בעטײלים	דבֿרים־בטלים
דװאָרים־גדױלים	דבֿר־גדול
דװאָרים האָאָמדים בערומע־שעלױלעם	דבֿרים העומדים ברומו־של־עולם
דװאָרים־קעהאַװאָיאָסן	דבֿרים־כּהװיותן
דװאָרים־קעיױסן	דבֿרים־כּהיותן
דװאָרים־שעביקדושע	דבֿר־שבקדושה
דװאַרכאָכמע	דבֿר־חכמה
דװאַרכאָל	דבֿר־חול
דװאַר־מאַלכעס	דבֿר־מלכות
דװאַרצדאָקע	דבֿר־צדקה
דװאַרשעקער	דבֿר־שקר
דװױרע	דבֿורה
דװױרע האַנעװיִע	דבֿורה הנבֿיאה
דװײקע(נע)ן	דבֿקע(נע)ן —> דבֿקע(נע)ן זיך
דװײקעס	דבֿקות
דױװ	דובֿ
דױװער־שקאָרים	דובֿר־שקרים
דױכע	דוחה —> דוחה זײַן
דױכעק	דוחק
דױכעק	דוחק —> דוחק זײַן
דױכע־שאַבעס	דוחה־שבת —> דוחה־שבת זײַן
דױמעם	דומם
דױפֿעק	דופֿק
דױרעס	דור
דױרעס	דורס —> דורס זײַן
דוכן	דוכן
דוכענען	דוכנען
דוקסים	דוכּוס
דוקעס	דוכּוס
דוקעסים	דוכּוס
דיבוקים	דיבוק
דיבורים	דיבור
דיבעק	דיבוק
דיבער	דיבור
דיװרע־האַיאָמים	דבֿרי־הימים
דיװרע־טױרע	דבֿר־תּורה
דיװרע־כאָכמע	דבֿר־חכמה
דיװרעכאָל	דבֿר־חול
דיװרע־מאַלכעס	דבֿר־מלכות
דיװרע־עלױקים־כאַיִם	דבֿרי־אלוקים־חײם
דיװרע־צדאָקע	דבֿר־צדקה
דיװרע־שעקער	דבֿר־שקר
דײַגע	דאגה
דײַגע(נע)ן	דאגה(נע)ן
דײַגעס־האַקלאַל	דאגת־הכּלל
דײַגעס־פּאַרנאָסע	דאגת־פּרנסה
דײַ־װעהױסער	די־והותר
דײע	דעה
דײַען	דײן
דײפֿעק	דפֿק
דײקע / דײַקע	דײקא
דילמאַטע	דלמטה
דילמײַלע	דלמעלה
דימיױנעס	דמיון
דימיען	דמיון
דין	דין
דין־װעכעזשבם	דין־וחשבון
דינטױרע	דין־תּורה
דינע	דינה
דינע־דעמאַלכעסע	דינא־דמלכותא
דינע־מאָמענעס	דיני־ממונות
דינע־נעפֿאָשעס	דיני־נפֿשות
דינע־קאַשרעס	דיני־כּשרות
דיצע	דיצה
דיקדוקים	דיקדוק
דיקדוקע־אַניִעס	דיקדוקי־עניות
דיקדעק	דיקדוק
דירע	דירה
דכאַק	דחק
דלילע	דלילה
דמײַ	דמאי
דע…	ד…
דעגל	דגל
דעהײַנע	דהײַנו
דעװער	דצ״ך עד״ש באח״ב: דבֿר
דעױרײַסע	דאורײַתא
דעלי	דלי
דעלי	מזל דלי
דע־לעאָן	זוהר: ר׳ משה די־ליאון
דעצאַך	סימן: ס׳איז אַ סימן־דצ״ך
דעצאַך אַדאַש בעאַכאַב	דצ״ך עד״ש באח״ב
דעקאַק	דק״ק
דעקעהילע־קדױשע	דק״ק: דקהילה־קדושה
דערהאַרגע(נע)ן	דערהרגע(נע)ן
דעריקער(שט)	עיקר: דער עיקר(שט)
דערעך	דרך
דערעך־אַגעװ	דרך־אַגבֿ
דערעך־אױלעם	דרך־עולם
דערעך־האָױלעם	דרך־העולם
דערעך־האַטעװע	דרך־הטבֿע
דערעך־האַיאָשער	דרך־הישר
דערעך־האַמײלעך	דרך־המלך
דערעך־האַסײכל	דרך־השׂכל
דערעך־האַשאָלעם	דרך־השלום
דערעך־מײלעך	דרך־מלך
דערעכערעץ	דרך־ארץ
דערעך־שאָלעם	דרך־שלום
דערקאַאַסן	דערכּעסן
דערראַגזע(נע)ן	דעררגזע(נע)ן
דראָכים	דרך
דראַש	דרש
דראָשע	דרשה
דראָשע	דרשה־געשאַנק
דרוש	דרוש
דריסעס־האָרעגל	דריסת־הרגל
דשאָיִם־װאַסאָװים	דשאָים־ועשׂבֿים

האַ…	ה…
האַאַזינו	האזינו
האָאַראַמי	לבֿן (האַרמי)
האַגאָדע	הגדה
האַגאָדע־שעל־פּײסעך	הגדה־של־פּסח
האַגאַם	הגם
האַגאָע	הגהה
האַגבאָע	הגבהה
האַגבע	הגבה
האַגדאָמע	הקדמה
האַגונים	הגון
האַגונע	הגון: הגונה
האָגן	הגון
האַדאַסים	הדס
האַדאַסע	הדסה
האַדגאָשע	הדגשה
האָד־מאַלכוסע	הוד־מלכותו
האָד־מאַלכעס	הוד־מלכות
האָדעס	הדס
האָדעסל	הדסל
האָדער	הדר
האַדראָגע	הדרגה
האַדראָכע	הדרכה
האַדרען	הדרן
האַדרעס־פּאָנעם	הדרת־פּנים
האַדרעס־פּענעמער	הדרת־פּנים
האַװאָלים	הבֿל
האַװאָנע	הבֿנה
האַװאָרע	הבֿרה
האַװדאָלע	הבֿדלה
האַװױעס־(האָ)ױלעם	הװיות־(ה)עולם
האַװײל־האַװאָלים	הבֿל־הבֿלים
האַװײַע	הװיה
האַװײַע	העװיה
האַזמאָנע	הזמנה
האָזע	העזה
האַזקאָרע	הזכּרה
האַזקאָרעס־נעשאָמעס	הזכּרת־נשמות
האַטאָקע	העתּקה
האַטיקװאָ	התּיקװה
האַיאָקער	היקר
האַיױצע לאָנו מיזע	היוצא לנו מזה
האַיױצע מידװאָרײנו	היוצא מדבֿרינו
האַיױצע מיזע	היוצא מזה
האַיִטאָכן	היתּכן
האַיעלעד אײנענו	הילד איננו
האָיִקער שאָכאַכטי	העיקר שכחתּי
האַכאָנע	הכנה
האַכאָסעם־מאַטאָ	החתום־מטה
האַכבאָדע	הכבדה
האַכלאָטע	החלטה
האַכנאָסע	הכנסה
האַכנאָסעס־אָרכים	הכנסת־אורחים
האַכנאָסעס־קאַלע	הכנסת־כּלה
האַכנאָע	הכנעה
האַכסומים־מאַטא	החתום־מטה
האַכראָזע	הכרזה
האַכראָע	הכרעה
האַכשאָרע	הכשרה
האַלאָכע	הלכה
האַלאָכע לעמױשע מיסינײַ	הלכה למשה מסיני
האַלאָצע	הלצה
האַלבאָשע	הלבשה
האַלװאָע	הלװאה
האַליטײני(ק)	הלעיטני(ק)
האַלמײַ	הלמאַי
האַלעװײַ	הלװאַי
האָלעך מױשע־מאָרטכע	הלך משה־מרדכי
האַלעל	הלל
האַלעלוּיאָ	הללױה
האַלעמײַ	הלמאַי
האַמאַװד(י)ל	המבֿדיל
האַמאַפּל	המפּיל
האַמאַפּע	רמ״א: המפּה
האַמױן	המון
האַמױן־אַם	המון־עם
האַמױצע	המוציא
האַמױצע	המוציא
האַמײליץ	המליץ
האַמײלעך	המלך
האַמכונע	המכונה
האַמעכונע	המכונה
האָמען	המן
האָמען האַראָשע	המן הרשע
האָמענטאַש	המן־טאַש
האַמעפֿאָרסעם	המפֿורסם
האַמעפֿורסעם	המפֿורסם
האַמצאָע	המצאה
האַנאָװי	הנבֿיא
האַנאָכע	הנחה
האַנאַל	הנ״ל
האַנאָע	הנאה
האַנהאָגע	הנהגה
האַניסקער לעײל	הנ״ל: הניזכּר לעיל
האַנעװיִע	הנבֿיאה
האַנע־מילע	הני־מילי
האַסאָגע	השׂגה
האַסאָגעס־גװוּל	הסגת־גבֿול
האַסבאָרע	הסברה
האַסכאָלע	התחלה
האַסמאָדע	התמדה
האַס־מילעהאַסקער	הס־מלהזכּר
האַסקאָלע	השׂכּלה
האַסקאָמע	הסכּמה
האַסקאָרע	הזכּרה
האַסקאָרעס־נעשאָמעס	הזכּרת־נשמות
האַסראָע	התראה
האַפּע שעאָסער האַפּע שעהיטער	הפּה שאָסר הפּה שהתּיר
האַפֿאָכים	היפּוך
האַפֿאָכים	הפֿך
האַפֿטאָכע	הבֿטחה
האַפֿטױרע	הפֿטורה
האַפֿלע־װאָפֿעלע	הפֿלא־ופֿלא
האַפֿסאָקע	הפֿסקה
האָפֿעך	הפֿוך
האַצאַדיק	הצדיק
האַצאָלע	הצלה
האַצלאָכע	הצלחה
האַצפֿירע	הצפֿירה
האַקאָדעש	הקדוש
האַקאָדעש־באָרכו	הקדוש־ברוך־הוא
האַקאָפֿע	הקפֿה
האָקיצאָ	הקיצה
האַקכאָשע	הכּחשה
האַקל־באַקל(־מיקל)	הכּל־בכּל(־מכּל)
האַקל־באַקל־מיקל־פֿלעקל	הכּל־בכּל־מכּל־פֿלעקל
האַקל מוכן	הכּל מוכן
האַקפּאָדע	הקפּדה
האַקצאַקאָסע	הכּצעקתה
האָראַװ	הרבֿ
האַראַס־אױלעם	הרת־עולם
האַראָשע	הרשע
האַרגע(נע)ן	הרגע(נע)ן
האַר־האַבאַיִס	הר־הבית
האַר־האַזײסים	הר־הזיתים
האַרוגים	הורג
האַרוגים	הרוג
האַרוגע	הרוגי־
האַריגע	הריגה
האַרײ־אַט (מעקודעשעס)	הרי־אַתּ (מקודשת)
האָרים־אוגװאָעס	הרים־וגבֿעות
האָרישן	הראשון
האַרכאָװע	הרחבֿה
האַרכאָװעדיק	הרחבֿהדיק
האַרכאָװעס־האַדאַאַס	הרחבֿת־הדעת
האַר־סעיִר	הר־שׂעיר
האָרעג	הרוג
האָרע־כױשעך	הרי־חושך
האַרקאָװע	הרכּבֿה
האַרשאָע	הרשאה
האַשאָװעס־אַװײדע	השבֿת־אַבֿדה
האַשאָרע	השערה
האַשאָרעס־האַנעפֿעש	השאָרת־הנפֿש
האַשבאָע	השבעה
האַשגאָכע	השגחה
האַשגאָכע־עליױנע	השגחה־עליונה
האַשגאָכע־פּראָטעס	השגחה־פּרטית
האַשטאָנע	השתּנה
האַשלאָמע	השלמה
האַשמאָטע	השמטה
האַשעם	ד׳
האַשעם	ה׳
האַשעם יאַצילײנו	השם יצילנו
האַשעם ײִנקאָם דאָמױ / דאָמאָם	הי״ד: השם ינקום דמו / דמם
האַשעם־ײִסבאָרעך	השם־יתברך
האַשעם ײִשמערײנו	השם ישמרנו
האַשעם יעראַכעם	השם ירחם
האַשפּאָע	השפּעה
האַשקאָמע	השכּמה
האַשקאָפֿע	השקפֿה
הו האַדין	הוא הדין
הױד	הוד
הױדאָע	הודאה
הױדאָע	הודעה
הױדע	הודו
הױדע	הודו
הױװע	הװה
הױלעך	הולך
הױלעכן	הולכן
הױלעך־ראָכ(י)ל	הולך־רכיל
הױן־ראַװ	הון־רבֿ
הױסאָפֿע	הוספֿה
הױצאָע	הוצאה
הױצאָעס־האַדערעך	הוצאָות־הדרך
הױראָע	הוראה
הױריִעס	הוריות
הױרעג	הורג
הױרעגן	הורגן
הױרעג־נעפֿאַשעס / ־נעפֿאָשעס	הורג־נפֿשות
הױשײַנע	הושענא
הױשײַנע־ראַבע	הושענא־רבה
הױשײע	הושע
הורדעס	הורדוס
הידורים	הידור
הידער	הידור
הײ	ה
הײ	הא
הײדעד	הידד
הײ־האַיעדיִע	הא־הידיעה
הײטעװ	היטבֿ
הײכאָלים	היכל
הײכאָלעס	היכל
הײכל	היכל
הײכל־האַקױדעש	היכל־הקודש
הײכע־טימצע	היכא־תּימצא
הײַנע	הײַנו
הײַנע־האַך	הײַנו־הך
הײַעם	היום
הײַעם־טעאַמצײנו	היום־תּאַמצנו
הײפּעך	היפּוך
הײפּעכדיק	היפּוכדיק
הילולע	הילולא
הילולע־װעכינגע	הילולא־וחינגא
הילכעס	הילכות
הילכעסע־לימשיכע	הילכתא־לימשיחא
הילעך	הילוך
הילעל	הלל
הילעל האַזאָקן	הלל הזקן
הינײ	הנה
היסבױדעדעס	התבודדות
היסבױנענעס	התבוננות
היסגאַלעס	התגלות
היסױרערעס	התעוררות
היסטאַדרוט	הסתּדרותּ
היסטאַלקעס	הסתּלקות
היסטאַפּקעס	הסתּפּקות
היסכאַסקעס	התחזקות
היסכײַװעס	התחײַבֿות
היסלײַװעס	התלהבֿות
היסמאַנעס	התמנות
היסנאַגדעס	התנגדות
היסנאַצלעס	התנצלות
היסנײַגעס	התנהגות
היספּײַלעס	התפּעלות
היסקאַרװעס	התקרבֿות
היסרױמעמעס	התרוממות
היפּוכים	היפּוך
היצטאַרכעס	הצטרכות
הירהורים	הירהור
הירהורע־אַװײרע	הירהור־עבֿירה
הירהורע־טשוּװע	הירהור־תּשובֿה
הירער	הירהור
הירער־אַװײרע	הירהור־עבֿירה
הירער־טשוּװע	הירהור־תּשובֿה
הישטאַדלעס	השתּדלות
הישטאַפּכעס	השתּפּכות
הישטאַפּכעס־האַלעװ	השתּפּכות־הלבֿ
הישטאַפּכעס־האַנעפֿעש	השתּפּכות־הנפֿש
העאָרע	הערה
העגדײשים	הקדש
העגדעש	הקדש
העדיױטים	הדיוט
העדיעט	הדיוט
העדיעט קױפֿעץ בעראָש	הדיוט קופֿץ בראָש
העװדײלים	הבֿדל
העװדל	הבֿדל
העװל	הבֿל
העװל	הבֿל
העװל־האַװאָלים	הבֿל־הבֿלים
העװל־האַװאָלימדיק	הבֿל־הבֿלימדיק
העזײקעס	היזק
העזעק	היזק
העטײרים	היתּר
העטער	היתּר
העטער־איסקע	היתּר־עיסקא
העטער־הױראָע	היתּר־הוראה
העטער־שכיטע	היתּר־שחיטה
העיױס	היות
העכרײעך	הכרח
העכרעך	הכרח
העכשײרים	הכשר
העכשער	הכשר
העמשײכים	המשך
העמשעך	המשך
הען	הן… הן…
הען־צעדעק	הן־צדק
העסאָפֿע	הוספֿה
העסעבעט	הסבֿ־בעט
העסעך־האַדאַאַס	היסח־הדעת
העספּײדים	הספּד
העספּעד	הספּד
העסקעם	הסכּם
העסקעם־קולעם	הסכּם־כּולם
העפֿסײדים	הפֿסד
העפֿסײקים	הפֿסק
העפֿסעד	הפֿסד
העפֿסעד־מערובע	הפֿסד־מרובה
העפֿסעק	הפֿסק
העפֿעך	הפֿך
העפֿקײרעס	הפֿקרות
העפֿקער	הפֿקר
העפֿקער	הפֿקר
העצאָע	הוצאה
העקײפֿים	היקף
העקעף	היקף
הערגײלים	הרגל
הערגל	הרגל
הערגל נאַאַסע טעװע	הרגל נעשׂה טבֿע
הערגל נײַסע טעװע	הרגל נעשׂה טבֿע
הערעג	הרג
הערעף־אַיִן	הרף־עין
העשײַנע	הושענא

װ…	ו…
װאַאַד	װעד
װאַאַד־אַרבאַ־אַראָצעס	װעד־אַרבע־אַרצות
װאַדים	װעד
װאָװ	ו
װאָװ	װאָװ
װאַטראָנים	װתּרן
װאַטראָנעס	װתּרנות
װאַטרען	װתּרן
װאַטרענטע	װתּרנטע
װאַיאָװע האָמען	ױבֿוא המן
װאַיאָכלו	ױאכלו
װאַיאַצמעך־פּורקאָנע	ױצמח־פּורקניה
װאַיאַקהעל	ױקהל
װאַײִגעש	ױגש
װאַײִװרעך	ױבֿרח
װאַײילעך	ױלך
װאַײיצע	ױצא
װאַײירע	ױרא
װאַײישעװ	ױשבֿ
װאַײִקראָ	ױקראָ
װאָײרע	וארא
װאַײִשלעך	ױשלח
װאַיִכעד־ײִסרעדיק	ױחד־יתרודיק
װאַיִסרױצעצו	ױתרוצצו
װאַיעכי	ױחי
װאַיִצאַקו	ױצעקו
װאָסיקים	װתיק
װאָסיקן	װתיק
װאָסעק	װתיק
װאָעסכאַנען	ואתחנן
װאַשטע	ושתּי
װדאָק	ודו״ק
װוּראַכעם	והוא־רחום
װידױִם	װידױ
װידע	װידױ
װידערקאָל	װידערקול
װידערקױלעס	װידערקול
װיטורים	װיתּור
װיטער	װיתּור
װײאָדער	ואָדר
װײַהי	ױהי
װײַהי האַיױם	ױהי היום
װײַהי ראָצן	ױהי רצון
װײַזאָסע	ױזתא
װײס	בית: בֿית
װײציטקאָסכע	וצדקתך
װײשעט	װשט
װיקוכים	װיכּוח
װיקועך	װיכּוח
װלאַד	װלד
װע…	ו…
װעאָהאַװטאָ לערעיאַכאָ קאָמױכאָ	ואָהבֿתּ לרעך כּמוך
װעאַל־קולעם	ועל־כּולם
װעדײַ לאַכקימע בירמיזע	ודי לחכּימא ברמיזא
װעדײַ לאַמײװן	ודי למבֿין
װעדײַ לאַנאָװן	ודי לנבֿון
װעדײַעק װעסימצע קאַל	ודו״ק: ודײק ותמצא קל
װעהאַיעלעד אײנענו	והילד איננו
װעהאָ־רײַע	והאָ־ראַיה
װעהאַשײנעס	והשנית
װעהײַעם	והיום
װעזױס־האַבראָכע	וזאת־הברכה
װעײנענו	ואיננו
װעכאָרעס	וכרות
װענאָסנו	ונתנו
װעסט	װסתּ
װעקעדױמע	וכּדומה

זאָהאָװ	זהבֿ
זאָהעװ	זהובֿ
זאָהעװ־טאָהער	זהבֿ־טהור
זאָהער־װעזאָהער	זהיר־וזהיר
זאָװים	זבֿים
זאָכיִעס(ן)	זכות
זאָכער	זכר
זאַכרעס	זכרות
זאַל	ז״ל
זאָל	זול
זאַלמען	זלמן
זאָנעװ	זנבֿ
זאַצאַל	זצ״ל
זאָקן	זקן
זאָקן	זקן
זאָקן־װעראָגל	זקן־ורגיל
זאָרעך	זרח
זאַרקען	זרקען
זגולע	סגולה
זוגאָסױ	זוגתו
זוגאָסי	זוגתי
זוגאָסכע	זוגתך
זוגעס	זוגות
זװאָכים	זבֿחים
זװוּלן	זבֿולן
זױ טױראָ װעזױ סכאָראָ	זו תּורה וזו שׂכרה
זױכע	זוכה —> זוכה זײַן
זױכע־בעגױרל	זוכה־בגורל —> זוכה־בגורל זײַן
זױלעל	זולל
זױלעל־װעסױװע	זולל־וסובֿא
זױלעל־װעסױװעניק	זולל־וסובֿאניק
זױנע	זונה
זױס־כאַנוקע	זאת־חנוכּה
זױער	זוהר
זיװ־האַשכינע	זיװ־השכינה
זיװוּגים	זיװג
זיװעג	זיװג
זײװ	זאבֿ
זײכער	זכר
זײכער־לעכורבם	זכר־לחורבן
זײכער צאַדיק לעװראָכע	זכר צדיק לבֿרכה
זײַען	ז
זײַען	זײן
זיכרױנאָם לעװראָכע	זכרונם לבֿרכה
זיכרױנע לעװראָכע	זכרונה לבֿרכה
זיכרױנע לעװראָכע	זכרונו לבֿרכה
זיכרױנעס	זכרונות
זילזולים	זילזול
זילזל	זילזול
זילפּע	זילפּה
זיקאָרן	זכּרון
זיקנע	זיקנה
זיקנע	זקנה
זכאָרים	זכר
זכאַריע	זכריה
זכױר־בריס	זכור־ברית
זכוס 	זכות
זכוס־אָװעס	זכות־אָבֿות
זכוס־אַצמע	זכות־עצמו
זכוס־האַקיִעם	זכות־הקיום
זכוסע יאָגן (אָלײנו)	זכותו יגן (עלינו)
זכוסעם יאָגן (אָלײנו)	זכותם יגן (עלינו)
זכיִע	זכיה
זמאַן	זמן
זמירעס	זמירות
זנאָװים	זנבֿ
זנוס	זנות
זע בעכױ װעזע בעכױ	זה בכה וזה בכה
זע בעקױ װעזע בעקױ	זה בכּה וזה בכּה
זע־האָרעגע	זה־הרגע
זעהוּװים	זהובֿ
זעהירעס	זהירות
זעמער	זמר
זע נױפֿל װעזע קאָם	זה נופֿל וזה קם
זערע	זרע
זערעש	זרש
זקאָנים	זקן
זקאָנע	זקנה
זקײנים	זקן
זקײנע	זקנה
זראָיִם	זרעים
זרובאָװל	זרובבֿל
זריִע	זריעה

טאַבאַאַס־האַמאַלכעס	טבעת־המלכות
טאַבאַאַס־ק(י)דושן	טבעת־קידושין
טאַבור־האָאָרעץ	טבור־האָרץ
טאַג	תּג
טאַגן	תּג
טאָהער	טהור
טאַז	ט״ז
טאַזריִע	תּזריע
טאַזריִע־מעצױרע	תּזריע־מצורע
טאָיאַנים	טוען
טאָך	תּוך
טאָך	תּוך־
טאַכבולע	תּחבולה
טאַכטױנים	תּחתּונים
טאַכלױִם־ראָיִם	תּחלואים־רעים
טאַכלײסים	תּכלית
טאַכלעס	תּכלית
טאַכלעס־סינע	תּכלית־שׂינאה
טאַכנונים	תּחנונים
טאַכנע	תּנחום
טאַכנען	תּחנון
טאַכסיסע־מילכאָמע	תּכסיסי־מלחמה
טאָכעס	תּחת
טאָכעס	תּחת
טאָך־קאָלהאַטױכעס	תּוך־כּל־התּוכות
טאָך־קעדײדיבער	תּוך־כּדי־דיבור
טאַכריכים	תּכריכים
טאַכריכים	תּכריכים־שטעך
טאַכשיטים	תּכשיט
טאַכשיטן	תּכשיט
טאַכשעט	תּכשיט
טאַל	טל
טאַל־אומאָטער	טל־ומטר
טאָלדעס	תּולדות
טאַל־װעמאָטער	טל־ומטר
טאַליאָנים	תּלין
טאַלײסים	טלית
טאַלײסים־קטאַנים	טלית־קטן
טאַליען	תּלין
טאַלמוד	תּלמוד
טאַלמוד־באַװלי	תּלמוד־בבֿלי
טאַלמוד־יערושאַלמי	תּלמוד־ירושלמי
טאַלמידים	תּלמיד
טאַלמידים־מוּװאָקים	תּלמיד־מובֿהק
טאַלמידע	תּלמידה
טאַלמידע־כאַכאָמים	תּלמיד־חכם
טאַלמעד	תּלמיד
טאַלמעד־כאָכעם	תּלמיד־חכם
טאַלמעד־מוּװעק	תּלמיד־מובֿהק
טאַלמעטױרע	תּלמוד־תּורה
טאָלע	מזל טלה
טאָלע	תּלױ
טאָלע	תּלױ
טאָלע־בעדאָװער	תּלױ־בדבֿר
טאַלעס	טלית
טאַלעס־קאָטן	טלית־קטן
טאַם	טעם
טאַם	טעם
טאַם	תּם
טאַמאַרע	תּמרה
טאַם־װענישלעם	תּם־ונ(י)שלם
טאָמע	טמא
טאָמע	טמא
טאָמעד	תּמיד
טאַמעװאַטע	תּמעװאַטע
טאַמעז	תּמוז
טאַמען	תּמען
טאָמעניק	טמאניק
טאָמער	תּמר
טאַמצײסים	תּמצית
טאַמצעס	תּמצית
טאַנאָיִם	תּנא
טאַנאַך	תּנך / תּנ״ך
טאַנאַכיש	תּנכיש
טאַנאַצבע	תּנצב״ה
טאָנו ראַבאָנאָן	תּנו רבנן
טאַנײסים	תּענית
טאַנכעם	תּנחום
טאַנע	תּנא
טאַנעבאַרע	תּנא־ברא
טאָנעס	תּענית
טאַנעס־טשוּװע	תּענית־תּשובֿה
טאַנעס־ציבער	תּענית־ציבור
טאָעס	טעות
טאָעס־האַטפֿוס	טעות־הדפֿוס
טאָף	תּ
טאָף	תּװ
טאָפֿל	טפֿל
טאַפֿסאָנים	תּפֿסן
טאַפֿסן	תּפֿסן
טאַפֿסע(נע)ן	תּפֿסע(נע)ן
טאָפֿעס	תּפֿוס
טאַק	תּ״ק
טאַקאָנע	תּקנה
טאַקעף	תּקיף
טאַקעף־בעדאַטע	תּקיף־בדעתּו
טאַרבוט־שול	תּרבות־שול
טאַרבוס־שול	תּרבות־שול
טאַרבעס	תּרבות
טאַרגעם	תּרגום
טאַרגעם־אונקלעס	תּרגום־אונקלוס
טאַרגעם־האַשיװים	תּרגום־השיבֿעים
טאַרגעם־יױנעסן	תּרגום־יונתן
טאַרגעם־לאָשן	תּרגום־לשון
טאַרגעם־שײני	תּרגום־שני
טאַרומעס	תּרעומות
טאַרטע־דעסאַסרע	תּרתּי־דסתרי
טאַריאַג מיצװעס	תּרי״ג מיצװת
טאַרנעגױלים	תּרנגול
טאַרנעגל	תּרנגול
טאַרע	טהרה
טאַרע־ברעט	טהרה־ברעט
טאָרעד	טרוד
טאַרעס	טהרות
טאַרעס־האַמישפּאָכע	טהרת־המשפּחה
טאַרע־שטיבל	טהרה־שטיבל
טאַרפּאַט (אַלאָפֿים)	תּרפּ״ט (אַלפֿים)
טאַרפֿעס	טרפֿות
טאַשלעך	תּשליך
טאַשמישע־קדושע	תּשמישי־קדושה
טאַשמעש(־האַמיטע)	תּשמיש(־המיטה)
טאַשראַק	תּשר״ק
טהאָם	תּהום
טהאָרעס	טהרות
טו	ט״ו
טו בישװאַט	ט״ו בשבֿט
טוּװײ־האָיִר	טובֿי־העיר
טוּװיע	טובֿיה
טװוּל־יאָם	טבֿול־יום
טװוּנע	תּבֿונה
טװוּע	תּבֿואה
טװילע	טבֿילה
טװיִע	תּבֿיעה
טװיִעס־אַיִן	טבֿיע(ו)ת־עין
טװעריע	טבֿריה
טױגער	תּוגר
טױװאַאַס־בעפּע	תּובֿעת־בפּה
טױו־װאָװױו	תּוהו־ובֿוהו
טױװײע	תּובֿע
טױװײע־בעפּע	תּובֿע־בפּה —> תּובֿע־בפּה זײַן
טױװים	תּובֿע
טױװיע	טובֿיה
טױװל	טובֿל —> טובֿל זײַן
טױװלען	טובֿלען
טױװע	טובֿה
טױװעס־האַנאָע	טובֿת־הנאה
טױװעס־האַקלאַל	טובֿת־הכּלל
טױכן	תּוכן
טױכן־האָיִניאָנים	תּוכן־הענינים
טױכעכע	תּוכחה
טױמים	מזל תּאומים
טױמים	תּאומים
טױסעפֿעס	תּוספֿות
טױע	טועה —> טועה זײַן —> זײַן זיך
טױעװױע	תּוהו־ובֿוהו
טױעם	טועם —> טועם זײַן
טױעם־טאַם	טועם־טעם —> טועם־טעם זײַן
טױען	טוען
טױפֿעס	תּופֿס —> תּופֿס זײַן
טױרע	תּורה
טױרע	תּורה
טױרע אוגדולע בעמאָקעם עכעד	תּורה וגדולה במקום אחד
טױרעס־כאַיִם	תּורת־חײם
טױרעס־לאָקשן	תּורת־לאָקשן
טױרעס־מױשע	תּורת־משה
טױרעס־מױשע עמעס	תּורת־משה אמת
טױרע־קולע	תּורה־כּולה
טױרע־שעבאַלפּע	תּורה־שבעל־פּה
טױרע־שעביקסאַװ	תּורה־שבכּתבֿ
טױשאָװים	תּושבֿ
טױשװים	תּושבֿ
טױשעװ	תּושבֿ
טומטעם	טומטום
טומע	טומאה
טיװיעס	טיבֿיעות
טיטעס האַראָשע	טיטוס הרשע
טײַװע	תּאװה
טײװע	תּבֿה
טײװעס	טבֿת
טײַמים	טעם
טײַמים	טעמים
טײמען	תּימן
טײַנוגים	תּענוג
טײַנע	טענה
טײַנע־אומײַנע	טענה־ומענה
טײַנעג	תּענוג
טײַנען	טענהן
טײַנעס־אוטװיִעס	טענות־ותּבֿיעות
טײקו	תּיקו
טײקעף	תּיכּף
טײקעף־אומיִיאַד	תּיכּף־ומיד
טיכיע	תּחיה
טילטל־האַדערעך	טילטול־הדרך
טילים	תּהילים
טימכע	תּימחה
טינױפֿעס	טינופֿת
טינױקעס	תּינוק
טינױקעסל	תּינוקתל
טינױקעס־שעל־בײסראַבאָן	תּינוקות־של־בית־רבן
טינעף	טינוף
טינעק	תּינוק
טיסכאַדעש	תּתחדש
טיפּע	טיפּה
טיפּע־מין־האַיאַם	טיפּה־מן־הים
טיפּע־סרוכע	טיפּה־סרוחה
טיפּעש	טיפּש
טיפּשים	טיפּש
טיפּשע	טיפּשה
טיפּשעס	טיפּשות
טיפֿלע	תּיפֿלה
טיפֿערעס	תּפֿארת
טיקונים	תּיקון
טיקונע־זױער	תּיקוני־זוהר
טיקן	תּיקון
טיקן־טאָעס	תּיקון־טעות
טיקן־כצאָס	תּיקון־חצות
טיקן־(לײל־) שװוּעס	תּיקון־(ליל־)שבֿועות
טירדע	טירדה
טירופֿים	טירוף
טירכע	טירחה / טירחא
טירעף	טירוף
טירעף־האַדאַס	טירוף־הדעת
טישבאָכעס	תּשבחות
טישבױרעס	תּשבורת
טישבי	תּישבי
טישים	תּישעים
טישע	תּישעה
טישעבאָװ	תּישעה־באָבֿ
טישרע	תּישרי
טכאַק	דחק
טכום	תּחום
טכום־האַמױשעװ	תּחום־המושבֿ
טכום־שאַבעס	תּחום־שבת
טכונע	תּכונה
טכײלעס	תּכלת
טכילעס	תּחילת
טכינע	תּחינה
טכיִעס־המײסים	תּחית־המתים
טליִע	תּליה
טלע	טלה
טמונעס־אָס	תּמונת־אות
טמורע	תּמורה
טמיכע	תּמיכה
טמימעס	תּמימות
טמיִע	תּמיה
טמעיִם	טמא
טנאָיִם	תּנאַי
טנאָיִם	תּנאָים
טנאָיִם	תּנאָים
טנוע	תּנועה
טנײַ	תּנאַי
טנײַ־געט	תּנאַי־גט
טעהױרים	טהור
טעהי נישמאָסע צרורע ביצרױר האַכאַיִם	תּנצב״ה: תּהי נשמתו / נשמתה צרורה בצרור החײם
טעװיע	טבֿיה
טעװע	טבֿע
טעוסים	טעות
טעכעסל	תּחת : דימינוטיװ תּחתל
טעכעסער	תּחת
טעל	תּל
טעלאַװיװ	תּל־אַבֿיבֿ / ־אָבֿיבֿ
טעל־אױלעם	תּל־עולם
טענאַך	תּנך / תּנ״ך
טענאַצװע	תּנצב״ה
טעס	ט
טעס	טית
טעפֿעך	טפֿח
טעצאַװע	תּצוה
טעקאָלע	תּקלה
טעראַך	תּרח
טערוצים	תּירוץ
טערעכטע	תּרחטע
טערעץ	תּירוץ
טערעץ־מאַספּיק	תּירוץ־מספּיק
טפֿאָכים	טפֿח
טפֿוצעס־האָאָרעץ	תּפֿוצות־האָרץ
טפֿוצעס־ײִסראָעל	תּפֿוצות־ישׂראל
טפֿײלים	טפֿל
טפֿילן	תּפֿילין
טפֿילע	תּפֿילה
טפֿילע־בעציבער	תּפֿילה־בציבור
טפֿילע־זאַקע	תּפֿילה־זכּה
טפֿילעס־האַדערעך	תּפֿילת־הדרך
טפֿיסע	תּפֿיסה
טפֿיסעניק	תּפֿיסהניק
טקומע	תּקומה
טקופֿע	תּקופֿה
טקופֿעס־טאַמעז	תּקופֿת־תּמוז
טקופֿעס־טײװעס	תּקופֿת־טבֿת
טקופֿעס־טישרע	תּקופֿת־תּישרי
טקופֿעס־ניסן	תּקופֿת־ניסן
טקיִע	תּקיעה
טקיִע־גדױלע	תּקיעה־גדולה
טקיִעס־קאַף	תּקיעת־כּף
טקיפֿים	תּקיף
טקיפֿעס	תּקיפֿות
טרודים	טרוד
טרומע	תּרומה
טרומעס	תּרומות
טרוע	תּרועה
טרופֿע	תּרופֿה
טרײף	טריף
טרײף־פּאָסל	טריף־פּסול
טרײפֿן	טריפֿן
טרײפֿניאַק	טריפֿניאַק
טרײפֿע	טריפֿה
טרײפֿעניצע	טריפֿהניצע
טרײפֿענער	טריפֿן: טריפֿנער
טשאָיִם־װאַסאָװים	דשאָים־ועשׂבֿים
טשוּװע	תּשובֿה
טשוּװע־ברורע	תּשובֿה־ברורה
טשועס־כײן	תּשואות־חן
טשוקע	תּשוקה

יאַאַדעס	יהדות
יאַאַמױד	יעמוד
יאַבאָשע	יבשה
יאַבעבאָ	יכּכּה: בײַ אים איז יכּכּה און יבבה
יאָגן־װאַאַנאָכע	יגון־ואַנחה
יאַד	יד
יאַד	יד
יאָדאַיִם	יד
יאָדאַיִם	ידים
יאַדאַכעס	יד־אַחת
יאַדאָנים	ידען
יאַדאָנעס	ידענות
יאַד־האַכאַזאָקע	יד־החזקה
יאָדים	יודע
יאַדן	ידען
יאָדע־כײן	יודע־חן
יאָדע־נאַגײן	יודע־נגן
יאָדע־סײפֿער	יודע־ספֿר
יאָװן	יװן
יאָװן	יװן
יאַװנע	יבֿנה
יאָװע יױמע	יבֿוא יומו
יאַיִן	ײן
יאַיִן־האַמשומער	ײן־המשומר
יאַיִן־נעסעך	ײן־נסך
יאַיִן־סאָרעף	ײן־שׂרף
יאַיִן־קאַפֿריסן	ײן־קפֿריסין
יאַכאַלױקו	יחלוקו
יאַכדעװ	יחדיו
יאָכװעט	יוכבֿד
יאָכלוהו	יאכלוהו
יאָכלען	יכלען
יאַכסאָנים	יחסן
יאַכסאָנעס	יחסנות
יאַכסן	יחסן
יאַכסנטע	יחסנטע
יאַכסענען	יחסנען —> יחסנען זיך
יאָכעד	יחיד
יאָכעד־בעדאָר	יחיד־בדור
יאָכעד־בעמינע	יחיד־במינו
יאָכעװעד	יוכבֿד
יאָכפֿעט	יוכבֿד
יאָלדעס	יולדת
יאַלקוטים	ילקוט
יאַלקעט	ילקוט
יאָם	יום
יאַם	ים
יאָם אַלעף	א: יום א׳
יאַם־אָקיאָנעס	ים־אוקינוס
יאָם בײס	ב: יום ב׳
יאָם גימל	ג: יום ג׳
יאָם דאַלעט	ד: יום ד׳
יאַם־האַגאָדל	ים־הגדול
יאָם־האַדין	יום־הדין
יאַם־האַטיכױן	ים־התּיכון
יאַם־האַמעלאַך	ים־המלח
יאַם־האַקאָרעש	ים־הקרוש
יאַם־האַקעראַך	ים־הקרח
יאָם הײ	ה: יום ה׳
יאָם װאָװ	ו: יום ו׳
יאָם־װאָלײַלע	יום־ולילה
יאָמים	יום
יאַמים־אומידבאָריעס	ימים־ומידבריות
יאָמים־װעשאָנים	ימים־ושנים
יאָמים־טױװים	יום־טובֿ
יאָמים־נעראָיִם	ימים־נוראָים
יאָמים־נעראָיִמדיק	ימים־נוראָימדיק
יאַם־כאַזײרימלעך	ים־חזירל
יאַמכאַזערל	ים־חזירל
יאַמסוף	ים־סוף
יאָמקיפּער	יום־כּיפּור
יאָמקיפּער־קאָטן	יום־כּיפּור־קטן
יאַם שעל שלױמע	ים של שלמה
יאַנדעס	יהדות
יאָנטױװים	יום־טובֿ
יאָנטעװ	יום־טובֿ
יאָנטעװן	יום־טובֿן
יאָנקיפּער	יום־כּיפּור
יאָנקיפּער־קאָטן	יום־כּיפּור־קטן
יאַנקעװ	יעקבֿ
יאַנקעװ אָװינו	יעקבֿ אָבֿינו
יאָסעם	יתום
יאָסעמדיק	יתומדיק
יאָסעף	יוסף
יאָסעף דעלע רײנע	יוסף דילה רײנה
יאָסעף האַצאַדיק	יוסף הצדיק
יאָצע־מידאַטע	יצא־מדעתּו װערן
יאָצרעס	יוצר
יאַקיר	יקיר
יאַקנעהאָז	יקנה״ז
יאַקעקאָ	יכּכּה
יאַקראָנים	יקרן
יאַקרען	יקרן
יאַקרעס	יקרות
יאָר־אײדעס	יאָר־עדות —> עדות
יאָרדים	יורד
יאַרדן	ירדן
יאַריד	יריד
יאָרע־כעט	ירא־חטא
יאָרעם־הױדע	ירום־הודו
יאָרע־שאָמאַיִם	ירא־שמים
יאָרשים	יורש
יאַרשע(נע)ן	ירשע(נע)ן
יאַש	יש  / י״ש
יאָשװים	יושבֿ
יאָשװע־אױעל	יושבֿ־אוהל
יאָשן־נױשן	ישן־נושן
יאָשער	ישר
יאַשער־קױעך	ײשר־כּוח
יאָשעש	ישיש
יאַשראָנים	ישרן
יאַשראָנעס	ישרנות
יאַשרען	ישרן
יוד	י
יוד	יוד
יודיס	יהודית
יודעס	יהודית
יױװל	יובֿל
יױכענען	יוחנן
יױכענען בען־זאַקײַ	יוחנן בן־זכּאי
יױמע	יומא
יױמע־דעפּאַגרע	יומא־דפּגרא
יױמעם־װאָלײַלע	יומם־ולילה
יױנאָסן	יונתן
יױנע	יונה
יױנעסן	יונתן
יױנעק	יונק —> יונק זײַן
יױסעף	יוסף
יױסעף דעלע רײנע	יוסף דילה רײנה
יױסעף האַצאַדיק	יוסף הצדיק
יױעל	יואל
יױעץ	יועץ
יױפֿע	יופֿי
יױצים־מין־האַקלאַל	יוצא־מן־הכּלל
יױצע	יוצא
יױצע	יוצא —> יוצא זײַן
יױצע־דױפֿן	יוצא־דופֿן
יױצע־װעניכנעס	יוצא־ונכנס
יױצע־מין־האַקלאַל	יוצא־מן־הכּלל
יױצע־מיצראַיִם	יוצאי־מצרים
יױצער	יוצר
יױצער־מעשאָרסים (װאַשער מעשאָרסאָװ)	יוצר־משרתים
יױרעד	יורד
יױרע־דײע	יורה־דעה
יױרעש	יורש
יױרעשטע	יורשטע
יױרעש־עצער	יורש־עצר
יױשעװ	יושבֿ
יױשעװ־אױעל	יושבֿ־אוהל
יױשעװ־ראָש	יושבֿ־ראָש
יױשער	יושר
ײִבעם	יבום
ײִגדאַל	יגדל
ײִטושים	ײִתּוש
ײִטער	ײִתּור
ײִטעש	ײִתּוש
יײַװער אָלײַ מאָ	יעבֿור עלי מה
יײַלע	יעלה
יײַלע־װעיאָװע	יעלה־ױבֿא
ײיעש	ײִאוש
ײיצער־האָרע	יצר־הרע
ײיצער־טאָװ / ־טױװ	יצר־טובֿ
ײישו (האַנױצרי)	ישו
ײִכודים	ײִחוד
ײִכיע	יחיה
ײִכעד	ײִחוד
ײִכעס	ײִחוס
ײִכעס	ײִחוס־בריװ
ײִכעס־אַצמע	ײִחוס־עצמו
ײִכעסן	ײִחוסן —> ײִחוסן זיך
ײִמאַך־שמאָם	ימח־שמם
ײִמאַך־שמאָם־װעזיכראָם	ימח־שמם־וזכרם
ײִמאַך־שמױ	ימח־שמו
ײִמאַך־שמױ	ימח־שמו
ײִמאַך־שמױ־װעזיכרױ	ימח־שמו־וזכרו
ײִמאַכשמױניצע	ימח־שמוניצע
ײִמאַכשמױניק	ימח־שמוניק
ײִמאַך־שעמאָם	ימח־שמם
ײִמאַך־שעמאָם־װעזיכראָם	ימח־שמם־וזכרם
ײִמאַך־שעמױ	ימח־שמו
ײִמאַך־שעמױ	ימח־שמו
ײִסאָ(ס)כער	ישׂשׂכר
ײִסקער	יזכּור
ײִסקער	יזכּור־בוך
ײִסראָײלי	ישׂראלי
ײִסראָעל	ישׂראל
ײִסרױנעס	יתרון
ײִסרע	יתרו
ײִסרעײליס	ישׂראלית
ײִסרען	יתרון
ײִעש	ײִאוש
ײִפֿטאַך	יפֿתּח
ײִצכאָק	יצחק
ײִצכאָק אָװינו	יצחק אָבֿינו
ײִצכאָקי	רש״י: ר׳ שלמה יצחקי
ײִרגאָזן	ירגזון
ײִרמיאָהו	ירמיהו
ײִרמיִע	ירמיהו
ײִרע	ײִראה
ײִרע־כעט	ירא־חטא
ײִרעס־האַקאָװעד	ײִראת־הכּבֿוד
ײִרעס־האַשעם	ײִראת־השם
ײִרעס־שאָמאַיִם	ײִראת־שמים
ײִרע־שאָמאַיִם	ירא־שמים
ײִשאָקײני	ישקני
ײִשו (האַנױצרי)	ישו
ײִשוּװים	ײִשובֿ
ײִשוּװניצע	ײִשובֿניצע
ײִשוּװניק	ײִשובֿניק
ײִשמאָעל	ישמעאל
ײִשעװ	ײִשובֿ
ײִשעװ	ײִשובֿ
ײִשעװ־האַדאַאַס	ײִשובֿ־הדעת
ײִשעװן	ײִשובֿן —> ײִשובֿן זיך
יעגיִעס־קאַפּאַיִם	יגיעת־כּפּים
יעגיִעס־קאַפּע	יגיעת־כּפּו
יעגיִעס־קאַפּעװ	יגיעת־כּפּיו
יעגיִע־קאַפּאַיִם	יגיע־כּפּים
יעגיִע־קאַפּאַיִמניק	יגיע־כּפּימניק
יעגיִע־קאַפּע	יגיע־כּפּו
יעגיִע־קאַפּעװ	יגיע־כּפּיו
יעדוע	ידוע
יעדוע־לאַקל	ידוע־לכּל
יעדיד	ידיד
יעדידי	ידידי
יעדידים־נעמאָנים	ידיד־נאמן
יעדידיע	ידידיה
יעדיד־נעמען	ידיד־נאמן
יעדײע	יודע
יעדײע	יודע —> יודע זײַן
יעדײע־האַקל	יודע־הכּל
יעדײע־כײן	יודע־חן
יעדײע־נאַגײן	יודע־נגן
יעדײע־סײפֿער	יודע־ספֿר
יעדײע־שעײנע־יעדײע	יודע־שאינו־יודע
יעדיִע	ידיעה
יעהודי	יהודי
יעהודיס	יהודית
יעהודע	יהודה
יעהודע האַכאָסיד	יהודה החסיד
יעהודע האַלײװי	יהודה הלװי
יעהודע האַמאַקאַבי	יהודה המכּבי
יעהודע האַנאָסי	יהודה הנשׂיא
יעהױנעסן	יהונתן
יעהױעש	יהואש
יעהױשוע	יהושע
יעהי	יהי
יעהי־אױר	יהי־אור
יעהי־ראָצן	יהי־רצון
יעװאָמעס	יבֿמות
יעװאָנים	יװן
יעװאָניש	יװניש
יעװאָרעכעכאָ	יבֿרכך
יעכױלעס	יכולת
יעכידים	יחיד
יעכידע־זגולע	יחידי־סגולה
יעכיִעל	יחיאל
יעכעסקל	יחזקאל
יעלאָדים	ילד
יעלאָלע	יללה
יעלאַמדײנע	ילמדנו
יעלוד־אישע	ילוד־אישה
יעלעד	ילד
יעלעד־שאַאַשױִם	ילד־שעשועים
יעמײ	ימי־
יענוקע	ינוקא
יעניקע	יניקה
יעסאָד	יסוד
יעסױדעס	יסוד
יעסױמים	יתום
יעסױמע	יתומה
יעסורים	יסורים
יעסורים־ראָיִם	יסורים־רעים
יעסורים־שעל־אַ(ה)אַװע	יסורים־של־אַהבֿה
יעפֿאַסטױער	יפֿת־תּואר
יעפֿײפֿיִע	יפֿהפֿיה
יעפֿײפֿע	יפֿהפֿיה
יעפֿעס	יפֿת
יעציִעס־האַנעפֿעש	יציאת־הנפֿש
יעציִעס־מיצראַיִם	יציאת־מצרים
יעציִעס־נעשאָמע	יציאת־נשמה
יעצירע	יצירה
יעקאַר־האַמציִעס	יקר־המציאות
יעקום־פּורק(אָ)ן	יקום־פּורקן
יעקוסיִעל	יקותיאל
יעקירי	יקירי
יעראָװאָם בען־נעװאָט	ירבֿעם בן־נבֿט
יעראַכמיִעל	ירחמיאל
יערוכעם	ירוחם
יערושאָלאַיִם	ירושלים
יערושאָלאַיִם־דע	ירושלים־ד…
יערושאָלאַיִם־דעליטע	ירושלים־דליטא
יערושאַלמי	ירושלמי
יערושע	ירושה
יעריד	יריד
יערידע	ירידה
יעריכע	יריחו
יעריִע	יריעה
יעש	יש
יעשאַיאָהו	ישעיהו
יעש אָמרים	יש אומרים
יעש־אָמרים	יש־אומרים
יעשוע	יהושע
יעשוע	ישועה
יעשועס־װענעכאָמעס	ישועות־ונחמות
יעשיװע	ישיבֿה
יעשײַע	ישעיה
יעשישים	ישיש
יעש־מעאַיִן	יש־מאַין

כאַבאַד	חב״ד
כאַבאַדניצע	חבדניצע
כאַבאַדניק	חבדניק
כאַבאַדער	חבדער
כאַגאָעס	חגא
כאַג־האָאָסיף	חג־האָסיף
כאַג־האַביקורים	חג־הביכּורים
כאַג־האַמאַצעס	חג־המצות
כאַגיגע	חגיגה
כאָגע	חגא
כאַגע	חגי
כאַדאָרים	חדר
כאַדאָרים־מעסוקאָנים	חדר־מתוקן
כאַדאָשים	חודש
כאַדאָשעס	חדשות
כאַד־בעדאָרע	חד־בדרא
כאַד־גאַדיע	חד־גדיא
כאַדראַג	חדר״ג
כאַדרע־כאַדאָרים	חדרי־חדרים
כאַװוּרע	חבֿורה
כאַװײרים	חבֿר
כאַװײרים־לעדײע	חבֿר־לדעה
כאַװײרע	חבֿרה
כאַװע	חװה
כאָװעװע־ספֿאַס־אײװער	חובֿבֿי־שׂפֿת־עבֿר
כאָװעװע־ציִען	חובֿבֿ־ציון
כאַװעס־דאַאַס	חװת־דעת
כאָװער	חבֿר
כאַװער	חבֿר
כאַװערטאָרן	חבֿרטאָרין
כאַװערטע	חבֿרטע
כאַװעריש	חבֿריש
כאַװער־לאַװער	חבֿר  —> זײַן מיט עמעצן חבֿר־לאַװער
כאַװערלאַפּ	חבֿר  —> זײַן מיט עמעצן חבֿר־לאַפּ
כאַװער־לעדײע	חבֿר־לדעה
כאַװערן	חבֿרן —> חבֿרן זיך
כאַװערשאַפֿט	חבֿרשאַפֿט
כאַװקוק	חבֿקוק
כאַװרוסע	חבֿרותא
כאַזאַל	חז״ל
כאַזאָנים	חזן
כאַזאָניש	חזניש
כאַזאָנעס	חזנות
כאַזאַק	חזק
כאַזאָקע	חזקה
כאַזאָרע	חזרה
כאַזאָרעס־האַשאַץ	חזרת־הש״ץ
כאַזײרים	חזירים —> חזיר
כאַזן	חזן
כאַזנטע	חזנטע
כאַזנטעס	חזנטעס —> חזנטע
כאַזער	חזיר
כאַזערטע	חזירטע
כאַזערטעס	חזירטעס —> חזירטע
כאַזערײַ	חזירײַ
כאַזערײַען	חזירײַען —> חזירײַ
כאַזעריש	חזיריש
כאַזערישן	חזירישן —> חזיריש
כאַזערישע	חזירישע —> חזיריש
כאַזערישער	חזירישער —> חזיריש
כאַזערן	חזרן
כאַזערסט	חזרסט —> חזרן
כאַזערט	חזרט —> חזרן
געכאַזערט	געחזרט —> חזרן
כאַזערנדיק	חזרנדיק —> חזרן
כאַזערניצע	חזירניצע
כאַזערניצעס	חזירניצעס —> חזירניצע
כאַזערניק	חזירניק
כאַזערניקעס	חזירניקעס —> חזירניק
כאָזרים	חוזרים —> חוזר
 כאָזרים־ביטשוּװע	חוזר־בתּשובֿה
כאַטאָיִם	חטא
כאָטאָסי	חטאָתי
כאָטים	חוטא
כאַטעס־נעורים	חטאת־נעורים
כאַטעף	חטף
כאַיאָװים	חײבֿ
כאַיאָטים	חײט
כאַיאָלעס	חײל
כאַיונע	חיונה
כאַיִל	חײל
כאַיִם	חײם
כאַיעשאָ	חײ־שעה
כאַיִש	חײִש
כאַכאָמײנו —> כאַכאָמײנו זיךרױנעם לעװראָכע	חז״ל: חכמינו זכרונם לבֿרכה
כאַכאָמים	חכם
כאַכאָמים־אַטיקים	חכם־עתּיק
כאַכאָמים־מופֿלאָגים	חכם־מופֿלג
כאַכאָמע	חכמה
כאַכײמעס	חכמת
כאָכמאַניס	חכמנית
כאָכמאַניִעס	חכמנית
כאָכמע	חכמה
כאַכמע־האַטאַלמוד	חכמי־התּלמוד
כאַכמע־האַלעזשאַנקע	חכמי־הלעזשאַנקע
כאַכמע־ײִסראָעל	חכמי־ישׂראל
כאָכמע־כיצױנעס	חכמה־חיצונית
כאָכמע־ניסטערעס	ח״ן: חכמה־נסתּרת
כאָכמע(נע)ן	חכמה(נע)ן —> חכמה(נע)ן זיך
כאָכמעס־האַ…	חכמת־ה…
כאָכמעס־האַטכונע	חכמת־התּכונה
כאָכמעס־האַיאַאַדעס	חכמת־היהדות
כאָכמעס־האַיאַד	חכמת־היד
כאָכמעס־האַכעזשבם	חכמת־החשבון
כאָכמעס־האַכעזשבם־װעהאַמדידע	חכמת־החשבון־והמדידה
כאָכמעס־האַפּאַרצעף	חכמת־הפּרצוף
כאָכמעס־יאָװן	חכמת־יװן
כאָכמעס־כיצױניִעס	חכמה־חיצונית
כאָכעם	חכם
כאָכעם־אַטעק	חכם־עתּיק
כאָכעם־באַלײַלע	חכם־בלילה
כאָכעם־לעהאָרע	חכם־להרע
כאָכעם־מופֿלעג	חכם־מופֿלג
כאַל	חל —> חל זײַן
כאַלאָיִם	חולה
כאַלאַס	חלאַת
כאַלאָפֿים	חלף
כאַלאָקים	חלק
כאַלאָשעס	חלשות
כאַלאָשעסדיק	חלשותדיק
כאַלױמעס	חלום
כאַלוצים	חלוץ
כאַלוצע	חלוצה
כאַלוקע	חלוקה
כאַלושים	חלוש
כאָלילע	חלילה
כאָלילע־װעכאַס	חלילה־וחס
כאָליען	חליען
כאַליצע	חליצה
כאַלע	חלה
כאָלעל	חלל
כאָלעם	חלום
כאַלעמױד	חול־המועד
כאָלעמױד	חול־המועד
כאָלעמען	חלומען
כאַלעף	חלף
כאָלעץ	חלוץ
כאָלעש	חלוש
כאַלעשן	חלשן
כאָלעש־רײע	חלוש־ריאה
כאַלפֿאָנים	חלפֿן
כאַלפֿאָנעס	חלפֿנות
כאַלפֿן	חלפֿן
כאָלקים	חולק
כאַם	חם
כאָמדע־מאָמען	חומד־ממון
כאַמױ(ע)ר	חמור
כאַמױרים	חמור
כאַמױריש	חמוריש
כאַמישאָסער (בישװאַט)	חמישה־עשׂר
כאַמישי	חמישי
כאַמישים	חמישים
כאַמישע כומשע־טױרע	חמישה חומשי־תּורה
כאָמעץ	חמץ
כאַמער	חמור
כאַמערײזל	חמור־אײזל
כאַנאַניע	חנניה
כאַנױך	חנוך
כאַנופֿע	חנופֿה
כאַנוקע	חנוכּה
כאַנוקעס־האַבאַיִס	חנוכּת־הבית
כאַנײפֿים	חונף
כאַניפֿושניצע	חניפֿושניצע
כאַניפֿושניק	חניפֿושניק
כאַניפֿע	חניפֿה
כאַניפֿעניק	חניפֿהניק
כאַניפֿעסניצע	חניפֿותניצע
כאַניפֿעסניק	חניפֿותניק
כאַניקע	חנוכּה
כאָנע	חנא
כאַנע	חנה
כאַנעך	חנוך
כאָנען	חנן
כאַנפֿאָנים	חנפֿן
כאָנפֿים	חונף
כאַנפֿן	חנפֿן
כאַנפֿע(נע)ן	חנפֿע(נע)ן
כאַס	חס —> חס זײַן
כאָס	חס —> חס זײַן
כאַסאָדים	חסד
כאַסאַן־דענאַן	חתן־דנן
כאַסאַן־האַיױװל	חתן־היובֿל
כאַסאַנים	חתן
כאָס־דאַרגע	נחות־דרגא
כאַס־װעכאָלילע	חס־וחלילה
כאַס־װעשאָלעם	חס־ושלום
כאָסיד	חסיד
כאָסידקע	חסידקע
כאַסלערע	חאַסלערע
כאַסלערע	חתלורע / חתליערע
כאַסמע(נע)ן	חתמע(נע)ן
כאָסן	חתן
כאָסן	חתן־מאָל
כאָסן־באָכער	חתן־בחור
כאָסן־ברײשעס	חתן־בראשית
כאָסן־דענאַן	חתן־דנן
כאָסן־טױרע	חתן־תּורה
כאָסנקאַלע	חתן־כּלה
כאָסעדל	חסידל
כאָסעך־באָנים	חשׂוך־בנים
כאָסעם־מאַטע	חתום־מטה
כאַסענע	חתונה
כאָסער	חסר
כאָסער־דײע	חסר־דעה
כאָסער־דײע	חסר־דעה
כאָסער־דײעניק	חסר־דעהניק
כאָף	כּף: כף
כאָפֿני	חפֿני
כאַצאַר־האַמאַלכעס	חצר־המלכות
כאַצופֿים	חצוף
כאַצופֿע	חצופֿה
כאַצײרעס	חצר
כאַצײרעס־מעלאָכים	חצר־המלכות
כאַציפֿעס	חציפֿות
כאַציצע	חציצה
כאָצע	חצי
כאָצע־דאָװער	חצי־דבֿר
כאָצע־כױדעש	חצי־חודש
כאָצע־כינעם	חצי־חינם
כאָצע לי כאָצע לאָך	חצי לי חצי לך
כאָצעף	חצוף
כאָצעף־מעכוצעף	חצוף־מחוצף
כאָצער	חצר
כאָצע־שאַבעסל	חצי־שבתל
כאָצע שעלי װעכאָצע שעלאָך	חצי שלי וחצי שלך
כאָק	חוק
כאָק־װעלױ־יאַװער	חוק־ולא־יעבֿר
כאַקירע	חקירה
כאַקירע־(װע)דרישע	חקירה־ודרישה
כאַקירען	חקירהן
כאָקל	חוקל
כאָק־לעיִסראָעל	חוק־לישׂראל
כאַקראָנים	חקרן
כאָקרים	חוכּר
כאַקרען	חקרן
כאַקרענען	חקרנען
כאַראָטע	חרטה
כאַראָמים	חרם
כאַראָמעס	חרם
כאַראָמעס	חרמות
כאַרװױנע	חרבֿונה
כאַרױסעס	חרוסת
כאַרוצים	חרוץ
כאַרוצע	חרוצה
כאַרטומים	חרטומים
כאַרײדים	חרד
כאַריפֿים	חריף
כאַריפֿעס	חריפֿות
כאָרן־אַף	חרון־אַף
כאָרעד	חרד
כאָרעװ	חרובֿ
כאָרעװ־װענעכרעװ	חרובֿ־ונחרבֿ
כאַרעף	חריף
כאָרעץ	חרוץ
כאַרפּע	חרפּה
כאַשודים	חשוד
כאַשוּװים	חשובֿ
כאַשיװעס	חשיבֿות
כאַשכעס	חשכות
כאַשמענאָיִם	חשמונאָים
כאָשעד	חשוד
כאָשעװ	חשובֿ
כאָשעװ	חשובֿ
כוט־האַמשולעש	חוט־המשולש
כוט־האַשעדרע	חוט־השדרה
כױדעש	חודש
כױװ	חובֿ
כױװעװ־ציִען	חובֿבֿ־ציון
כױװעס־האַלװאָװעס	חובֿות־הלבֿבֿות
כױזים	חוזה
כױזע	חוזה
כױזעק	חוזק
כױזעקן	חוזקן
כױזער	חוזר
כױזער	חוזר —> חוזר זײַן
כױזער־ביטשוּװע	חוזר־בתּשובֿה
כױזער־ביטשוּװע	חוזר־בתּשובֿה —> חוזר־בתּשובֿה זײַן
כױטים	חוטא
כױטע	חוטא
כױטע־אומאַכטי (עס האָראַבים)	חוטא־ומחטיא
כױטע־ב(ע)ײגל	חוטא־בעגל —> חוטא־בעגל זײַן
כױטעם	חוטם
כױטען	חוטאן
כױלאַנעס	חולנית
כױלי־האַנעפֿעש	חולי־הנפֿש
כױלים	חולה
כױלים־מעסוקאָנים	חולה־מסוכּן
כױלים־נױפֿלים	חולה־נופֿל
כױלי־נױפֿלים	חולי־נופֿלים
כױלע	חולה
כױלע	חולה —> חולה זײַן
כױלעװאַטע	חולהװאַטע
כױלעם	חולם
כױלעם	חולם־נאָז
כױלע־מעסוקן	חולה־מסוכּן
כױלע־נױפֿל	חולה־נופֿל
כױלעק	חולק
כױלעק	חולק —> חולק זײַן
כױמעד־מאָמען	חומד־ממון
כױמער	חומר
כױמער־היִולי	חומר־היולי
כױנעף	חונף
כױסעם	חותם
כױסעם־האַמאַלכעס	חותם־המלכות
כױקער	חוכּר
כױקער	חוקר
כױקער	חוקר —> חוקר זײַן
כױקער־װעדױרעש	חוקר־ודורש —> חוקר־ודורש זײַן
כױקרים	חוקר
כױרעש	חורש
כױשן	חושן
כױשן־מישפּעט	חושן־מישפּט
כױשעד	חושד —> חושד זײַן
כױשעד־ביקשײרים	חושד־בכּשרים —> חושד־בכּשרים זײַן
כױשעך	דצ״ך עד״ש באח״ב: חושך
כױשעך	חושך
כױשעך	חושך
כױשעך־װאַאַפֿײלע	חושך־ואַפֿלה
כױשעך־װאַכלאַקלאַקעס	חושך־וחלקלקות
כױשעך־מיצראַיִם	חושך־מצרים
כױשעכן	חושכן
כוכע־אוטלולע	חוכא־וטלולא
כוכע־טלולע	חוכא־טלולא
כולין	חולין
כולשע	חולשה
כומאָשים	חומש
כומעש	חומש
כומרע	חומרא
כופּע	חופּה
כופּע־װעק(י)דושן	חופּה־וקידושין
כוץ	חוץ
כוץ־לאָאָרעץ	חוץ־לאָרץ
כוץ־לאַגעדער	חוץ־לגדר
כוץ־לאַמאַכנע	חוץ־למחנה
כוץ־לעדערעך־האַטעװע	חוץ־לדרך־הטבֿע
כוץ־לעזע	חוץ־לזה
כוצפּע	חוצפּה
כוצפּעניצע	חוצפּהניצע
כוצפּעניק	חוצפּהניק
כוקים	חוק
כוקעס	חקת
כורבױנעס	חורבן
כורבם	חורבן
כורבם־באַיִס־רישן	חורבן־בית־ראשון
כורבם־באַיִס־שײני	חורבן־בית־שני
כורבם־ליטעראַטור	חורבן־ליטעראַטור
כורבן	חורבן
כורבן־באַיִס־רישן	חורבן־בית־ראשון
כורבן־באַיִס־שײני	חורבן־בית־שני
כורבן־ליטעראַטור	חורבן־ליטעראַטור
כורװע	חורבֿה
כוש	חוש
כוש־האַטאַם	חוש־הטעם
כוש־האַמישעש	חוש־המישוש
כוש־האַרײעך	חוש־הריח
כוש־האַריִע	חוש־הראיה
כוש־האַשמיִע	חוש־השמיעה
כושימדיק	חושימדיק
כושעם	חושים
כיבורים	חיבור
כיבעט־האַקײװער	חיבוט־הקבֿר
כיבעס־ציִען	חיבת־ציון
כיבעק־װענישעק	חיבוק־ונישוק
כיבער	חיבור
כידודים	חידוד
כידושים	חידוש
כידושים־װעניפֿלאָעס	חידושים־ונפֿלאָות
כידושע־טױרע	חידושי־תּורה
כידעד	חידוד
כידעקל	חדקל
כידעש	חידוש
כידעשן	חידושן —> חידושן זיך
כיִוּװים	חיובֿ
כיזױען	חזיון
כיזוקים	חיזוק
כיזיױנעס	חזיון
כיזעק	חיזוק
כיטעך־האַדיבער	חיתּוך־הדיבור
כײַ	חי
כײַ	חי  / ח״י
כײדער	חדר
כײדער־ליפֿנים־מיכײדער	חדר־לפֿנים־מחדר
כײדער־מעיוכעד	חדר־מיוחד
כײדער־מעסוקן	חדר־מתוקן
כײַ־װעקײַעם	חי־וקים
כײלעװ	חלבֿ
כײלעװן	חלבֿן
כײלעק	חלק
כײלעק־לעױלעם־האַבע	חלק־לעולם־הבא
כײן	ח״ן
כײן	חן
כײן	חן־גריבעלע
כײנדל	חנדל
כײנדלען	חנדלען —> חנדלען זיך
כײנעװדיק	חנעװדיק
כײַע	חיה
כײַע	חיה
כײַע־אָדעם	חײ־אָדם
כײַע־אױלעם	חײ־עולם
כײַעװ	חײבֿ
כײַעװ	חײבֿ
כײַעװ־מיסע	חײבֿ־מיתה
כײַעט	חײט
כײַעס	חיות
כײַע־סאָרע	חײ־שׂרה
כײַע־ראָע	חיה־רעה
כײפֿעץ	חפֿץ
כײרעם	חרם
כײרעם־דעראַבײנו־גערשאָם	חרם־דרבנו־גרשם
כײרעם־קװיטל	חרם־קװיטל
כײרעף־נעפֿעש	חרוף־נפֿש
כײרעש	חורש
כײרעש שױטע װעקאָטן	חרש שוטה וקטן
כײשעק	חשק
כילולים	חילול
כילופֿים	חילוף
כילוקים	חילוק
כילוקע־דײעס	חילוקי־דעות
כילעל	חילול
כילעל־האַטױרע	חילול־התּורה
כילעל־האַמעס	חילול־המת
כילעל־האַקאָװעד	חילול־הכּבֿוד
כילעל־האַקױדעש	חילול־הקודש
כילעל־האַשעם	חילול־השם
כילעל־קױדעש	חילול־קודש
כילעל־שאַבעס	חילול־שבת
כילעף	חילוף
כילעפֿן	חילופֿן
כילעק	חילוק
כינעך	חינוך
כינעך	חנוך
כיסער	חיסור
כיִעװ	חיובֿ
כיִעס	חיות
כיִעסן	חיותן —> חיותן זיך
כיצױנים	חיצון
כיצױניִעס	חיצוניות
כיצן	חיצון
כירעק	חיריק
כלושע־רײע	חלוש־ריאה
כליצע	חליצה
כמאָרים	חמרים
כמימע	חמימה
כמימעסדיק	חמימותדיק
כמישי	חמישי
כמישים	חמישים
כנופֿע	חנופֿה
כניפֿושניצע	חניפֿושניצע
כניפֿושניק	חניפֿושניק
כניפֿע	חניפֿה
כניפֿעניק	חניפֿהניק
כניפֿעסניצע	חניפֿותניצע
כניפֿעסניק	חניפֿותניק
כסאָדים	חסד
כסאַר־דײע	חסר־דעה
כסאַר־דײע	חסר־דעה
כסאַר־דײעש	חסר־דעהש
כסוכע־באָנים	חשׂוך־בנים
כסומים־מאַטע	חתום־מטה
כסידאַרניע	חסידאַרניע
כסידים	חסיד
כסידיש	חסידיש
כסידע־אומעס־האָױלעם	חסידי־אומות־העולם
כסידע־אַשקענאַז	חסידי־אַשכּנז
כסידעס	חסידות
כסימע	חתימה
כסימע	חתימה־געלט
כסימע־טױװע	חתימה־טובֿה
כסימעס־זאָקן	חתימת־זקן
כעדװע	חדװה
כעװלע־יעצירע	חבֿלי־יצירה
כעװלע־לײדע	חבֿלי־לידה
כעװלע־מעשיִעך	חבֿלי־משיח
כעװרײַע	חבֿרײא / חבֿריה
כעװרע	חבֿרה
כעװרע	חבֿרה־מאַן
כעװרען	חבֿרון
כעװרעניק	חבֿרהניק
כעװרע־קעדישע	חבֿרה־קדישא
כעזשבױנעס	חשבון
כעזשבם	חשבון
כעזשבם־האַנעפֿעש	חשבון־הנפֿש
כעזשבם־צעדעק	חשבון־צדק
כעזשבענען	חשבונען
כעזשװן	חשװן
כעט	חטא
כעלבנע	חלבנה
כענעק	חנק
כעס	ח
כעס	חית
כעסאָרן	חסרון
כעסאָרן־קיס	חסרון־כּיס
כעסעד	חסד
כעסעד־שעל־עמעס	חסד־של־אמת
כעסרױנים	חסרון
כעסרױנעס	חסרון
כעפֿצעס	חפֿצ(י)ות
כפֿאָצים	חפֿץ
כפֿײצים	חפֿץ
כצאָס	חצות
כצופֿים	חצוף
כצופֿע	חצופֿה
כצײרעס	חצר
כצײרעס־מעלאָכים	חצר־המלכות
כציפֿעס	חציפֿות
כציצע	חציצה
כקירע	חקירה
כקירע־(װע)דרישע	חקירה־ודרישה
כקירען	חקירהן
כראָטע	חרטה
כראָמים	חרם
כראָמעס	חרם
כראָמעס	חרמות
כרױסעס	חרוסת
כריפֿים	חריף
כריפֿעס	חריפֿות
כשאַד	חשד
כשאָדים	חשד
כשאַש	חשש
כשאָשים	חשש
כשאַש־כאָמעץ	חשש־חמץ
כשאָשעס	חשש
כשודים	חשוד
כשוּװים	חשובֿ
כשיװעס	חשיבֿות

לאַ…	ל…
לאַג־בעױמער	ל״ג־בעומר
לאַהאַרעג־אולעאַבעד	להרוג־ולאַבד
לאַװ	לאַװ
לאַװ־דאַפֿקע	לאַװ־דװקא
לאָװן (האָאַראַמי)	לבֿן (האַרמי)
לאַזאָזל	לעזאזל
לאָט	לוט
לאַטכאָנים	לקחן
לאַטכן	לקחן
לאַטכענען	לקחנען
לאַיעהודים	ליהודים
לאַכאָדים	לאַחדים
לאַכאָדימניצע	לאַחדימניצע
לאַכאָדימניק	לאַחדימניק
לאַכאַצאָיִם	לחצאָים
לאַכאַצאָיִן	לחצאָין
לאָכײן	לכן
לאַכלוטן	לחלוטין
לאַכמע	לחמא
לאָכן	לכן
לאַכעש	לחש
לאַמדאָנים	למדן
לאַמדאָנעס	למדנות
לאָמדים	לומדים
לאָמדיש	לומדיש
לאַמדן	למדן
לאָמדעס	לומדות
לאַמעד	ל
לאַמעד	למד
לאַמעדװאָװ	למד־װאָװ
לאַמעד־װאָװניצע	למד־װאָװניצע
לאַמעד־װאָװניק	למד־װאָװניק
לאָעט	להוט
לאָער	להוט
לאַפּאַג	לפּ״ג
לאַפּאַק	לפּ״ק
לאַפֿוקע	לאַפֿוקי
לאָצן	לצון
לאַקכאָנים	לקחן
לאַקכן	לקחן
לאַקכענען	לקחנען
לאַקל אײס	לכּל עת
לאָשן	לשון
לאָשן־האָרע	לשון־הרע
לאָשן־זאָכער	לשון־זכר
לאָשן־יאָכעד	לשון־יחיד
לאָשן־נעקײװע	לשון־נקבֿה
לאָשן־נעקיִע	לשון־נקיה
לאָשן־סעגינאָער	לשון־סגי־נהור
לאָשן־קױדעש	לשון־קודש
לאָשן־קױדעש	לשון־קודש
לאָשן־ראַבים	לשון־רבים
לױ	לא
לױ־אַלײכעם	לא־עליכם
לױ־אַלײכעמדיק	לא־עליכמדיק
לױ־אָלײנו	לא־עלינו
לױ אַלמען ײִסראָעל	לא אַלמן ישׂראל
לױ דובים װעלױ יאַאַר	לא דובים ולא יער
לױ־דײַ	לא־די
לױ הױו דװאָרים מעױלעם	להד״ם: לא היו דבֿרים מעולם
לױ הױע װעלױ ניװרע	לא היה ולא ניבֿרא
לױ הוכשער דאָרע	לא הוכשר דרא
לױװים	לװה
לױװע	לװה
לױט	לוט
לױ־יוצלעך	לא־יוצלח
לױ ײִזאָכער װעלױ ײִפּאָקעד	לא יזכר ולא יפּקד
לױ ײִמאָלעט	לא ימלט
לױ־יעכרעץ	לא־יחרץ(־געלט)
לױמערן	לומרן
לױ־סאַכמעד	לא־תחמוד
לױ־סיגנעװ	לא־תיגנובֿ
לױסײַסע	לא־תעשׂה
לױ־סינעף	לא־תינאף
לױ־סירצעך / ־סערצעך	לא־תירצח
לױסעסע	לא־תעשׂה
לױעג־לעראָש	לועג־לרש
לױפֿידאַלטי	לא־פֿידלתּי
לױ פֿילאָלטי	לא־פֿידלתּי: לא פֿיללתּי
לױ־קאָלש(ע)קען	לא־כּל־שכּן
לױקי	לא־כּי
לוכעס	לוח
לולאָװים	לולבֿ
לולעװ	לולבֿ
לועך	לוח
לוריע	אַר״י:  ר׳ יצחק לוריא
לי…	ל…
ליבריִעס־(האָ)ױלעם	לבריאת־(ה)עולם
ליגנײַ	לגנאַי
לידײ גמאַר	לידי גמר
לידײ געמער	לידי גמר
לײװי	לװי
לײװי	לװי
לײכעס	לחות
לײכעץ	לחות
לײל־האַשימורים	ליל־השימורים
לײלע־אולײלע	לעילא־ולעילא
לײלע־אולײלעדיק	לעילא־ולעילאדיק
לײל־שימורים	ליל־שימורים
לײמער	לאמר
לײמערן	לאמרן
לײע	לאה
לײצים	לץ
ליכװױד	לכבֿוד
ליכױרע	לכאורה
ליכשעיאַרװיִעך	לכשירװיח
ליכשעיאַרכעװ	לכשירחיבֿ
ליליס	לילית
לימדינעס־האַיאַם	למדינת־הים
לימודים	לימוד
לימעד	לימוד
לינעס־(האַ)צעדעק	לינת־(ה)צדק
ליסכוס	לזכות
ליִע	עליה
ליפּראַט־גאָדל	לפּרט־גדול
ליפּראַט־קאָטן	לפּרט־קטן
ליפֿנײַ־װעליפֿנים	לפֿני־ולפֿנים
ליפֿנײ־קאָל־אַם־װעײדע	לפֿני־כּל־עם־ועדה
ליפֿנים־מעשורעס־האַדין	לפֿנים־משורת־הדין
ליצמיסעס	לצמיתות
ליקױִם	ליקױ
ליקע	ליקױ
ליקע־כאַמע	ליקױ־חמה
ליקע־לעװאָנע	ליקױ־לבֿנה
ליקשעיאַרװיִעך	לכּשירװיח
ליקשעיאַרכעװ	לכּשירחיבֿ
לישװאַך	לשבֿח
לישמאָ	לשמה
למײַ	הלמאַי
לע…	ל…
לעאַכער־האַמײַסע	לאַחר־המעשׂה
לעאַכער־זמאַן	לאַחר־זמן
לעאַכער־מײע־שאָנים	לאַחר־מאה־שנים
לעאָסעד	לעתיד
לעאָסעד־לאָװע	לעתיד־לבֿוא
לעגאַבע	לגבי
לעגאַמרע	לגמרי
לעגבױמער	ל״ג־בעומר
לעדאָר־דױרעס	לדור־דורות
לעדוגמע	לדוגמא
לעדױרעס	לדורות
לעהאַבע	להבא
לעהאַדאַם	להד״ם
לעהאַװדל	להבֿדיל
לעהאַװדל עלעף (אַלפֿײ) האַװדאָלעס	להבֿדיל אלף (אַלפֿי) הבֿדלות
לעהאַכעס	להכעיס
לעהאַכעסניצע	להכעיסניצע
לעהאַכעסניק	להכעיסניק
לעהאַשמיד־אולעהאַרעג	להשמיד־ולהרוג
לעהײפּעך	להיפּוך
לעװ	לבֿ
לעװאָװעס	לבֿ
לעװאַטאָלע	לבֿטלה
לעװאָנע	לבֿנה
לעװאָנען	לבֿנון
לעװוּש	לבֿוש
לעװוּשן	לבֿוש
לעװטאָװ	לבֿ־טובֿ
לעװיאָסן	לװיתן
לעװיִיִם	לװי
לעװײַע	לװיה
לעװ יעדײע	לבֿ יודע
לעױלאָמעס	לעולמות
לעױלעם	לעולם
לעױלעם־װאָעד	לעולם־ועד
לעױלעם טיקעך	לעולם תּיקח
לעױלעמעס	לעולמות
לעזײכער(־אױלעם)	לזכר(־עולם)
לעזיכרען־דױרעס	לזכרון־דורות
לעזיקאָרן	לזכּרון
לעטאַרבעס־ראָע	לתּרבות־רעה
לעטאַשמעש	לתּשמיש
לעטױװע	לטובֿה
לעטױװעס	לטובֿת
לעטױװעס־האַקלאַל	לטובֿת־הכּלל
לעטױרע לעכופּע אולמײַסים־טױװים	מגדל —> מגדל זײַן: לתּורה לחופּה ולמעשׂים־טובֿים
לעיִבעד	לאיבוד
לעײװער־האַיאַם	לעבֿר־הים
לעײנע־האַשעמעש	לעיני־השמש
לעײס־זיקנע	לעת־זיקנה
לעיִניאָנײנו	לעניננו
לעיעסער־ביטאָכן	ליתר־בטחון
לעיעסער־טױקעף	ליתר־תּוקף
לעיעסער־כיזעק	ליתר־חיזוק
לעכאָ־דױדי	לכה־דודי
לעכאַטכילע	לכתּחילה
לעכאַיִם	לחײם
לעכאַיִם	לחײם
לעכאַיִם־אולעשאָלעם	לחײם־ולשלום
לעכאַיִם־טױװים־אולעשאָלעם	לחײם־טובֿים־ולשלום
לעכאָלאַדײעס	לכל־הדעות
לעכאָלאַפּאָכעס	לכל־הפּחות
לעכאָשים	לחש
לעכוד	לחוד
לעכו װענײלכאָ	ביל״ו: בית־יעקבֿ לכו ונלכה
לעכױװע	לחובֿה
לעכו־נעראַנענאָ	לכו־נרננה
לעכלעכאָ	לך־לך
לעכעם	לחם
לעלאַאַג־אולקעלעס	ללעג־ולקלס
לעמאַזל	למזל
לעמאַנאַשעם	למען־השם
לעמאַן־האָעמעס	למען־האמת
לעמאַן־ײידו	למען־ידעו
לעמאַן־ײִשמעו־װעײִרו	למען־ישמעו־ױראו
לעמאַרעס־אַיִן	למראית־עין
לעמאָשל	למשל
לעמײַ	הלמאַי
לעמײַ	למאַי
לעמײַלע	למעלה
לעמײַלע־מין־האַטעװע	למעלה־מן־הטבֿע
לעמײַלע־מין־האַסײכל	למעלה־מן־השׂכל
לעמײַסע	למעשׂה
לעמיספּאָראָם	למיספּרם
לעמעהאַדרין	למהדרין
לעמעך	למך
לענױ	לנױ
לעסאַטע	לעת־עתּה
לעסאָף	לסוף
לעס ברײרע	לית ברירה
לעס דין װעלעס דײַען	לית דין ולית דײן
לעסײרוגן	לסירוגין
לעערעך	לערך
לעפּאָכעס	לפּחות
לעפּאָנעם	לפּנים
לעפֿטאָװ	לבֿ־טובֿ
לעפֿי	לפֿי
לעפֿידאַטי	לפֿי־דעתּי
לעפֿיזע	לפֿי־זה
לעפֿי־טומע	לפֿי־תּומו
לעפֿי־מײַסעװ	לפֿי־מעשׂיו
לעפֿי־ערעך	לפֿי־ערך
לעפֿישאָ	לפֿי־שעה
לעפֿי־שאָעדיק	לפֿי־שעהדיק
לעץ	לץ
לעצאָנים	לץ
לעצאָנעס	לצנות
לעצן	לצן
לעצעװען	לצעװען
לעקאָװעד	לכּבֿוד
לעקאַף־כױװ	דן —> דן זײַן: דן —> דן זײַן לכּף־חובֿ
לעקאַף־סכוס	דן —> דן זײַן: דן —> דן זײַן לכּף־זכות
לעראָװ	לרובֿ
לעראָע	לרעה
לעראָצן	לרצון
לעשאָנאָ האַבאָ בירושאָלאַיִם	לשנה הבאה בירושלים
לעשאָנע טױװע טיקאָסײװוּ (װעסעכאָסײמו)	לשנה טובֿה תּכּתבֿו (ותחתמו)
לעשױנעס	לשון
לעשיטאָסע	לשיטתו
לעשעם	לשם
לעשעם־ײִכעד	לשם־ײִחוד
לעשעם־שאָמאַיִם	לשם־שמים

מאַ	מה
מאָ	מה
מאַאַמאַקים	מעמקים
מאָ אָנו אומע כאַײינע	מה אָנו ומה חײנו
מאַאַפּילים	מעפּילים
מאַאַרע	מערה
מאַבל	מבול
מאַבלען	מבולען
מאַבעקאַך	מה־בכּך
מאַגביל	מגביל —> מגביל זײַן
מאַגידים	מגיד
מאַגידעס	מגידות
מאַגיִיִם	מגיה
מאַגײפֿע	מגפֿה
מאַגיִע	מגיה
מאַגיִע	מגיה —> מגיה זײַן
מאָגן־דאָװעד	מגן־דוד
מאַגעד	מגיד
מאַגעדקע	מגידקע
מאַגעמאַסע	מגע־(ו)משׂא
מאָדײַ	מדי
מאָדין	מודיעין
מאַדע	מדע
מאַדעך	מה־דאָך
מאַדרײגע	מדרגה
מאַדריכים	מדריך
מאַדרעך	מדריך
מאַדרעך	מדריך —> מדריך זײַן
מאַהאַר…	מהר…
מאַהאַראַל	מהר״ל
מאַהאַראַם	מהר״ם
מאַהאַראַם	מהר״ם שיף
מאַהאַרשאָ	מהרש״אָ
מאַהאַרשאַל	מהרש״ל
מאָױז־צור	מעוז־צור
מאַזאָלעס	מזל
מאַזיקים	מזיק
מאַזיקן	מזיקן
מאַזל	מזל
מאַזל אַקרעװ	מזל עקרבֿ
מאַזל אַריע	מזל אַריה
מאַזל־בראָכע	מזל־ברכה
מאַזל געדי	מזל גדי
מאַזל דאָגים	מזל דגים
מאַזל דעלי	מזל דלי
מאַזלטאָװ	מזל־טובֿ
מאַזלטאָװ	מזל־טובֿ
מאַזל טאָלע	מזל טלה
מאַזל טױמים	מזל תּאומים
מאַזל מאָזנאַיִם	מזל מאָזנים
מאַזל סאַרטן	מזל סרטן
מאַזל פּסולע	מזל בתולה
מאַזל קאַשעס	מזל קשת
מאַזל שאָר	מזל שור
מאָזנאַיִם	מאָזנים
מאָזנאַיִם	מזל מאָזנים
מאַזעק	מזיק
מאַזעק	מזיק —> מזיק זײַן
מאַזער	מזהיר —> מזהיר זײַן
מאַטאַמים	מטעמים
מאַטאָנע	מתּנה
מאַטבײע	מטבע
מאַטױװ	מה־טובֿ
מאַטױװע	מה־טובֿו
מאַטיפֿים	מטיף
מאַטיקים	מעתּיק
מאַטכע	מדחה —> מדחה זײַן
מאַטמױנים	מטמון
מאַטמען	מטמון
מאַטן־בעסײסער	מתּן־בסתר
מאַטן־טױרע	מתּן־תּורה
מאַטנעס־באָסער־װעדאָם	מתּנת־בשׂר־ודם
מאַטנעס־יאַד	מתּנת־יד
מאַטנעס־כינעם	מתּנת־חינם
מאַטנעס־עלױהים	מתּנת־אלוהים
מאַטנעס־עלױקים	מתּנת־אלוהים
מאַטע	מטה
מאַטעם	מטעים —> מטעים זײַן
מאַטע־מאַטע / ־מאָטע	מטה־מטה
מאַטעס	מטות
מאַטעס	מתּת
מאַטעס־אומאַסע	מטות־ומסעי
מאַטעסיאָהו	מתּתיהו
מאַטעס־מאַסע	מטות־מסעי
מאַטעף	מטיף
מאַטער	מתּיר —> מתּיר זײַן
מאַטער־דאַם	מתּיר־דם —> מתּיר־דם זײַן
מאַטער־נײדער	מתּיר־נדר —> מתּיר־נדר זײַן
מאַטפּיסים	מדפּיס
מאַטפּעס	מדפּיס
מאַטריִעך	מטריח —> מטריח זײַן
מאַטרעניסע	מטרוניתא
מאַיאָפֿעס	מה־יפֿית
מאַיאָפֿעס	מה־יפֿית־ײִד
מאַיאָפֿעס	מה־יפֿית־לידל
מאַיאָפֿעסניק	מה־יפֿיתניק
מאַ־יאָקער	מה־יקר
מאַ־יױקער	מה־יוקר
מאַיײַסעניק	מה־יעשׂהניק
מאַיִם	מים
מאַיִם־אַכרױנים	מים־אַחרונים
מאַיִם־כאַיִם	מים־חײם
מאַיִם־שעײן־לאָהעם־סאָף	מים־שאין־להם־סוף
מאַיִם־שעלאָנו	מים־שלנו
מאַכבעד	מכביד —> מכביד זײַן
מאַכזאָקעס	מחזקות
מאַכזױרים	מחזור
מאַכזיר־לעמוטעװ	מחזיר־למוטבֿ —> מחזיר־למוטבֿ זײַן
מאַכזעק	מחזיק —> מחזיק זײַן
מאַכזעק־טױװע	מחזיק־טובֿה —> מחזיק־טובֿה זײַן
מאַכזער	מחזור
מאַכלױקע	מחלוקה
מאַכלױקעס	מחלוקת
מאַכלע	מחלה
מאַכלעס באַס־נײַמע	מחלת בת־נעמה
מאַכמירים	מחמיר
מאַכמעדאַניש	מחמדאַניש
מאַכמעדאַנער	מחמדאַנער
מאַכמעס	מחמת
מאַכמעץ	מחמיץ —> מחמיץ זײַן
מאַכמער	מחמיר
מאַכניסע־אָרכים	מכניס־אורח
מאַכנע	מחנה
מאַכנעס־אױרעך	מכניס־אורח
מאַכנעס־אױרעך	מכניס־אורח —> מכניס־אורח זײַן
מאַכנעס־אױרעכטע	מכניס־אורחטע
מאַכנעסװײַז	מחנותװײַז
מאָכסים	מוכס
מאָכע	מחה
מאַכעטאָנים	מחותּן
מאַכעטאָנעשאַפֿט	מחותּנותשאַפֿט
מאַכעטענעסטע	מחותּנתטע
מאָכרים	מוכר
מאַכריִע	מכריע —> מכריע זײַן
מאַכרעװ	מחריבֿ —> מחריבֿ זײַן
מאַכרעז	מכריז —> מכריז זײַן
מאַכרעז־אומױדיִע	מכריז־ומודיע —> מכריז־ומודיע זײַן
מאַכרעם	מחרים —> מחרים זײַן
מאַכרעם־אױלעם	מחרים־עולם —> מחרים־עולם זײַן
מאָכרע־ספֿאָרים	מוכר־ספֿרים
מאַכשאָװע	מחשבֿה
מאַכשאָװע־זאָרע	מחשבֿה־זרה
מאַכשאָװע־טױװע	מחשבֿה־טובֿה
מאַכשאָװעסן	מחשבֿותן
מאַכשאָװע־ראָע	מחשבֿה־רעה
מאַכשײפֿטע	מכשפֿטע
מאַכשײפֿע	מכשפֿה
מאַכשירים	מכשיר
מאַכשירין	מכשירין
מאַכשל	מכשיל —> מכשיל זײַן
מאַכשער	מכשיר
מאַכשער	מכשיר —> מכשיר זײַן —> זײַן זיך
מאַל	מל —> מל זײַן
מאַלאָכי	מלאָכי
מאַלאַכײ־האַשאָרעס	מלאַכי־השרת
מאַלאָכים	מלאך
מאַלאַכע־האַשאָלעם	מלאך־השלום
מאַלאַכע־כאַבאָלע	מלאך־חבלה
מאַלאַכע־עליען	מלאך־עליון
מאַלבושים	מלבוש
מאַלבעש	מלבוש
מאַלבעש	מלביש —> מלביש זײַן
מאַלבעש־אומאַניל	מלביש־ומנעיל —> מלביש־ומנעיל זײַן
מאַלבעש־אַרומים	מלביש־ערומים
מאַלבעש־אַרומים	מלביש־ערומים —> מלביש־ערומים זײַן
מאַלגײרען	מעלה־גירהן
מאַלװים	מלװה
מאַלװים־בעריביס	מלװה־בריבית
מאַלװע	מלװה
מאַלװע־בעריביס	מלװה־בריבית
מאַ לי לעשאַקער	מה לי לשקר
מאַלכאַמאָװעס	מלאך־המװת
מאַלכעס	מלכות
מאַלכעס	מלכות
מאַלכעסדיק	מלכותדיק
מאַלכעס־האָרעשאָע	מלכות־הרשעה
מאַלכעס־האָרעשע	מלכות־הרשע
מאַלכעס־ײִסראָעל	מלכות־ישׂראל
מאַלכעס־יעהודע	מלכות־יהודה
מאַלכעס־שאָמאַיִם	מלכות־שמים
מאַלן	מלן
מאָלע	מלא
מאָלע	מלא
מאָלע	מלא־
מאַלע	מלע —> מלע זײַן
מאָלע־גאַזלען	מלא־גזלן
מאַלעגײרען	מעלה־גירהן
מאָלע־געדולע	מלא־גדולה
מאָלע־האָמען	מלא־המן
מאָלע־װעגאָדעש	מלא־וגדוש
מאָלע־טאַם	מלא־טעם
מאַלעך	מלאך
מאַלעכאַמאָװעס	מלאך־המװת
מאַלעך־דױמע	מלאך־דומה
מאַלעך־האַגױעל	מלאך־הגואל
מאַלעך־האַדױמע	מלאך־הדומה
מאַלעך־האַמױשיִע	מלאך־המושיע
מאַלעך־האַשאָלעם	מלאך־השלום
מאָלע־כײמע	מלא־חמה
מאָלע־כײן	מלא־חן
מאַלעך־כאַבאָלע	מלאך־חבלה
מאַלעך־עליען	מלאך־עליון
מאַלען	מלען
מאָלע־סימכע	מלא־שׂימחה
מאָלע־קאַאַס	מלא־כּעס
מאָלע־ראַכמים	מלא־רחמים
מאָלע־רעציכע	מלא־רציחה
מאַלקיִעל	מלכּיאל
מאַלקע	מלכּה
מאַלקע	מלכּה
מאַלקעס	מלקות
מאַלקע־קעדישע	מלכּא־קדישא
מאַלקע־שװאָ	מלכּה־שבֿאָ
מאַלשינעס	מלשינות
מאַלשן	מלשין —> מלשין זײַן
מאַמאָשעס	ממשות
מאַמזײרים	ממזר
מאַמזײרעס	ממזרת
מאַמזער	ממזר
מאַמזער־בען־האַנידע	ממזר־בן־הנידה
מאַמזערטע	ממזרטע
מאַמזעריש	ממזריש
מאַמטאַקים	ממתּקים
מאַמלעץ	ממליץ —> ממליץ זײַן
מאַמעלאָשן	לשון: מאַמע־לשון
מאָמען	ממון
מאָמען־קױרעך	ממון־קורח
מאַמעש	ממש
מאַמצע	ממציא —> ממציא זײַן
מאַמשעך	ממשיך —> ממשיך זײַן
מאַן	מן
מאַ־נאָע	מה־נאה
מאַנדאָמאַר	מאַן־דאָמר
מאַנדעהו	מאַן־דהוא
מאַנהיגים	מנהיג
מאַנהיגע־האַדאָר	מנהיג־הדור
מאַ־נישטאַנע	מה־נשתּנה
מאַנעג	מנהיג
מאַנעג־האַדאָר	מנהיג־הדור
מאָנע־יאָפֿע	מנה־יפֿה
מאָנע־מעכאַײינע	מה אָנו ומה חײנו
מאָנע(פֿ)שעך	ממה־נפֿשך
מאַס	מס
מאַסאָעס	משׂא
מאַסאָעס בעניאָמען האַשלישי	מסעות בנימין השלישי
מאַסבער	מסביר —> מסביר זײַן
מאַסטן	משׂטין —> משׂטין זײַן
מאַסמידים	מתמיד
מאַסמידע	מתמידה
מאַסמעד	מתמיד
מאָסן	מתון
מאַסנע	מתנה —> מתנה זײַן
מאַסע	מסעי
מאַסע	משׂא
מאַסעג	משׂיג —> משׂיג זײַן
מאַסעג־גװוּל	מסיג־גבֿול —> מסיג־גבֿול זײַן
מאַסעכעס	מסכת
מאַסעמאַטן	משׂא־מתּן
מאַסעפּאָנעם	משׂא־פּנים
מאַסע־קװײדע	משׂא־כּבֿדה
מאָסער	מוסר
מאָסער	מסור
מאַסער	מסר
מאַסערן	מסרן
מאַספּידים	מספּיד
מאַספּעד	מספּיד
מאַספּעד	מספּיד —> מספּיד זײַן
מאַסקאָנע	מסקנא
מאַסקילים	משׂכּיל
מאַסקל	משׂכּיל
מאַסקעם	מסכּים
מאַסקעם	מסכּים —> מסכּים זײַן
מאַסקער	מזכּיר —> מזכּיר זײַן
מאַסקער	מזכּיר —> מזכּיר זײַן —> זײַן זיך
מאַסקער־נעשאָמעס	מזכּיר־נשמות —> מזכּיר־נשמות זײַן
מאָסרים	מסור
מאַסריִעך	מסריח —> מסריח זײַן
מאַסרע	מתרה —> מתרה זײַן
מאָסרעס	מותר
מאָעס	מאָוס
מאָעס	מעות
מאָעס־כיטים	מעות־חיטים
מאָעס־כיטן	מעות־חיטין
מאָער	מאור
מאָער־האַגױלע	מאור־הגולה
מאַפּאָלע	מפּלה
מאַפּױלעס	מפּולת
מאַ פּישי	מה פּשעי
מאַפּל	מפּיל
מאַפּל	מפּיל —> מפּיל זײַן
מאַפּל	מפּיל־קינד
מאַפּלען	מפּלען
מאַפּעלעך	מפּיל
מאַפֿטיִעך	מבֿטיח —> מבֿטיח זײַן
מאַפֿטער	מפֿטיר
מאַפֿכן	מבֿחין —> מבֿחין זײַן
מאַפֿלעג	מפֿליג —> מפֿליג זײַן
מאַפֿלע־לײַסעס	מפֿליא־לעשׂות
מאָפֿסים	מופֿת
מאַפֿסעק	מפֿסיק —> מפֿסיק זײַן
מאַפֿסעק־מישנאָסע	מפֿסיק־משנתו —> מפֿסיק־משנתו זײַן
מאַפֿצער	מפֿציר —> מפֿציר זײַן
מאַפֿקער	מפֿקיר —> מפֿקיר זײַן
מאַצדעק	מצדיק —> מצדיק זײַן
מאַצדעק־האַדין	מצדיק־הדין —> מצדיק־הדין זײַן
מאַצײװע	מצבֿה
מאַצל	מציל —> מציל זײַן
מאַצליִעך	מצליח —> מצליח זײַן
מאָצע	מוצאי־
מאַצע	מצה
מאַצע	מצה־װאַסער
מאַצעװ	מצבֿ
מאָצע־שאַבעס	מוצאי־שבת
מאַצע־שמורע	מצה־שמורה
מאַקאַבי	מכּבי
מאַקאַבײער	מכּבײער
מאַקדעם	מקדים —> מקדים זײַן
מאַקדעם	מקדים —> מקדים זײַן —> זײַן זיך
מאַקדעש	מקדיש —> מקדיש זײַן
מאַקכעש	מכּחיש —> מכּחיש זײַן
מאַקע	מכּה
מאַקע אַשער לױ קסוּװע באַטױרע	מכּה אַשר לא כּתובֿה בתּורה
מאָקעם	מקום
מאָקעם־גאָדל	מקום־גדול
מאָקעם־לעפּוראָניעס	מקום־לפּורעניות
מאָקעם־מיקלעט	מקום־מיקלט
מאָקעם־מענוכע	מקום־מנוחה
מאָקעם־קאָדעש	מקום־קדוש
מאַקעס	מכּות
מאַקעס־אַכזאָריעס	מכּות־אַכזריות
מאַקעס־מעדינע	מכּת־מדינה
מאַקעס־פּכױרעס	דצ״ך עד״ש באח״ב: מכּת־בכורות
מאַקעס־רעצעך	מכּות־רצח
מאַקעף	מקף
מאָקער	מקור
מאַקער־טױװע	מכּיר־טובֿה
מאַקע שעלױ קסוּװע באַטױרע	מכּה שלא כּתובֿה בתּורה
מאַקפּידים	מקפּיד
מאַקפּעד	מקפּיד
מאַקפּעד	מקפּיד —> מקפּיד זײַן
מאַקרעװ	מקריבֿ —> מקריבֿ זײַן
מאַקשאָנים	מקשן
מאַקשן	מקשן
מאַקשע	מקשה —> מקשה זײַן
מאַקשע־לײלעד	מקשה־לילד
מאַר…	מהר…
מאַראָכע	מערכה
מאָראָנאָן װעראַבאָנאָן װעראַבױסײַ	מרנן ורבנן ורבותי
מאַראַש	מה־רעש
מאַרבעץ־טױרע	מרביץ־תּורה —> מרביץ־תּורה זײַן
מאַרבערעבאַשע	מר־ב(ר־)רב־אַשי
מאַרגל	מרגיל —> מרגיל זײַן
מאַרגניסע־טאַװע	מרגניתא־טבֿא
מאַרגעש	מרגיש —> מרגיש זײַן
מאָרדים	מורד
מאָרדים־בעמאַלכעס	מורד־במלכות
מאַרװיכער	מרװיחער
מאַרװיִעך	מרװיח —> מרװיח זײַן
מאָרטכע	מרדכי
מאָרטכע האַצאַדיק	מרדכי הצדיק
מאַריס־אַיִן	מראית־עין
מאַריעם	מרים
מאַרכעװ	מרחיבֿ —> מרחיבֿ זײַן
מאַרכעזשװן	מרחשװן
מאַרכעק	מרחיק —> מרחיק זײַן
מאַר־מימאָװעס	מר־ממװת
מאַרנעפֿעש	מר־נפֿש
מאַרע	מראה
מאָרע־דאַװראָהאָם	מריה־דאַבֿרהם
מאָרע־דאַסרע	מרא־דאַתרא
מאָרע־דעאַלמע־קולע	מריה־דעלמא־כּולה
מאָרע־דעאַסרע	מרא־דאַתרא
מאַרעװיכער	מרװיחער
מאַרע־מאָקעם	מראה־מקום
מאַרע־מעקױמעס	מראה־מקומות
מאָרע־נעפֿעש	מר־נפֿש
מאָרעס	מרת
מאַרע־קױען	מראה־כּהן
מאָרער	מרור
מאַרעש	מרעיש —> מרעיש זײַן
מאַרעש־אױלעם	מרעיש־עולם —> מרעיש־עולם זײַן
מאָרעשכױרע	מרה־שחורה
מאַרשאַס	מרשעת
מאַשביִע	משביע —> משביע זײַן
מאַשגיכים	משגיח
מאַשגיִעך	משגיח
מאַשגיִעך	משגיח —> משגיח זײַן
מאַשװע	משװה —> משװה זײַן
מאַשטן	משתּין —> משתּין זײַן
מאַשכיסים	משחית
מאַשכעס	משחית
מאָשל	משל
מאָשלים	מושל
מאָשלים־בעקיפּע	מושל־בכּיפּה
מאַשלעם	משלים —> משלים זײַן
מאַשלעש	משליש —> משליש זײַן
מאָשל־קעכערעס־האַנישבער	משל־כּחרס־הנישבר
מאַשמאָעס	משמעות
מאַ שמײכעם	מה שמכם
מאַשמע	משמע
מאַ שמעכאָ	מה שמך
מאַשעהו	משהו
מאַשפּיִע	משפּיע —> משפּיע זײַן
מאַשפּל	משפּיל —> משפּיל זײַן
מאַשקאַנטע	משכּנתּא
מאַשקאָנעס	משכּון
מאַשקאָעס	משקה
מאַשקן	משכּון
מאַשקע	משקה
מוהאַראַר	מוהר״ר
מוטל	מוטל —> מוטל זײַן
מוטל־בעסאָפֿעק	מוטל־בספֿק
מוטער	מותּר
מױדאָע	מודעה
מױדיִיִן	מודיעין
מױדים	מודים
מױדיִע	מודיע —> מודיע זײַן
מױדע	מודה
מױדע	מודה —> מודה זײַן
מױדע	מודה —> מודה זײַן —> זײַן זיך
מױדע־אומיסװאַדע	מודה־ומתװדה —> מודה־ומתװדה זײַן
מױדע־אַני	מודה־אַני
מױכיכים	מוכיח
מױכיִעך	מוכיח
מױכל	מוחל
מױכל	מוחל —> מוחל זײַן
מױכעס	מוח
מױכעס	מוכס
מױכער	מוכר
מױכער־ספֿאָרים	מוכר־ספֿרים
מױכער־ספֿאָרימניק	מוכר־ספֿרימניק
מױלעד	מולד
מױלעד	מוליד —> מוליד זײַן
מױלעך	מולך
מױלעכער	מולכער
מױסעף	מוסיף —> מוסיף זײַן
מױסער	מוסר —> מוסר זײַן
מױסער	מותר
מױסער־מױדאָע	מוסר־מודעה —> מוסר־מודעה זײַן
מױסער־נעפֿעש	מוסר־נפֿש —> מוסר־נפֿש זײַן —> זײַן זיך
מױסער קסאַװ זע	מוכּ״ז: מוסר כּתבֿ זה
מױסרעס	מותר
מױעד	מועד
מױעד־קאָטן	מועד־קטן
מױעװ	מואבֿ
מױעך	מוח
מױעכל	מוחל
מױעכן	מוחן —> מוחן זיך
מױעל	מוהל
מױעל־מעל	מוהל־מעל
מױעלשאַפֿט	מוהלשאַפֿט
מױפֿעס	מופֿת
מױצע	המוציא
מױצע	מוציא
מױצע	מוציא —> מוציא זײַן
מױצע־זערע־לעװאַטאָלע	מוציא־זרע־לבֿטלה
מױצע־כײן	מוצא־חן —> מוצא־חן זײַן
מױצע־לאַאַז	מוציא־לעז —> מוציא־לעז זײַן
מױצע־שנאָסע	מוציא־שנתו —> מוציא־שנתו זײַן
מױצע־שעמראַ	מוציא־שם־רע —> מוציא־שם־רע זײַן
מױקירע	מוקיר־
מױקער	מוקיר־
מױרײנע	מורנו
מױרײנע (װעראַבײנע) האָראַװ רעב	מוהר״ר: מורנו הרבֿ רב
מױרײנע האָראַװ רעב	מהר…:  מורנו הרבֿ רב
מױרע	מורא
מױרעד	מורד
מױרעד	מורד —> מורד זײַן
מױרעד־בעמאַלכעס	מורד־במלכות
מױרעדיק	מוראדיק
מױרע־דערעך	מורה־דרך
מױרע־הױראָע	מורה־הוראה
מױרע־העטער	מורה־היתּר —> מורה־היתּר זײַן
מױרע־מױרײנע	מורה־מורינו
מױרע־נעװוּכים	מורה־נבֿוכים
מױרעראָע	מורה־הוראה
מױשל	מושל
מױשל־בעקיפּע	מושל־בכּיפּה
מױשע	משה
מױשעװ	מושבֿ
מױשעװ־לײצים	מושבֿ־לצים
מױשעװ־סקײנים	מושבֿ־זקנים
מױשע ראַבײנע	משה רבנו
מוכזעק	מוחזק
מוכן(־אומזומען)	מוכן(־ומזומן)
מוכרעם	מוחרם
מום	מום
מומאָרים	מומר
מומכים	מומחה
מומכע	מומחה
מומכע(נ)טע	מומחה(נ)טע
מומער	מומר
מומער־לעהאַכעס	מומר־להכעיס
מומער־לעטעאָװן	מומר־לתּאָבֿון
מומרים	מומר
מוסאָפֿים	מוסף
מוסעף	מוסף
מוסער	מוסר
מוסער	מוסר־ליטעראַטור
מוסער־האַסקל	מוסר־השׂכּל
מוסערן	מוסרן
מוסערניק	מוסרניק
מוסער־סײפֿער	מוסר־ספֿר
מוסער־ספֿאָרים	מוסר־ספֿר
מוסקעם	מוסכּם
מופֿלאָגים	מופֿלג
מופֿלאָגים	מופֿלג
מופֿלעג	מופֿלג
מופֿלעג	מופֿלג
מופֿלעג־(באַ)טױרע	מופֿלג־(ב)תּורה
מופֿקאָרים	מופֿקר
מופֿקער	מופֿקר
מופֿקערעס	מופֿקרת
מוצלאָכים	מוצלח
מוצלעך	מוצלח
מוקאַז	מוכּז / מוכּ״ז
מוקדעם אומעוכער	מוקדם ומאוחר
מוקעס־עץ	מוכּת־עץ
מוקצע	מוקצה
מוקצע־מאַכמעס־מיִעס	מוקצה־מחמת־מיאוס
מוקשע	מוקשה
מורשים	מורשה
מורשע	מורשה
מושװע	מושװה װערן
מושלאָמים	מושלם
מושלעם	מושלם
מושלעמעס	מושלמת
מושפּע	מושפּע װערן
מי…	מ…
מיבאָד־יאָם	מבעוד־יום
מיבאַיִס־לעבאַיִס	מבית־לבית
מיבעטן־װעלײדע	מבטן־ולידה
מיגדעש	מיקדש
מיגיִע־קאַפּע	מיגיע־כּפּו
מיגיִע־קאַפּעאָ	מיגיע־כּפּיה
מיגיִע־קאַפּעװ	מיגיע־כּפּיו
מיגע	מיגו
מידאָר לעדאָר	מדור לדור
מידבאָריעס	מידבר
מידבער	מדבר
מידבער	מידבר
מידױרײַסע	מדאורײַתא
מידײ יאָם בעיױמע	מדי יום ביומו
מידײ כױדעש בעכאָטשע	מדי חודש בחודשו
מידײע	מי־יודע
מידײ שאַבעס בעשאַבאַטע	מדי שבת בשבתּו
מידיען	מידין
מידע	מידה
מידע־בזוּיע	מידה־בזױה
מידע־טױװע	מידה־טובֿה
מידע־מעגונע	מידה־מגונה
מידעס	מידות
מידעס־האַדין	מידת־הדין
מידעס־האָראַכמים	מידת־הרחמים
מידעס־זדאָם	מידת־סדום
מידע קענעגעד מידע	מידה כּנגד מידה
מידראַבאָנען	מדרבנן
מי־װאָײש אומי־װאַמאַיִם	מי־בֿאש ומי־בֿמים
מי װאָמי (האָהױלכים)	מי ומי (ההולכים)
מיִוטים	מיעוט
מיזבײכעס	מזבח
מיזבײעך	מזבח
מיזדאַװעג	מזדװג װערן
מיזמױרים	מיזמור
מיזמער	מיזמור
מיזראָכי	מזרחי
מיזראָכים	מיזרח
מיזרעך	מיזרח
מיזרעך	מיזרח
מיטאָך	מתּוך
מיטאָך־האַמײַסע	מתּוך־המעשׂה
מיטאָך־סכאָק	מתּוך־שׂחוק
מיטאַמער־װעױלע	מתּמר־ועולה —> מתּמר־ועולה זײַן
מיטע	מטה
מיטע	מיטה
מיִיאַד	מיד
מיִיאַד־לעיאַד	מיד־ליד
מי יאָמעס	מי ימות
מײַדאַנים	מעדנים
מײַדאַנע־מײלעך	מעדני־מלך
מײַדאַנע־מלאָכים	מעדני־מלכים
מײַדעם	מאדים
מײַ דעקאָאַמרע ראַבאָנען	מאַי דקאמרי רבנן
מײַ דעקאָאַמרע רעבעצן	מאַי דקאמרי רביצין
מײװן	מבֿין
מײװן־בעלאָשן	מבֿין־בלשון —> מבֿין־בלשון זײַן
מײװנטע	מבֿינטע
מײװן־קאָל־דיבער	מבֿין־כּל־דיבור —> מבֿין־כּל־דיבור זײַן
מײַװער	מעבֿיר —> מעבֿיר זײַן
מײַװער־יאַבעק	מעבֿר־יבוק
מײַװער־נאַכלע	מעבֿיר־נחלה —> מעבֿיר־נחלה זײַן
מײַװער־סעדרע	מעבֿיר־סדרה —> מעבֿיר־סדרה זײַן
מײַ טײַמע	מאַי טעמא
מײטעװ	מטיבֿ —> מטיבֿ זײַן
מײטעװ־כאָלעם	מטיבֿ־חלום —> מטיבֿ־חלום זײַן
מײַטעק	מעתּיק
מײַטעק	מעתּיק —> מעתּיק זײַן
מי ײִכיע	מי יחיה
מײַכאָלים	מאכל
מײַכאָלעס־אַסורעס	מאכלות־אַסורות
מײכושים	מיחוש
מײַכל	מאכל
מײכל	מוחל
מײַכל־טאַרפֿעס	מאכיל־טרפֿות —> מאכיל־טרפֿות זײַן
מײַכל־מלאָכים	מאכל־מלכים
מײכן	מכין —> מכין זײַן —> זײַן זיך
מײכע־טײסע	מהיכא־תּיתי
מײכעש	מיחוש
מײַלאָסע	מעלתו
מײַלן באַקױדעש	מעלין בקודש
מײלע	מילא
מײַלע	מעלה
מײַלע־גײרע	מעלה־גירה —> מעלה־גירה זײַן
מײלעך	מלך
מײלעך	מלך
מײלעך־בעקיפּע	מלך־בכּיפּה
מײלעך־כעסעד	מלך־חסד
מײלעך־מאַלכע־האַמלאָכים	מלך־מלכי־המלכים
מײלעך־עװיען	מלך־אבֿיון
מײַלעם	מעלים —> מעלים זײַן
מײלעץ	מליץ
מײלעץ־יױשער	מליץ־יושר
מײלעץ־יױשערטע	מליץ־יושרטע
מײַמאָדעס	מעמדות
מײַמאָדעס	מעמדות
מײַמאָרים	מאמר
מײַמאָרע־כאַזאַל	מאמר־חז״ל
מײַמינים	מאמין
מײַמעד	מעמד
מײַמען	מאמין
מײמעסן	ממיתן
מײַמעק	מעמיק —> מעמיק זײַן
מײַמער	מאמר
מײַמער־האַמוסגער	מאמר־המוסגר
מײַמעריסטיק	מאמריסטיק
מײַמער־כאַזאַל	מאמר־חז״ל
מײַ נאַפֿקע־מינע	מאַי נפֿקא־מינה
מײַנע	מענה
מײַנע־לאָשן	מענה־לשון
מײַנעש	מעניש —> מעניש זײַן
מײַסים	מעשׂים
מײסים	מת
מײַסים־אַשער־לױ־יעאָסו	מעשׂים־אשר־לא־יעשׂו
מײַסים־בעכאָל־יאָם	מעשׂים־בכל־יום
מײַסים־טאַטױִם	מעשׂה־תּעתּועים
מײַסים־טױװים	מעשׂים־טובֿים
מײַסים־ראָיִם	מעשׂה־רע
מײסיס־אומעדיִעך	מסית־ומדיח
מײסיִעך־לעפֿי־טומע	מסיח־לפֿי־תּומו
מײַסע	מעשׂה
מײַסע	מעשׂה
מײַסע	מעשׂה־ביכל
מײַסע־אױנען	מעשׂה־אונן
מײַסע־בעטאָך־מײַסע	מעשׂה־בתּוך־מעשׂה
מײַסע־ברײשעס	מעשׂה־בראשית
מײַסע־טאַטױִם	מעשׂה־תּעתּועים
מײַסע־יאָדאָװ	מעשׂי־ידיו
מײַסע־יאָדײַ	מעשׂי־ידי
מײסע־מידבער	מתי־מידבר
מײסע־מיצװע	מת־מיצװה
מײַסע־מערקאָװע	מעשׂה־מרכּבֿה
מײַסע־נױרע	מעשׂה־נורא
מײַסע־ניסים	מעשׂה־נסים
מײַסע־ניסים	מעשׂה־נסים
מײַסע־ניפֿלע	מעשׂה־ניפֿלא
מײַסעס	מעשׂה
מײַסע־סאָטן	מעשׂה־שׂטן
מײַסע־סדאָם	מעשׂה־סדום
מײַסער	מעשׂר
מײַסע־ראַ	מעשׂה־רע
מײַסער־שײני	מעשׂר־שני
מײַסע־שעהױע	מעשׂה־שהיה
מײַסרעס	מעשׂר
מײַסרעס	מעשׂרות
מײע	מאה
מײע	מאה
מי־יעדײע	מי־יודע
מײער	מאיר
מײער באַל־(האַ)נעס	מאיר בעל־(ה)נס
מײַ קאָ מאַשמע לאָן	מאַי קאָ משמע לן
מײַ קולע הײַ	מאַי כּולי האַי
מײקל	מקיל
מײקע(נע)ן	מקיא(נע)ן
מײַקערן	מעקרן
מײַריכים	מאריך
מײרע	מערה
מײַרע	מערה
מײַרעװ	מערבֿ
מײַרעװ	מעריבֿ
מײַרעך	מאריך
מײַרעך	מאריך —> מאריך זײַן
מײַרעך־יאָמים(־װעשאָנים)	מאריך־ימים(־ושנים) —> מאריך־ימים(־ושנים) זײַן
מײשעװ	משיבֿ —> משיבֿ זײַן
מײשעװ־שאָלעם	משיבֿ־שלום —> משיבֿ־שלום זײַן
מײַשער	מעשיר —> מעשיר זײַן
מיכאָעל	מיכאל
מיכוץ	מחוץ
מיכוץ־לאָאָרעץ	מחוץ־לאָרץ
מיכוץ־לאָיִר	מחוץ־לעיר
מיכוץ־לאַמאַכנע	מחוץ־למחנה
מיכוץ־לעדערעך־האַטעװע	מחוץ־לדרך־הטבֿע
מיכטאָװים	מיכתּבֿ
מיכטעװ	מיכתּבֿ
מיכיע	מחיה
מיכנעסאַיִם	מכנסים
מיכע	מיכה
מיכשױלים	מיכשול
מיכשל	מיכשול
מי לאָנו גאָדל מי…	מי לנו גדול מ…
מילכאָמע	מלחמה
מילכעמעס־גאָג־אומאָגעג	מלחמת־גוג־ומגוג
מילסע־דיבדיכעסע	מילתא־דבדיחותא
מילע	מילה
מילע־דיבדיכעסע	מילתא־דבדיחותא
מילע־דעאַלמע	מילי־דעלמא
מילעל	מלעיל
מילראַ	מלרע
מימאַאַמאַקים	ממעמקים
מימײלע	ממילא
מין	מין
מין	מין
מין	מן
מינאַאַר װעאַד זאָקן	מנער ועד זקן
מינאַדין	מן־הדין
מינאַסטאַם	מן־הסתּם
מינאַצאַד	מן־הצד
מין־אַשאָמאַיִם	מן־השמים
מינהאָגים	מינהג
מין־האַטױרע	מן־התּורה
מין־האַמופֿכער	מן־המובֿחר
מין־האַסאָפֿע־װעלאַכוץ	מן־השׂפֿה־ולחוץ
מין האַקױעך על האַפּױעל	מן הכּוח אל הפּועל
מין־האַשאָמאַיִם	מן־השמים
מין־זאָכער	מין־זכר
מיניאָנים	מנין
מיניען	מנין
מינכע	מינחה
מינכע־גדױלע	מינחה־גדולה
מינכע־קטאַנע	מינחה־קטנה
מין־נעקײװע	מין־נקבֿה
מין־סטאַם	מין־סתּם
מינעג	מינהג
מינעג־האָױלעם	מינהג־העולם
מינעג־האַמעדינע	מינהג־המדינה
מינעג־יאָשן	מינהג־ישן
מינעג־שטוס	מינהג־שטות
מינעס	מינות
מינע־קיטניעס	קיטניות: אַלערלײ מיני־קיטניות
מי סאָמכאָ	מי שׂמך
מיסאַסעף	מתאַסף —> מתאַסף זײַן —> זײַן זיך
מיסאַסעק	מתעסק —> מתעסק זײַן —> זײַן זיך
מיסאַסעק־בעמיצװעס	מתעסק־במיצװת
מיסאַסעק־בעצאָרכע־ציבער	מתעסק־בצרכי־ציבור
מיסאַסקים	מתעסקים
מיסאַסקים־בעמיצװעס	מתעסק־במיצװת
מיסאַסקים־בעצאָרכע־ציבער	מתעסק־בצרכי־ציבור
מיסבױדעד	מתבודד —> מתבודד זײַן —> זײַן זיך
מיסבױנען	מתבונן —> מתבונן זײַן —> זײַן זיך
מיסגאַבער	מתגבר —> מתגבֿ זײַן —> זײַן זיך
מיסדאַבעק	מתדבק —> מתדבק זײַן —> זײַן זיך
מיסװאַדע	מתװדה —> מתװדה זײַן —> זײַן זיך
מיסװאַקײעך	מתװכּח —> מתװכּח זײַן —> זײַן זיך
מיסױרער	מתעורר —> מתעורֿ זײַן —> זײַן זיך
מיסטאַגעף	מסתּגף —> מסתּגף זײַן —> זײַן זיך
מיסטאַם	מסתּם
מיסטאַמע	מסתּמא
מיסטאָמע	מסתּמא
מיסטאַפּעק־בעמועט	מסתּפּק־במועט
מיסטאַפּקים־בעמועט	מסתּפּק־במועט
מיסיאַכעד	מתיחד —> מתיחד זײַן —> זײַן זיך
מיסיאַכעס	מתיחס —> מתיחס זײַן —> זײַן זיך
מיסיאַעץ	מתיעץ —> מתיעץ זײַן —> זײַן זיך
מיסיאַעש	מתיאש —> מתיאש זײַן —> זײַן זיך
מיסים	מס
מיסינײַ	מסיני
מיסכאַבער	מתחבר —> מתחבֿ זײַן —> זײַן זיך
מיסכאַװן	מתכװן —> מתכװן זײַן —> זײַן זיך
מיסכאַטן	מתחתּן —> מתחתּן זײַן —> זײַן זיך
מיסכאַנען	מתחנן —> מתחנן זײַן —> זײַן זיך
מיסכאַקעם	מתחכּם —> מתחכּם זײַן —> זײַן זיך
מיסכאָרים	מיסחר
מיסכײַעװ	מתחײבֿ —> מתחײבֿ זײַן —> זײַן זיך
מיסכײַעװ־בענאַפֿשע	מתחײבֿ־בנפֿשו —> מתחײבֿ־בנפֿשו זײַן —> זײַן זיך
מיסכער	מיסחר
מיסנאַגדים	מתנגד
מיסנאַגדיש	מתנגדיש
מיסנאַגדעס	מתנגדות
מיסנאַגעד	מתנגד
מיסנאַצל	מתנצל —> מתנצל זײַן —> זײַן זיך
מיסע	מיתה
מיסע־בינשיקע	מיתה־בנשיקה
מיסע־מעשונע	מיתה־משונה
מיספּאַלעל	מתפּלל
מיספּאַלעל	מתפּלל —> מתפּלל זײַן
מיספּאָרים	מיספּר
מיספּער	מיספּר
מיספּער־גאָדל	מיספּר־גדול
מיספּער־קאָטן	מיספּר־קטן
מיסקאַנע	מתקנא —> מתקנא זײַן —> זײַן זיך
מיסראַכעק	מתרחק —> מתרחק זײַן —> זײַן זיך
מיסראַעם	מתרעם —> מתרעם זײַן
מיִעט	מיעוט
מיִעס	מיאוס
מיִעס־אומאָעס	מיאוס־ומאָוס
מיִעסן	מיאוסן —> מיאוסן זיך
מיִעסקײט	מיאוסקײט
מיפּיװ־האַקאָדעש	מפּיו־הקדוש
מיפּנײ־דאַרקע־שאָלעם	מפּני־דרכּי־שלום
מיפּעסעך־בײסע	מפּתח־ביתו
מיצאַד	מצד
מיצװע	מיצװה
מיצװע	מיצװה־טאַנץ
מיצװעס־אײַסע	מיצװת־עשׂה
מיצװעס־לױסײַסע / ־לױסעסע	מיצװת־לא־תעשׂה
מיצװעס־עסע	מיצװת־עשׂה
מיצטאַרעף	מצטרף —> מצטרף זײַן —> זײַן זיך
מיצנעפֿעס	מצנפֿת
מיצראַיִם	מצרים
מיצרי	מיצרי
מיצריס	מיצרית
מיצריִעס	מיצרית
מיצריש	מיצריש
מיקאַדמױנים	מקדמונים
מיקאַדמעס־דענאָ	מקדמת־דנאָ
מיקאָטן־ועאַד־גאָדל	מקטן־ועד־גדול
מיקאָל־האַמינים	מכּל־המינים
מיקאָל־האַמינים־שעהו	מכּל־המינים־שהוא
מיקאָל־טוּװ	מכּל־טובֿ
מיקאָל־מײַמינים־שעהו	מכּל־מאמינים־שהוא
מיקאָלשקן	מכּל־שכּן
מיקאַמע	מכּמה
מיקאַמע(־װעקאַמע) טײַמים	מכּמה(־וכּמה) טעמים
מיקאַמע(־װעקאַמע) שאָנים	מכּמה(־וכּמה) שנים
מיקאַק	מק״ק
מיקדעש	מקדש
מיקװאָעס	מיקװאָות
מיקװאָעס	מיקװה
מיקװע	מיקװה
מיקױעך	מכּוח
מיקױעך על האַפּױעל	מכּוח אל הפּועל
מיקלאָטים	מיקלטים —> מיקלט
מיקלױמערשט	מכּלומרשט
מיקלעט	מיקלט
מיקעהילע־קדױשע	מק״ק: מקהילה־קדושה
מיקעץ	מקץ
מיקצעס־מין־האַמיקצעס	מקצת־מן־המקצת
מיקראָעס־גדױלעס	מקראָות־גדולות
מיקרים	מיקרה
מיקרע	מיקרה
מיריעם	מרים
מיריעם האַנעװיִע	מרים הנבֿיאה
מירצעשעם	אם־ירצה־השם
מירשאַס	מרשעת
מישאַבעס־לעשאַבעס	משבת־לשבת
מישאָנים־קאַדמױניעס	משנים־קדמוניות
מישום	משום
מישום־דאַרקע־האַשאָלעם	משום־דרכּי־השלום
מישום־מאַריס־אַיִן	משום־מראית־עין
מישוראַס	משרת:  איראָנישער אַרױסרעד
מישטאַדל	משתּדל —> משתּדל זײַן —> זײַן זיך
מישטאַטײעך	משתּטח —> משתּטח זײַן —> זײַן זיך
מישטאַטעף	משתּתּף —> משתּתּף זײַן —> זײַן זיך
מישײשעס־יעמײ־ברײשעס	מששת־ימי־בראשית
מישיכמע־װאָמײַלע	משכמו־ומעלה
מישלאַכעס	משלחת
מישלױעך־מאָנעס	משלוח־מנות
מישלע	משלי
מישמאָרים	מישמר
מישמױרעס	משמורת
מישמער	מישמר
מישנײַעס	משניות
מישנע	מישנה
מישנע	משנה
מישנע־טױרע	יד־החזקה: מישנה־תּורה
מישנע־לאַמײלעך	מישנה־למלך
מישעבײרעך	מי־שברך
מישעלאָנו	משלנו
מישפּאָטים	מישפּט
מישפּאָטים	משפּטים
מישפּאַכטע(רע)	משפּחטע(רע)
מישפּאָכע	משפּחה
מישפּעט	מישפּט
מישפּעטן	מישפּטן
מישקאָלים	מישקל
מישקאַנטע	משכּנתּא
מישקױלעס	משקולת
מישקל	מישקל
מישקן	מישכּן
מישקעװ־בעהײמע	מישכּבֿ־בהמה
מישקעװ־זאָכער	מישכּבֿ־זכ(ו)ר
מכאַק	מחק
מלאָכים	מלך
מלאָכים	מלכים
מלױ־קױמאָסע	מלא־קומתו
מנאָכעס	מנחות
מע	מה
מע…	מ…
מעאַאַװע	מאַהבֿה
מעאַאַװעס	מאַהבֿת־
מעאַאַװעס־מאָרטכע	מאַהבֿת־מרדכי
מעאַבעד	מאַבד —> מאַבד זײַן
מעאַבעד־אַצמע־לאַדאַאַס	מאַבד־עצמו־לדעת
מעאַבעד־אַצמע־לאַדאַאַס	מאַבד־עצמו־לדעת —> מאַבד־עצמו־לדעת זײַן —> זײַן זיך
מעאַבעד־מאָמען	מאַבד־ממון —> מאַבד־ממון זײַן
מעאַגן	מעגן —> מעגן זײַן
מעאַהאַװע	מאַהבֿה
מעאַהאַװעס	מאַהבֿת־
מעאַהאַװעס־מאָרטכע	מאַהבֿת־מרדכי
מעאַװדעס לעכײרעס	מעבֿדות לחירות
מעאַכױרײ־האַפּאַרגעד	מאַחורי־הפּרגוד
מעאַכעד	מאַחד —> מאַחד זײַן
מעאַנעס	מאַנס —> מאַנס זײַן
מעאַסעף	מאַסף —> מאַסף זײַן
מעאַסעף־מאָמען	מאַסף־ממון —> מאַסף־ממון זײַן
מעאַקל	מעכּל —> מעכּל זײַן
מעאַקעװ	מעכּבֿ —> מעכּבֿ זײַן
מעאַקעװ־האַקריִע	מעכּבֿ־הקריאה —> מעכּבֿ־הקריאה זײַן
מעאַרבע פּינעס־האָױלעם	מאַרבע פּינות־העולם
מעאַרבע קאַנפֿעס־האָאָרעץ	מאַרבע כּנפֿות־האָרץ
מעאָרעס־האַמאַכפּײלע	מערת־המכפּלה
מעאָרעס־פּריצים	מערת־פּריצים
מעאַרער	מערער —> מערער זײַן
מעגאַדל	מגדל —> מגדל זײַן
מעגאַזעם	מגזם —> מגזם זײַן
מעגאַלע	מגלה —> מגלה זײַן
מעגאַלע־טמירן	מגלה־טמירין
מעגאַמגעם	מגמגם —> מגמגם זײַן
מעגולגל	מגולגל װערן
מעגונע	מגונה
מעגושעם	מגושם
מעגושעם	מגושם
מעגושעמדיק	מגושמדיק
מעגײַער	מגײר —> מגײר זײַן
מעגײַער	מגײר —> מגײר זײַן —> זײַן זיך
מעגילע	מגילה
מעגילעס־אײכע	מגילת־איכה
מעגילעס־עסטער	מגילת־אסתּר
מעגילעס־רוס	מגילת־רות
מעדאַבעק	מדבק —> מדבק זײַן —> זײַן זיך
מעדאַבער	מדבר
מעדאָע	מודעה
מעדאַקדעק	מדקדק
מעדאַקדעק	מדקדק —> מדקדק זײַן
מעדובער	מדובר
מעדינע	מדינה
מעדינע	מדינה־גײער
מעדינע־כאַכאָמים	מדינה־חכם
מעדינע־כאָכעם	מדינה־חכם
מעדינעס	מדינת־
מעדינעס־ײִסראָעל	מדינת־ישׂראל
מעדיִע	מודיע —> מודיע זײַן
מעדראָשים	מדרש
מעדרעש	מדרש
מעהאַדער	מהדר —> מהדר זײַן
מעהאַדרין־מין־האַמעהאַדרין	מהדרין־מן־המהדרין
מעהאָכײל װעאַד קאָלאָ	מהחל ועד כּלה
מעהאַלעך	מהלך
מעהאַלעך־ראַװ	מהלך־רבֿ
מעהאַנע	מהנה —> מהנה זײַן
מעהאַפּעך	מהפּך —> מהפּך זײַן
מעהאַר(ה)ער	מהרהר —> מהרהר זײַן
מעהודאָרים	מהודר
מעהודער	מהודר
מעהומע	מהומה
מעהוס	מהות
מעהײַ־טײַמע	מהאַי־טעמא
מעהײַעם װאָהאָלע	מהיום והלאה
מעהירעס	מהירות
מעובערעס	מעוברת
מעװאַזע	מבֿזה —> מבֿזה זײַן
מעװאַטל	מבֿטל —> מבֿטל זײַן
מעװאַטער	מװתּר —> מװתּר זײַן
מעװאַטער	מותּר —> מותּר זײַן
מעװאַלבל	מבֿלבל —> מבֿלבל זײַן
מעװאַסער	מבֿשׂר —> מבֿשׂר זײַן
מעװאַסער־פּסורע	מבֿשׂר־בשׂורה —> מבֿשׂר־בשׂורה זײַן
מעװאַער	מבֿאר —> מבֿאר זײַן
מעװאַער	מבֿער —> מבֿער זײַן
מעװאַער־כאָמעץ	מבֿער־חמץ —> מבֿער־חמץ זײַן
מעװאַקער־כױלע	מבֿקר־חולה —> מבֿקר־חולה זײַן
מעװוּזע	מבֿוזה
מעװוּזע	מבֿוזה װערן
מעװוּזע־אומעװאַזע	מבֿוזה־ומבֿזה —> מבֿוזה־ומבֿזה זײַן
מעװוּיעש	מבֿױש
מעװוּלבל	מבֿולבל װערן
מעװוּסעם	מבֿוסם
מעװוּעל	מבֿוהל װערן
מעװוּעלדיק	מבֿוהלדיק
מעװײַעש	מבֿײש —> מבֿײש זײַן
מעװינים	מבֿין
מעװינעס	מבֿינות
מעוּיעמדיק	מאױמדיק
מעױר עכאָד	מעור אחד
מעױרער	מעורר —> מעורֿ זײַן
מעורעװ־אים־האַבריִעס	מעורבֿ־עם־הבריות
מעזאַװעג	מזװג —> מזװג זײַן
מעזאַלזל	מזלזל —> מזלזל זײַן
מעזאַנע	מזנה —> מזנה זײַן
מעזאַקע	מזכּה —> מזכּה זײַן
מעזאַרעז	מזרז —> מזרז זײַן
מעזוזע	מזוזה
מעזױנעס	מזונות
מעזומאָנים	מזומן
מעזומען	מזומן
מעזומען	מזומן
מעזיװ־האַשכינע	מזיװ־השכינה
מעזעקטאָװ	מזג־טובֿ
מעטאַטרען	מטטרון
מעטאַלטעלים	מטלטלים
מעטאַלטעלן	מטלטלין
מעטאַמע	מטמא —> מטמא זײַן
מעטאַער	מטהר —> מטהר זײַן
מעטאַפּל	מטפּל —> מטפּל זײַן —> זײַן זיך
מעטופּאָלים	מטופּל
מעטופּל	מטופּל
מעטוראָפֿים	מטורף
מעטורעף	מטורף
מעטורעפֿעס	מטורפֿת
מעטושטעש	מטושטש
מעיאַבעם	מיבם —> מיבם זײַן
מעיאַזדים	מיסד
מעיאַטער	מיתּר —> מיתּר זײַן
מעיאַכעד	מיחד —> מיחד זײַן —> זײַן זיך
מעיאַכעס	מיחס —> מיחס זײַן —> זײַן זיך
מעיאַסעד	מיסד
מעיאַסעד	מיסד —> מיסד זײַן
מעיאַעש	מיאש —> מיאש זײַן
מעיאַעש	מיאש —> מיאש זײַן —> זײַן זיך
מעיאַשעװ	מישבֿ —> מישבֿ זײַן —> זײַן זיך
מעיִד	מעיד —> מעיד זײַן
מעיוכאָסים	מיוחס
מעיוכעס	מיוחס
מעיוכעסטע	מיוחסטע
מעיוכעסעס	מיוחסת
מעיושעװ	מיושבֿ
מעיושעװדיק	מיושבֿדיק
מעיִז(־פּאָנעם)	מעיז(־פּנים) —> מעיז(־פּנים) זײַן
מעײװער־לעיאַם	מעבֿר־לים
מעײמעס־יאָם־האַדין	מאימת־יום־הדין
מעײַעם	מאַײם —> מאַײם זײַן
מעײַען	מעײן —> מעײן זײַן
מעיִלע	מעילה
מעיִניאָנע־דעיױמע	מעניני־דיומא
מעכאַבאָלים	מחבל
מעכאַבל	מחבל
מעכאַבלים	מחבל
מעכאַבעד	מכבד —> מכבד זײַן
מעכאַבעװ	מחבבֿ —> מחבבֿ זײַן
מעכאַבעק־אומענאַשעק	מחבק־ומנשק —> מחבק־ומנשק זײַן
מעכאַבער	מחבר
מעכאַבער	מחבר —> מחבֿ זײַן
מעכאַברים	מחבר
מעכאַדעש	מחדש
מעכאַדעש	מחדש —> מחדש זײַן
מעכאַדשים	מחדש
מעכאַװן	מכװן —> מכװן זײַן
מעכאַטשים	מחדש
מעכאַלעל	מחלל —> מחלל זײַן
מעכאַלעל־האַשעם	מחלל־השם —> מחלל־השם זײַן
מעכאַלעל־קױדעש	מחלל־קודש —> מחלל־קודש זײַן
מעכאַלעל־שאַבעס	מחלל־שבת —> מחלל־שבת זײַן
מעכאַלעל־שעם	מחלל־שם —> מחלל־שם זײַן
מעכאַלעל־שעם־שאָמאַיִם (בעפֿערעסיע)	מחלל־שם־שמים
מעכאַנעך	מחנך —> מחנך זײַן
מעכאַסער	מחסר —> מחסר זײַן
מעכאַפּער	מכפּר —> מכפּר זײַן
מעכאַפּער־פּאָנעם	מכפּר־פּנים —> מכפּר־פּנים זײַן
מעכאַק	מחק
מעכאַרעף־אומעגאַדעף	מחרף־ומגדף —> מחרף־ומגדף זײַן
מעכאַשעף	מכשף
מעכאַשעפֿטע	מכשפֿטע
מעכאַשפֿים	מכשף
מעכובאָדים	מכובד
מעכובעד	מכובד
מעכובעד	מכובד
מעכוטאָנים	מחותּן
מעכוטאָנעמשאַפֿט	מחותּנימשאַפֿט
מעכוטאָנעסשאַפֿט	מחותּנותשאַפֿט
מעכוטאָנעשאַפֿט	מחותּנישאַפֿט
מעכוטן	מחותּן
מעכוטענעסטע	מחותּנתטע
מעכוּיעװ	מחױבֿ
מעכוּיעװ־גאָלעס	מחױבֿ־גלות װערן
מעכולע	מכולה
מעכולעק	מחולק
מעכוסער	מחוסר־
מעכוסער־לעכעם	מחוסר־לחם
מעכוסרע	מחוסר־
מעכוסרע־לעכעם	מחוסר־לחם
מעכוערעס	מכוערת
מעכוץ	מחוץ
מעכוצאָפֿים	מחוצף
מעכוץ־לאָאָרעץ	מחוץ־לאָרץ
מעכוץ־לאָיִר	מחוץ־לעיר
מעכוץ־לאַמאַכנע	מחוץ־למחנה
מעכוץ־לעדערעך־האַטעװע	מחוץ־לדרך־הטבֿע
מעכוצענער	מחוצנער
מעכוצעף	מחוצף
מעכוצעף־פּאָנעם	מחוצף־פּנים
מעכוצעפֿטע	מחוצפֿטע
מעכוראַס	מכוערת
מעכטײסע	מהיכא־תּיתי
מעכטײסעדיק	מהיכא־תּיתידיק
מעכטײסעניצע	מהיכא־תּיתיניצע
מעכטײסעניק	מהיכא־תּיתיניק
מעכײַע	מחיה
מעכײַע	מחיה —> מחיה זײַן
מעכײַעװ	מחײבֿ —> מחײבֿ זײַן
מעכײַע־מײסים	מחיה־מתים —> מחיה־מתים זײַן
מעכײַע־נעפֿאָשעס	מחיה־נפֿשות
מעכײַע־נעפֿאָשעס	מחיה־נפֿשות —> מחיה־נפֿשות זײַן
מעכילע	מחילה
מעכילע־גמורע	מחילה־גמורה
מעכיצע	מחיצה
מעכירע	מכירה
מעכירעס־יױסעף	מכירת־יוסף
מעכירעס־כאָמעץ	מכירת־חמץ
מעכעס	מכס
מעלאַװים	מלװה
מעלאַװע	מלװה
מעלאַװע־מאַלקע	מלװה־מלכּה
מעלאָכע	מלאָכה
מעלאָכע־בזוּיע	מלאָכה־בזױה
מעלאָכע(נע)ן	מלאָכה(נע)ן
מעלאַמדים	מלמד
מעלאַמדעס	מלמדות
מעלאַמעד	מלמד
מעלאַמעד־סכוס	מלמד־זכות —> מלמד־זכות זײַן
מעלאַמעטקע	מלמדקע
מעלוכע	מלוכה
מעלומאָדים	מלומד
מעלומדעס	מלומדות
מעלומעד	מלומד
מעלומעדעס	מלומדת
מעלופּן	מלופּן
מעליצים	מליץ
מעליצע	מליצה
מעליצע־יױשער	מליץ־יושר
מעם	מ
מעם	מם
מעמאַלע	ממלא —> ממלא זײַן
מעמאַלע־מאָקעם	ממלא־מקום
מעמאַלע־מאָקעם	ממלא־מקום —> ממלא־מקום זײַן
מעמאַלע־מעקױמע	ממלא־מקומו
מעמוכן	ממוכן
מעמונים	ממונה
מעמונע	ממונה
מעם־טעס שאַאַרע־טומע	מ״ט שערי־טומאה
מעמרע	מימרא
מעמשאָלע	ממשלה
מענאַגן	מנגן
מענאַדװים	מנדבֿ
מענאַדעװ	מנדבֿ
מענאַדעװ	מנדבֿ —> מנדבֿ זײַן
מענאַדער	מנדר —> מנדר זײַן
מענאַהעל	מנהל
מענאַכעם	מנחם
מענאַכעם	מנחם —> מנחם זײַן
מענאַכעמאָװ	מנחם־אָבֿ
מענאַכעם־אָװל	מנחם־אָבֿל —> מנחם־אָבֿל זײַן
מענאַלים	מנהל
מענאַצײעך	מנצח —> מנצח זײַן
מענאַקע	מנכּה —> מנכּה זײַן
מענאַקעד	מנקד —> מנקד זײַן
מענאַקער	מנקר
מענאַקרים	מנקר
מענאַשע	מנשה
מענוּװאָלים	מנוּװל
מענוּװל	מנוּװל
מענוּװלטע	מנוּװלטע
מענוּװעלעס	מנוּװלת
מענױרע	מנורה
מענױרעס־האַמאָער	מנורת־המאור
מענוכע	מנוחה
מענוכע	מנוחה
מענוקעד	מנוקד
מענײ־אוּװײ	מניה־וביה
מענײבײ	מניה־וביה
מעניִע	מניעה
מעס	מת
מעסאַבעװ־קאָל־האַסיבעס	מסבבֿ־כּל־הסיבות
מעסאַדער	מסדר —> מסדר זײַן
מעסאַדער־ק(י)דושן	מסדר־קידושין
מעסאַדער־ק(י)דושן	מסדר־קידושין —> מסדר־קידושין זײַן
מעסאַלסל־בעסײרע	מסלסל־בשׂערו —> מסלסל־בשׂערו זײַן
מעסאַלעק	מסלק —> מסלק זײַן
מעסאַמײעך	משׂמח —> משׂמח זײַן
מעסאַקן	מתקן —> מתקן זײַן
מעסאַרעס	מסרס —> מסרס זײַן
מעסאַרעץ	מתרץ —> מתרץ זײַן
מעסוגל	מסוגל
מעסױרע	מסורה
מעסונים	מתון
מעסופּעק	מסופּק
מעסוקן	מסוכּן
מעסושעלעך	מתושלח
מעס־טאָהער	מת־טהור
מעסיבע	מסיבה
מעסײַעם	מסײם —> מסײם זײַן
מעסיכטע	מסיכתּא
מעסינעס	מתינות
מעסינעס־האָמען	משׂינאת־המן
מעסיפֿטע	מתיבֿתּא
מעסיקעס	מתיקות
מעסירע	מסירה
מעסירעס־מעדאָע	מסירת־מודעה
מעסירעס־נעפֿעש	מסירת־נפֿש
מעסלעס	מעת־לעת
מעס־מיצװע	מת־מיצװה
מעסן	מתן
מעסעכטע	מסכתּא
מעפֿאַטע	מפֿתּה —> מפֿתּה זײַן
מעפֿאַלפּל	מפֿלפּל —> מפֿלפּל זײַן —> זײַן זיך
מעפֿאַצע	מפֿצה —> מפֿצה זײַן
מעפֿאַרנעס	מפֿרנס —> מפֿרנס זײַן
מעפֿאָרסעם	מפֿורסם
מעפֿאָרסעם	מפֿורסם
מעפֿאַרסעם	מפֿרסם —> מפֿרסם זײַן
מעפֿאַרעש	מפֿרש
מעפֿאַרעש	מפֿרש —> מפֿרש זײַן
מעפֿאָרשים	מפֿרש
מעפֿולפּל	מפֿולפּל
מעפֿונאָקים	מפֿונק
מעפֿוניצע	מפֿוניצע
מעפֿונעק	מפֿונק
מעפֿורסאָמים	מפֿורסם
מעפֿורסעם	מפֿורסם
מעפֿורסעם	מפֿורסם
מעפֿײַעס	מפֿײס —> מפֿײס זײַן
מעפֿיצע־האַסקאָלע	מפֿיצי־השׂכּלה
מעפֿיצע־ספֿאַס־אײװער	מפֿיצי־שׂפֿת־עבֿר
מעצאַמצעם	מצמצם —> מצמצם זײַן
מעצאַער	מצער —> מצער זײַן
מעצאַער	מצער —> מצער זײַן —> זײַן זיך
מעצאַרעף	מצרף —> מצרף זײַן
מעצודעס־דאָװיד	מצודת־דוד
מעצודעס־ציִען	מצודת־ציון
מעצױראַאַס	מצורעת
מעצױראָיִם	מצורע
מעצױרע	מצורע
מעציִע	מציאה
מעציִעס	מציאות
מעציצע	מציצה
מעקאַבל	מקבל
מעקאַבל	מקבל —> מקבל זײַן
מעקאַבל־בעאַ(ה)אַװע	מקבל־באַהבֿה —> מקבל־באַהבֿה זײַן
מעקאַבל־טײַנעג	מקבל־תּענוג —> מקבל־תּענוג זײַן
מעקאַבל־נאַכעס	מקבל־נחת —> מקבל־נחת זײַן
מעקאַבל־פּאָנעם	מקבל־פּנים —> מקבל־פּנים זײַן
מעקאַבל־קיניען	מקבל־קנין —> מקבל־קנין זײַן
מעקאַבל־שאַבעס	מקבל־שבת —> מקבל־שבת זײַן
מעקאַבער	מקבר —> מקבֿ זײַן
מעקאַדעש	מקדש —> מקדש זײַן
מעקאַדעש־האַשעם	מקדש־השם —> מקדש־השם זײַן
מעקאַטרײגים	מקטרג
מעקאַטרעג	מקטרג
מעקאַטרעג	מקטרג —> מקטרג זײַן
מעקאָכים	מקח
מעקאַמעץ	מקמץ —> מקמץ זײַן
מעקאַנע	מקנא —> מקנא זײַן
מעקאָנענים	מקונן
מעקאַפּײעך	מקפּח —> מקפּח זײַן
מעקאַצער	מקצר
מעקאַצער	מקצר —> מקצר זײַן
מעקאַצער־יאָמים(־װעשאָנים)	מקצר־ימים(־ושנים) —> מקצר־ימים(־ושנים) זײַן
מעקאַצרים	מקצר
מעקאַרעװ	מקרבֿ —> מקרבֿ זײַן
מעקאַשע־לײלעד	מקשה־לילד
מעקובאָלים	מקובל
מעקובל	מקובל
מעקױמעס	מקום
מעקױנען	מקונן
מעקוּיעם	מקױם װערן
מעקױרים	מקור
מעקױרעס	מקור
מעקוראָװים	מקורבֿ
מעקורעװ	מקורבֿ
מעקײַעם	מקײם —> מקײם זײַן
מעקײַעם־פּסאַק	מקײם־פּסק —> מקײם־פּסק זײַן
מעקילים	מקיל
מעקעך	מקח
מעקעך־אומעמקער	מקח־וממכּר
מעקעך־טאָעס	מקח־טעות
מעראַגל	מרגל
מעראַכעם	מרחם —> מרחם זײַן
מעראַכעק	מרחק —> מרחק זײַן
מעראַמעז	מרמז —> מרמז זײַן
מערובאָיִם	מרובע
מערובע	מרובה
מערובע	מרובע
מערױעך־אָשעך	מרוח־אָשך
מערוצע	מרוצה
מערוצע־לאַבריִעס	מרוצה־לבריות
מערטשעם	אם־ירצה־השם
מערידע	מרידה
מערײנע	מורנו
מערכאַקים	מרחק
מערכע־טיפּכע	מרכא־טיפּחא
מערכעץ	מרחץ
מערכעק	מרחק
מערצעשעם	אם־ירצה־השם
מערקאָװע	מרכּבֿה
מעשאַדעך	משדך —> משדך זײַן
מעשאַדעך	משדך —> משדך זײַן —> זײַן זיך
מעשאַכעד	משחד —> משחד זײַן
מעשאַלײעך	משלח —> משלח זײַן
מעשאָלים	משל
מעשאַלעם	משלם —> משלם זײַן
מעשאַלעמען	משלמען
מעשאַלשל־בעיאַד	משלשל־ביד —> משלשל־ביד זײַן
מעשאַמער־אומאַצל	משמר־ומציל —> משמר־ומציל זײַן
מעשאַמעש	משמש
מעשאַמעש	משמש —> משמש זײַן
מעשאַמעש־האַמיטע	משמש־המיטה —> משמש־המיטה זײַן
מעשאַמשים	משמש
מעשאַנע	משנה —> משנה זײַן
מעשאַנע־שעם	משנה־שם —> משנה־שם זײַן
מעשאַעל־אײצע	משאל־עצה —> משאל־עצה זײַן —> זײַן זיך
מעשאַער	משער —> משער זײַן —> זײַן זיך
מעשאַקער	משקר —> משקר זײַן
מעשאָרסים	משרת
מעשאָרסיש	משרתיש
מעשאָרעס	משרת
מעשאָרעסטע	משרתטע
מעשאָרערים	משורר
מעשובאָדע־קאָאָל	משועבדי־קהל
מעשובעד	משועבד
מעשוגאָיִם	משוגע
מעשוגאָיִם	משוגענער
מעשוגאַס	משוגעת
מעשוגן	משוגען
מעשוגע	משוגע
מעשוגע	משוגע
מעשוגע־לעדאָװער־עכעד	משוגע־לדבֿר־אחד
מעשוגענער	משוגענער
מעשױרער	משורר
מעשולאָכים	משולח
מעשולאַכעס	משולחת
מעשולאָשים	משולש
מעשולעך	משולח
מעשולעם	משולם
מעשולעש	משולש
מעשומאָדים	משומד
מעשומעד	משומד
מעשומעדעס	משומדת
מעשומעדעסטע	משומדתטע
מעשונע	משונה
מעשופּע	משופּע
מעשופֿרע־דעשופֿרע	משופֿרי־דשופֿרי
מעשײַשײע	משעשע —> משעשע זײַן —> זײַן זיך
מעשיכים	משיח
מעשיכיש	משיחיש
מעשיכעס	משיחות
מעשיִעך	משיח
מעשיִעך בען־דאָװיד	משיח בן־דוד
מעשיִעך בען־יױסעף	משיח בן־יוסף
מעשיִעכל	משיחל
מעשעך	משך
מרױעך־אָשעך	מרוח־אָשך

נאָגעד	נגיד
נאַדװאָנים	נדבֿן
נאַדװאָנעס	נדבֿנות
נאַדװן	נדבֿן
נאַדװנטע	נדבֿנטע
נאַדן	נדן
נאָדעװ	נדיבֿ
נאָדעװ־האַיעדוע	נדיבֿ־הידוע
נאַהאַראָ נאַהאַראָ אופֿשאָטע	נהראָ נהראָ ופֿשטי
נאָװי	נבֿיא
נאַװענאַד	נע־ונד
נאַװענאַדניצע	נע־ונדניצע
נאַװענאַדניק	נע־ונדניק
נאָזער	נזיר
נאָיאַפֿים	נואף
נאַך	נ״ך
נאַכזער לעיִניאָנײנו	נחזור לענינינו
נאָכטאַם	נאָכטעם
נאַכלאָעס	נחלה
נאַכלע	נחלה
נאַכמען	נחמן
נאָכעם	נחום
נאַכעס	נחת
נאַכעס־רועך	נחת־רוח
נאָכעש	נחש
נאָכעש־האַקאַדמױני	נחש־הקדמוני
נאָלדים	נולד
נאַמע	נעמי
נאָמע	נעמי
נאָסאָ	נשׂא
נאָסי	נשׂיא
נאָסן	נתן
נאָסנים	נותן
נאַסענען	נתנען
נאָע	נאה
נאָע־דױרעש	נאה־דורש
נאָע־מעקײַעם	נאה־מקײם
נאַפֿטאָלע	נפֿתּלי
נאַפֿקע	נפֿקא
נאַפֿקעמינע	נפֿקא־מינה
נאַצכאָנעס	נצחנות
נאַצערעס	נצרת
נאַקװעס	נקבֿות
נאָקי	נקי
נאַרע־האַמױראָסע	נערה־המאורשׂה
נאַרע־שעניספּאַטעסע	נערה־שניתפּתּתה
נאָשים	אישה
נאָשים	נשים
נאָשים־װעטאַף	נשים־וטף
נאָשים־ציטקאָניעס	נשים־צדקניות
נאָשים־צנועס	אישה־צנועה
נוטריקן	נוטריקון
נױגסים	נוגשׂ
נױגעס	נוגשׂ
נױטים־לאָמעס	נוטה־למות
נױטע	נוטה
נױטע	נוטה —> נוטה זײַן
נױטע־לאָמעס	נוטה־למות
נױטע־לאָמעס	נוטה־למות
נױלעד	נולד
נױלעד	נולד װערן
נױלעד־מאָהעל	נולד־מהול
נױמע	נעמי
נױסים	נוסע
נױסים	נושׂאים
נױסן	נותן
נױסע־האַמיטע	נושׂאי־המיטה
נױסע־כײן	נושׂא־חן —> נושׂא־חן זײַן
נױסענען	נותנען
נױסע־פּאָנעם	נושׂא־פּנים —> נושׂא־פּנים זײַן
נױסע־קײלים	נושׂא־כּלים
נױעג	נוהג
נױעג	נוהג —> נוהג זײַן —> זײַן זיך
נױעג־קאָװעד	נוהג־כּבֿוד —> נוהג־כּבֿוד זײַן
נױעך	נח
נױעך־לעבריִעס	נוח־לבריות
נױעך־לעבריִעס	נוח־לבריות
נױעף	נואף
נױעפֿטע	נואפֿטע
נױעפֿים	נואף
נױעפֿן	נואפֿן
נױפֿעך	נופֿך
נױפֿעך־מישעלאָ	נופֿך־משלה
נױפֿעך־מישעלױ	נופֿך־משלו
נױצרי	נוצרי
נױקסים	נוגשׂ
נױקעם	נוקם —> נוקם זײַן —> זײַן זיך
נױקעם־װענױטער	נוקם־ונוטר
נױקעם־װענױטער	נוקם־ונוטר —> נוקם־ונוטר זײַן —> זײַן זיך
נױקעם־װענױטער־קענאָכעש	נוקם־ונוטר־כּנחש
נון	נ
נון	נון
נוסכאָעס	נוסח
נוסעך	נוסח
נוסעך־אַשקענאַז	נוסח־אַשכּנז
נוסעך־האָאַרי	נוסח־האַר״י
נוסעך־ספֿאַרד	נוסח־ספֿרד
ניבלפּע	ניבול־פּה
ניגונים	ניגון
ניגזאָלים	ניגזל
ניגזל	ניגזל
ניגזער	ניגזר װערן
ניגלע	ניגלה
ניגמער	ניגמר
ניגן	ניגון
נידה	נידה
ניװזים	ניבֿזה
ניװזע	ניבֿזה
ניװכאָרים	ניבֿחר
ניװכער	ניבֿחר
ניװל־אומישטױמעם	ניבֿהל־ומשתּומם
ניװל־װענישטױמעם	ניבֿהל־ונשתּומם
ניזעק	ניזוק װערן
ניזעקן	ניזוקן
ניזער	ניזהר
ניטבאָיִם	ניתּבע
ניטבע	ניתּבע
ניטכע	נידחה
נײדער	נדר
נײַסע־װענישמע	נעשׂה־ונשמע
נײפֿעלע	נפֿלע
נײר	נר
נײרטאָמעד	נר־תּמיד
נײרע־יאָער	נ״י  נרו־יאיר
ניכבאָדים	ניכבד
ניכבאָדע־האָיִר	ניכבדי־העיר
ניכבעד	ניכבד
ניכטאָװים	ניכתּבֿ
ניכטעװ	ניכתּבֿ
ניכלעל	ניכלל
ניכנאָיִם	ניכנע
ניכנע	ניכנע
ניכע	ניחא
ניכעסע	ניחותא
ניכפּע	ניכפּה
ניכפּעניצע	ניכפּהניצע
ניכפּעניק	ניכפּהניק
ניכשל	ניכשל װערן
נילע	נעילה
נימוסים	נימוס
נימעס	נימאס
נימעס	נימאס װערן
נימעס	נימוס
נימעס־אומאָעס	נימאס־ומאָוס
נימעס־אומאָעס	נימאס־ומאָוס װערן
נימעס־אומיִעס	נימאס־ומיאוס װערן
נימצע	נימצא
נימרעד	נמרוד
נימשאָלים	נימשל
נימשל	נימשל
נינױִם	נענועים
ניסאַלע	נתעלה װערן
ניסאַשער	נתעשר װערן
ניסבאַקעש	נתבקש װערן
ניסגאַדל	נתגדל װערן
ניסגאַלע	נתגלה װערן
ניסױען	נסיון
ניסטאַלעק	נסתּלק װערן
ניסטאָרים	ניסתּר
ניסטאָרעס	ניסתּר
ניסטער	ניסתּר
ניסטער	ניסתּר
ניסיױנעס	נסיון
ניסים	נס
ניסימדיק	נסימדיק
ניסים־װעניפֿלאָעס	נסים־ונפֿלאָות
ניסכאַמעץ	נתחמץ װערן
ניסכײַעװ	נתחײבֿ װערן
ניסן	ניסן
ניסן	ניסן
ניסע־ניסים	נסי־נסים
ניספּאָעל	נתפּעל
ניספּאַרסעם	נתפּרסם װערן
ניסראַבע	נתרבה װערן
ניסראָפֿים	נישׂרף
ניסרעף	נישׂרף
ניִעף	ניאוף
ניפֿטאָרים	ניפֿטר
ניפֿטער	ניפֿטר
ניפֿטער	ניפֿטר װערן
ניפֿכאָרים	ניבֿחר
ניפֿכער	ניבֿחר
ניפֿלע	ניפֿלא
ניצאָװים	נצבֿים
ניצאָכן	נצחון
ניצױצעס	ניצוץ
ניצכױנעס	נצחון
ניצל	ניצול װערן
ניצמעך	ניצמח װערן
ניצעץ	ניצוץ
ניצראָכים	ניצרך
ניצרעך	ניצרך
ניקעד	ניקוד
ניקער	ניכּר
נירדאָפֿים	נירדף
נירדעף	נירדף
נישטאַנע	נשתּנה װערן
נישטױמעם	נשתּומם װערן
נישמאָסע בעגינזע־מערױמים	נשמתו בגנזי־מרומים
נישער	נישאר
נישקאָשע	נישקשה
נעגאָיִם	נגע
נעגאָיִם	נגעים
נעגידים	נגיד
נעגידיש	נגידיש
נעגידע	נגידה
נעגידעס	נגידות
נעגידעס	נגידית
נעגידעסטע	נגידיתטע
נעגײע	נוגע —> נוגע זײַן
נעגײע־באַדאָװער	נוגע־בדבֿר
נעגײע־בעקאָװעד	נוגע־בכּבֿוד —> נוגע־בכּבֿוד זײַן
נעגינע	נגינה
נעגישעס	נגישות
נעגע	נגע
נעגעװ	נגבֿ
נעגע(נע)ן	נגע(נע)ן
נעגע־צאָראַאַס	נגע־צרעת
נעדאָװע	נדבֿה
נעדאַן	נדן
נעדאָרים	נדר
נעדאָרים	נדרים
נעדוניע	נדוניא
נעדיװים	נדיבֿ
נעהאַר־די־נור	נהר־די־נור
נעהענע	נהנה —> נהנה זײַן
נעהענע־מיגיִע־קאַפּע	נהנה־מיגיע־כּפּו
נעװאָלע	נבֿלה
נעװוּכאַדנעצער	נבֿוכדנ(א)צר
נעװוּע	נבֿואה
נעװײלע	נבֿלה
נעװיִיִם	נבֿיא
נעװיִיִם	נבֿיאים
נעװיִיִם־אוקסוּװים	נבֿיאים־וכּתובֿים
נעװיִיִם־אַכרױנים	נבֿיאים־אַחרונים
נעװיִיִם־רישױנים	נבֿיאים־ראשונים
נעװײרע	עבֿירה
נעװיִיִש	נבֿיאיש
נעװיִע	נבֿיאה
נעװיִעטע	נבֿיאהטע
נעװיִעס	נבֿיאות
נעזיפֿע	נזיפֿה
נעזיקן	נזיקין
נעזירים	נזיר
נעזירעס	נזירות
נעטילעס־יעדאַיִם	נטילת־ידים
נעטיִע	נטיה
נעיִמעסדיק	נעימותדיק
נעכאָמע	נחמה
נעכאַמע	נחמה
נעכאָמע	נחמה
נעכאָס־דאַרגע	נחות־דרגא
נעכאָסים	נכסים
נעכאָשים	נחש
נעכבע־על־האַקײלים	נחבא־אל־הכּלים
נעכעמיע	נחמיה
נעלאָמים	נעלם
נעלם	נעלם
נעלם	נעלם װערן
נעמאָנים	נאמן
נעמאָנע	נאמנה
נעמאָנעס	נאמנות
נעמען	נאמן
נעמענטע	נאמנטע
נענאַטקע	ננתּקה
נענעש	נענש װערן
נעס	נס
נעסאַנע־טױקעף	נתנה־תּוקף
נעס־בעטאָך־נעס	נס־בתּוך־נס
נעס גאָד(ױ)ל הױאָ שאָם	נס גדול היה שם
נעסיִיִם	נשׂיא
נעסײע	נוסע
נעסינע	נתינה
נעסיִע	נסיעה
נעס־מין־האַשאָמאַיִם	נס־מן־השמים
נעסעך	נסך
נעפֿאַשעס	נפֿש
נעפֿאָשעס	נפֿש
נעפֿיכע	נפֿיחה
נעפֿעש	נפֿש
נעפֿעש־אַכעס	נפֿש־אַחת
נעצעך	נצח
נעצעך־ײִסראָעל	נצח־ישׂראל
נעצער	נעצר
נעקאָװים	נקבֿים
נעקאָװים־גדױלים	נקבֿים־גדולים
נעקאָװים־קטאַנים	נקבֿים־קטנים
נעקאָמע	נקמה
נעקודים־אוּװרודים	נקודים־ובֿרודים
נעקודע	נקודה
נעקײװע	נקבֿה
נעקיִעס	נקיות
נעקי־קאַפּאַיִם	נקי־כּפּים
נעקי־קאַפּאַיִמניק	נקי־כּפּימניק
נערעג	נהרג װערן
נערעג־אַל־פּאָכעס־מישאָװע־פּרוטע	נהרג־על־פּחות־משװה־פּרוטה
נערעגן	נהרגן
נעשאָמע	נשמה
נעשאָמע	נשמה־ליכט
נעשאָמע־יעסײרע	נשמה־יתירה

סאַגענאָער	סגי־נהור
סאַגענאָערטע	סגי־נהורטע
סאָד	סוד
סאַדיע	סעדיה
סאַדיע (האַ)גאָען	סעדיה (ה)גאון
סאָדע־סױדעס	סודי־סודות
סאַדערן	סדרן
סאַװלאָנים	סבֿלן
סאַװלאָנעס	סבֿלנות
סאַװלען	סבֿלן
סאַװלענטע	סבֿלנטע
סאָװע	סבֿא
סאָטן	שׂטן
סאָטן־האַמאַשכעס	שׂטן־המשחית
סאָטן־האַמעקאַטרעג	שׂטן־המקטרג
סאָטן־מעקאַטרעג	שׂטן־מקטרג
סאָיִף	סעיף
סאַך	סך
סאַכאַקל	סך־הכּל
סאַכאַקל	סך־הכּל
סאַך־האַקױלעל	סך־הכּולל
סאָכנוט	סוכנותּ
סאָכרים	סוחר
סאָכריש	סוחריש
סאָכרערײַ	סוחרערײַ
סאָלקאָ דײטאָך	סלקא דעתּך
סאַם	ס״ם
סאַם	סם
סאַם־אַמאָװעס	סם־המװת
סאַמאָעל	סמאל
סאַמבאַטיען	סמבטיון
סאַם־האַמאָװעס	סם־המװת
סאָמײעך־בעכעלקע	שׂמח־בחלקו
סאַמעך	ס
סאַמעך	סמך
סאַמעך־מעם	ס״ם
סאַמעך־מעם	סמך־מם
סאַמען	סמען
סאַנדאַלפֿן	סנדלפֿון
סאַנדעק	סנדק
סאַנדעקאָעס	סנדקאָות
סאַנײגער	סניגור
סאָנים	שׂונא
סאַנסינע	סיני סנסיני סמנגלוף
סאַנסענױ	סנױ סנסנױ סמנגלוף
סאַנעדרין	סנהדרין
סאַנעדרין־גדױלע	סנהדרין־גדולה
סאַנעדרין־קטאַנע	סנהדרין־קטנה
סאָסן־װעסימכע	שׂשׂון־ושׂימחה
סאָער־לאַזאָזל	שׂעיר־לעזאָזל
סאָף	סוף
סאָף	סוף־
סאָף	תּװ: תװ
סאָף־קאָל־האַדױרעס	סוף־כּל־הדורות
סאָפֿעק	ספֿק
סאָפֿעקן	ספֿקן
סאָפֿקל־סאָף	סוף־כּל־סוף
סאָפֿרים	סופֿר
סאָפֿריש	סופֿריש
סאָפֿרעס	סופֿרות
סאַפֿרע־ראַבע	ספֿרא־רבה
סאַקאָנע	סכּנה
סאַקאָנעס	סכּנות
סאַקאָנעס־נעפֿאָשעס	סכּנות־נפֿשות
סאַקאָנעס־נעפֿאָשעס	סכּנות־נפֿשות
סאַקן	סכּין
סאַר	שׂר
סאַר־האַמאַלכעס	שׂר־המלכות
סאַר־האַמאַשקים	שׂר־המשקים
סאַרטן	מזל סרטן
סאַרטן	סרטן
סאָרים	שׂר
סאַרכאָנים	סרחן
סאַרכן	סרחן
סאַרכע(נע)ן	סרחע(נע)ן
סאַרסאָרים	סרסור
סאַרסער	סרסור
סאַרסערן	סרסורן
סאָרע	שׂרה
סאָרע באַס־טױװים	שׂרה בת־טובֿים
סאָרעד	שׂריד
סאָרעד־אופּאָלעט	שׂריד־ופּליט
סאָרע־האַמאַלכעס	שׂר־המלכות
סאָרעס	סריס
סאָרעף	שׂרף
סאַרפֿע(נע)ן	שׂרפֿע(נע)ן
סגאַן־לעװיִע	סג״ל: סגן־לױה
סדאָם	סדום
סדאָם	סדום־בעטל
סדאָם־װאַאַמױרע	סדום־ועמורה
סדאָם־מישפּעט	סדום־מישפּט
סדאָרים	סדר
סוג	סוג
סוגיע	סוגיא
סודע	סעודה
סודע־האַמאַפֿסעקעס	סעודה־המפֿסקת
סודעס־האַװראָע	סעודת־הבֿראה
סודעס־מיצװע	סעודת־מיצװה
סודעס־פּורים	סעודת־פּורים
סװאַרבע	עשׂרים־ואַרבע
סװאָרע	סבֿרא / סבֿרה
סװיװע	סבֿיבֿה
סױגערן	סוגרן
סױדען	סודען —> סודען זיך
סױדעס	סוד
סױדעסדיק	סודותדיק
סױדעס־האַטױרע	סודות־התּורה
סױװל	סובֿל —> סובֿל זײַן
סױטע	סוטה
סױכער	סוחר
סױכערטע	סוחרטע
סױלעס	סולת
סױמעך	סומך —> סומך זײַן —> זײַן זיך
סױמעך־נאָפֿלים	סומך־נופֿלים
סױנע	שׂונא
סױנע־בעצע	שׂונא־בצע
סױנעטע	שׂונאטע
סױנע־ײִסראָעל	שׂונא־ישׂראל
סױנע־ציִען	שׂונא־ציון
סױסער	סותר —> סותר זײַן
סױפֿער	סופֿר
סױפֿער־מאָהער	סופֿר־מהיר
סױפֿער־סטאַם	סופֿר־סתּ״ם
סוס	סוס
סוקע	סוכּה
סוקע	סוכּה־שער
סוקעס	סוכּות
סטאַם	סתּ״ם
סטאַם	סתּם
סטימעס־האַגױלעל	סתּימת־הגולל
סטירע	סתּירה
סיִאַטע־דעשמײַע	סיעתּא־דשמעיא
סיבע	סיבה
סיגופֿים	סיגוף
סיגנען	סיגנון
סיגעף	סיגוף
סידורים	סידור
סידער	סידור
סידער־ק(י)דושן	סידור־קידושין
סידרע־ברײשעס	סדרי־בראשית
סיװן	סיװן
סיטרע־אַכרע	סיטרא־אַחרא
סיטרע־בישע	סיטרא־בישא
סיטרע־דיסמאָלע	סיטרא־דשׂמאָלא
סיטרע־מעסאָװוּסע	סיטרא־מסאָבֿותא
סײדער	סדר
סײדער־אױלעם	סדר־עולם
סײדער־האָױלעם	סדר־העולם
סײדער־האַיאָם	סדר־היום
סײדערן	סדרן
סײכל	שׂכל
סײכל־האַיאָשער	שׂכל־הישר
סײפֿער	ספֿר
סײפֿער	ספֿר־פּראַלניק
סײפֿער־האַזיכרױנעס	ספֿר־הזכרונות
סײפֿער־האַיאָשער	ספֿר־הישר
סײפֿער־האַכאַיִם	ספֿר־החײם
סײפֿער־האַכאָסעם	ספֿר־החתום
סײפֿער־האַספֿאָרים	ספֿר־הספֿרים
סײפֿער־טױרע	ספֿר־תּורה
סײפֿער־יעצירע	ספֿר־יצירה
סײפֿער־כױל	ספֿר־חול
סײפֿער־כקירע	ספֿר־חקירה
סײפֿער־ראַזיִ(ע)ל (האַמאַלעך)	ספֿר־רזיאל
סיכסוכים	סיכסוך
סיכסעך	סיכסוך
סיכע	שׂיחה
סיכעס־כולין	שׂיחת־חולין
סיכעס־נאָשים	שׂיחת־נשים
סילוקים	סילוק
סילעק	סילוק
סילעקן	סילוקן
סימאָנים	סימן
סימאָנים־מוּװאָקים	סימן־מובֿהק
סימאָנע־זאַכרעס	סימני־זכרות
סימאָנע־נאַאַרעס	סימני־נערות
סימכע	שׂימחה
סימכע	שׂימחה
סימכע־װעסאָסן	שׂימחה־ושׂשׂון
סימכעס־בײס־האַשאָײװע	שׂימחת־בית־השואבֿה
סימכעס־טױרע	שׂימחת־תּורה
סימכעס־מיצװע	שׂימחת־מיצװה
סימכע־שעל־מיצװע	שׂימחה־של־מיצװה
סימען	סימן
סימען־דאַלעס	סימן־דלות
סימענטאָװ	סימן־טובֿ
סימען־מוּװעק	סימן־מובֿהק
סין	שׂ
סין	שׂין
סינײַ	סיני
סינײַדיק	סינידיק
סינײַ־ניגונים	סיני־ניגון
סינײַ־ניגן	סיני־ניגון
סינע	שׂינאה
סינע סאַנסינע סעמאַנגלאָף	סיני סנסיני סמנגלוף
סינעס־כינעם	שׂינאת־חינם
סינעס־ציִען	שׂינאת־ציון
סיסרע־טױרע	סיתרי־תּורה
סיִעם	סיום
סיפּורים	סיפּור
סיפּורע־מײַסעס	סיפּורי־מעשׂיות
סיפּורע־ניפֿלאָעס	סיפּור־ניפֿלא
סיפּער	סיפּור
סיפּער־האַמײַסע	סיפּור־המעשׂה
סיפּער־ניפֿלע	סיפּור־ניפֿלא
סיפֿרע־טױרע	ספֿר־תּורה
סיפֿרע־כױל	ספֿר־חול
סיפֿרע־כקירע	ספֿר־חקירה
סיר־האַבאָסער	סיר־הבשׂר
סירכע	סירכא
סכאַך	סכך
סכאַקל	סך־הכּל
סכאַקל	סך־הכּל
סכאַר	שׂכר
סכאַר־האַליכע	שׂכר־הליכה
סכאַר־װעױנעש	שׂכר־ועונש
סכאַר־טירכע	שׂכר־טירחה / ־טירחא
סכאָרים	זכר
סכאַריע	זכריה
סכאַר־לימעד	שׂכר־לימוד
סכאַר־מעלאָכע	שׂכר־מלאָכה
סכױר־בריס	זכור־ברית
סכױרע	סחורה
סכום	סכום
סכום־האַקױלעל	סכום־הכּולל
סכוס 	זכות
סכוס־אָװעס	זכות־אָבֿות
סכוס־אַצמע	זכות־עצמו
סכוס־האַקיִעם	זכות־הקיום
סכוסע יאָגן (אָלײנו)	זכותו יגן (עלינו)
סכוסעם יאָגן (אָלײנו)	זכותם יגן (עלינו)
סכיִע	זכיה
סכיר־יאָם	שׂכיר־יום
סכירעס	שׂכירות
סליכע	סליחה
סליכע־אומעכילע	סליחה־ומחילה
סליכענען	סליחהנען
סליכענער	סליחהנער
סמאַך	סמך
סמיכע	סמיכה
סמיכעס	סמיכות
סמיכעס־האַפּאַרשע	סמיכות־הפּרשה
סמיכעס־האַפּאַרשעס	סמיכות־הפּרשיות
סנע	סנה
סעגאַל	סג״ל
סעגינאָער	סגי־נהור
סעגינאָערדיק	סגי־נהורדיק
סעגינאָערטע	סגי־נהורטע
סעגל	סגול
סעדאָרים	סדר
סעדרע	סדרה
סעו־יעדײכעם	שׂאו־ידיכם
סעיִפֿים	סעיף
סעיִר	שׂעיר
סעכאַקל	סך־הכּל
סעכאַקל	סך־הכּל
סעלע־האַמאַכלױקעס	סלע־המחלוקת
סעמאַך	סמך
סעמאַנגלאָף	סיני סנסיני סמנגלוף
סעמאַנגלאָף	סנױ סנסנױ סמנגלוף
סעמעך	סמך
סענױ סאַנסענױ סעמאַנגלאָף	סנױ סנסנױ סמנגלוף
סעקאָנע	סכּנה
סעקאָנעס	סכּנות
סעקאָנעס־נעפֿאָשעס	סכּנות־נפֿשות
סעקאָנעס־נעפֿאָשעס	סכּנות־נפֿשות
ספֿאַרד	ספֿרד
ספֿאַרדי	ספֿרדי
ספֿאַרדיס	הבֿרה: הבֿרה־ספֿרדית
ספֿאַרדיש	ספֿרדיש
ספֿאָרים	ספֿר
ספֿאָרים־כיצױנים	ספֿרים־חיצונים
ספֿײקעס	ספֿק
ספֿײקעס	ספֿקות
ספֿירע	ספֿירה
ספֿירע	ספֿירה
ספֿירעס־האַנאָצרים	ספֿירת־הנוצרים
ספֿעק־ספֿײקע	ספֿק־ספֿקא
סקאָנים	זקן
סקאָנע	זקנה
סקײנים	זקן
סקײנע	זקנה
סקילע	סקילה
סראָכע	סרחה
סראָפֿים	שׂרף
סראָפֿים־װעאױפֿאַנים	שׂרפֿים־ואופֿנים
סראָריש	שׂרריש
סראָרע	שׂררה
סראָרע(ס)טע	שׂררה(ס)טע
סרידים	שׂריד
סרידע־פּלײטע	שׂרידי־פּליטה
סרײפֿע	שׂרפֿה
סריסים	סריס
סריסעס	סריסות

עגלע־אַרופֿע	עגלה־ערופֿה
עדױמי	אדומי
עדעם	אדום
עװיױנים	אבֿיון
עװיױניש	אבֿיוניש
עװיױנעס	אבֿיונות
עװיען	אבֿיון
עװיענטע	אבֿיונטע
עװן־בױכן	אבֿן־בוחן
עװן־האָעזער	אבֿן־העזר
עװנטאָװ	אבֿן־טובֿ
עװן־נעגעף	אבֿן־נגף
עװן־פּעקודע	חובֿות־הלבֿבֿות: רבנו בחײ אבן־פּקודה
עװעד	עבֿד
עװעד־קנאַאַני/ ־קנײַני	עבֿד־כּנעני
עזרע	עזרא
עזרע האַסױפֿער	עזרא הסופֿר
עזרעס־נאָשים	עזרת־נשים
עכאָד	אחד
עלאָ	אלא
עלאָזער	אלעזר
עלאָ מאַ 	אלא מה / מאַי
עלאָ מײַ	אלא מה / מאַי
עליאָהו	אליהו
עליאָהו האַנאָװי	אליהו הנבֿיא
עליאָקעם	אליקום
עליױנים	עליון
עלימײלעך	אלימלך
עליע	אליה
עליעהאַנאָװע	אליהו הנבֿיא
עליעזער	אליעזר
עליען	עליון
עליענאָװע	אליהו הנבֿיא
עלישע	אלישע
עלישע בען־אַװוּיע	אַחר: אלישע בן־אַבֿױה
עלכאָנען	אלחנן
עלע	אלא
עלעל	אלול
עלעלדיק	אלולדיק
עלע מאַ	אלא מה / אלא מאַי
עלע מײַ	אלא מה / אלא מאַי
עלעף	אלף
עלעף־אַלאָפֿים	אלף־אַלפֿים
עלעף־האַשישי	אלף־השישי
עלקאָנע	אלקנה
עמונע	אמונה
עמונע־שלײמע	אמונה־שלמה
עמעס	אמת
עמעס	אמת
עמעס־װעיאַצעװ	אמת־ױציבֿ
עמעס מעערעץ טיצמעך	ראָשי־תּיבֿות: אמת מארץ תּצמח
עמעסן	אמת : אין אמתן
עמער	אמור
ענקעס־מעסאַלדעכאָ	אנקת־מסלדיך
עסטער	אסתּר
עסטער האַמאַלקע	אסתּר המלכּה
עסטער־טאָנעס	אסתּר־תּענית
עסע	עשׂה
עסער־מאַקעס	עשׂר־מכּות
עסער־ספֿירעס	עשׂר־ספֿירות
עסרױגים	אתרוג
עסרים־װ(ע)אַרבע	עשׂרים־ואַרבע
עסרעג	אתרוג
עסרעגל	אתרוגל
עפֿראָיִם	אפֿרים
עפֿרױכים	אפֿרוח
עפֿרױעך	אפֿרוח
עפֿשער	אפֿשר
עצבע־עלאָקים	אצבע־אלוהים
עצבע־עלאָקים	אצבע־אלקים
עצבע־עלױהים	אצבע־אלוהים
עצעם	עצם
עצעם	עצם
עצעם	עצם־
ערװע	ערװה
ערלטע	ערלטע
ערעװ	ערבֿ
ערעװראַװ	ערבֿ־רבֿ
ערעװ־שאַבעס	ערבֿ־שבת
ערעך	ערך
ערעץ	ארץ
ערעץ־ײִסראָעל	ארץ־ישׂראל
ערעץ־ײִסראָעל	ארץ־ישׂראל־פֿעדעם
ערקאָעס	ערכּאָות
פּ
פּאָגעם־קײלע	פּגום־כּלי
פּאָזער	פּזר
פּאַזראָנים	פּזרן
פּאַזראָניש	פּזרניש
פּאַזראָנעס	פּזרנות
פּאַזרען	פּזרן
פּאַזרענטע	פּזרנטע
פּאַטעך	פּתּח
פּאָטער	פּטור
פּאָטער	פּטור װערן
פּאָטער בעלױ קלום	פּטור בלא כּלום
פּאַטערן	פּטרן
פּאַטערניש	פּטרניש
פּאַטעש	פּטיש
פּאַכדאָנים	פּחדן
פּאַכדאָניש	פּחדניש
פּאַכדאָנעס	פּחדנות
פּאַכדן	פּחדן
פּאַכדנטע	פּחדנטע
פּאַכעד	פּחד
פּאָכעס־מישאָװע־פּרוטע	פּחות־משװה־פּרוטה
פּאַלטיִעל	פּלטיאל
פּאָלעט	פּליט
פּאַלעציִען	פּועלי־ציון
פּאַמאַליע	פּמליא / פּמליה
פּאַמאַליע־שעל־מײַלע	פּמליא־של־מעלה
פּאַנו דערעך	פּנו דרך
פּאַנו מאָקעם	פּנו מקום
פּאָנעם	פּנים
פּאָנעם־כאַדאָשעס	פּנים־חדשות
פּאָנעם־כאַלאָשעס	פּנים־חלשות
פּאָנעם־על־פּאָנעם	פּנים־אל־פּנים
פּאַס־אַקום	פּת־עכּו״ם
פּאַס בעסאַלע	פּת בסלו
פּאָסל	פּסול
פּאַסלאָנעס	פּסלנות
פּאָסל־לעײדעס	פּסול־לעדות
פּאַסלען	פּסלען
פּאַסלעס	פּסלות
פּאַסעך	פּתח
פּאָסעק	פּסוק
פּאָסקים	פּוסק
פּאָסקים	פּוסקים
פּאָסקים־אַכרױנים	פּוסקים־אַחרונים
פּאָסקים־רישױנים	פּוסקים־ראשונים
פּאַסקע(נע)ן	פּסקע(נע)ן
פּאָסרים	פּותר
פּאָקרים	פּוקר
פּאַרדײסים	פּרדס
פּאַרדעס	פּרדס
פּאָרױכעס	פּרוכת
פּאָרכע־נישמאָסע	פּרחה־נשמתו װערן
פּאַרנאָסים	פּרנס
פּאַרנאָסע	פּרנסה
פּאַרנאָסע־בזוּיע	פּרנסה־בזױה
פּאַרנאָסע־בעצימצעם	פּרנסה־בצימצום
פּאַרנאָסע־בעשעפֿע	פּרנסה־בשפֿע
פּאַרנײסים	פּרנס
פּאַרנעס	פּרנס
פּאַרנעס־כױדעש	פּרנס־חודש
פּאַרנעס־כױדעשטע	פּרנס־חודשטע
פּאַרנעסע־כױדעש	פּרנס־חודש
פּאָרע	פּרה
פּאַרע	פּרעה
פּאָרע־אַדומע	פּרה־אַדומה
פּאָרעס	פּרס
פּאָרעס־האַבאָשן	פּרות־הבשן
פּאָרעץ	פּרוץ
פּאָרעץ	פּריץ
פּאָרעש	פּרוש
פּאַרצופֿים	פּרצוף
פּאָרצע־געדער	פּורץ־גדר
פּאַרצעף	פּרצוף
פּאַרצעף־פּאָנעם	פּרצוף־פּנים
פּאַרשע	פּרשה
פּאַרשעס	פּרשה
פּאַשטאָנים	פּשטן
פּאַשטן	פּשטן
פּאָשטע־יאַד	פּושט־יד
פּאַשטעס	פּשטות
פּאָשע־בעלױקײ־ײִסראָעל	פּושע־באלוקי־ישׂראל
פּאָשעט	פּשוט
פּאָשעט־קעמאַשמאָע	פּשוט־כּמשמעו
פּאָשע־ײִסראָעל	פּושע־ישׂראל
פּאַשראָנים	פּשרן
פּאַשרען	פּשרן
פּגאָיִם	פּגע
פּגאָיִם־ראָיִם	פּגע־רע
פּגאַם	פּגם
פּגאָמים	פּגם
פּגאָרים	פּגר
פּגימע	פּגימה
פּגיריש	פּגיריש
פּגירע	פּגירה
פּױאַלים	פּועל
פּױאַלע־ציִען	פּועלי־ציון
פּױגײע	פּוגע —> פּוגע זײַן
פּױגײע־בעקאָװעד	פּוגע־בכּבֿוד —> פּוגע־בכּבֿוד זײַן
פּױגעם	פּוגם —> פּוגם זײַן
פּױטיקע	אַפּותּיקא / אַפּותּיקי
פּױטיקע	פּותּיקא / פּותּיקי
פּױ־לין	פּה־לין
פּױלן	פּועלן
פּױ־ניטמען	פּה־ניטמן
פּױ־ניקבער	פּה־ניקבר
פּױסעק	פּוסק
פּױסעק־אַכרען	פּוסק־אַחרון
פּױסער	פּותר
פּױסער	פּותר —> פּותר זײַן
פּױסער־כאָלעם	פּותר־חלום —> פּותר־חלום זײַן
פּױעל	פּועל
פּױעל־יױצע	פּועל־יוצא
פּױעל־יױצע	פּועל־יוצא —> פּועל־יוצא זײַן
פּױעלן	פּועלן
פּױעל־צעדעק	פּועל־צדק
פּױקעד־אַקאָרעס	פּוקד־עקרות —> פּוקד־עקרות זײַן
פּױקער	פּוקר
פּױרעץ־געדער	פּורץ־גדר
פּױרעץ־געדער	פּורץ־גדר —> פּורץ־גדר זײַן
פּױרעש־בישמױ	פּורש־בשמו —> פּורש־בשמו זײַן
פּױרעש־מין־האַציבער	פּורש־מן־הציבור
פּױשעט־יאַד	פּושט־יד
פּולע	פּעולה
פּוק	פּוק
פּוראָניעס	פּורעניות
פּורים	פּורים
פּורים־קאָטן	פּורים־קטן
פּורים־שפּיל	פּורים־שפּיל
פּורים־שפּילער	פּורים־שפּילער
פּורע	פּורה
פּטירע	פּטירה
פּי	פּי
פּיגל	פּיגול
פּידיױנעס	פּדיון
פּידיען	פּדיון
פּידיען־האַבען	פּדיון־הבן
פּידיען־האַנעפֿעש	פּדיון־הנפֿש
פּידיען־שװוּיִם	פּדיון־שבֿוײם
פּיװ־האַקאָדעש	פּיו־הקדוש
פּיִוטים	פּיוט
פּיזמױנים	פּיזמון
פּיזמױנעס	פּיזמון
פּיזמען	פּיזמון
פּיטעם	פּיטום
פּיטעם־האַקטױרעס	פּיטום־הקטורת
פּײ	פּ
פּײ	פּא
פּײגער	פּגר
פּײגערן	פּגרן
פּײַטאָנים	פּײַטן
פּײַטן	פּײַטן
פּײלע	פּלא
פּײסעך	פּסח
פּײסעכדיק	פּסחדיק
פּײסעך־שײנע	פּסח־שני
פּײע	פּאה
פּײַעט	פּיוט
פּײרע	פּרי
פּײרעד־האַלװאָװעס	פּירוד־הלבֿבֿות
פּײרעס	פּרי
פּײרעק	פּרק
פּײרעש	פּירוש
פּײרעש־האַמילעס	פּירוש־המילות
פּילאַקשים	פּלגש
פּילוסוף	פּילוסוף
פּילעגעש	פּלגש
פּילע־פּלאָיִם	פּילאי־פּלאָים
פּילפּל	פּילפּול
פּילפּלען	פּילפּולען —> פּילפּולען זיך
פּינכעס	פּינחס
פּינכעס	פּנחס
פּינכעס בען־עלאָזער בען־אַרן האַקױען	פּינחס בן־אלעזר בן־אַהרן הכּהן
פּינקאָסים	פּינקס
פּינקײסים	פּינקס
פּינקעס	פּינקס
פּיסכן־פּע	פּיתחון־פּה
פּיסעם־װעראַמסעס	פּיתום־ורעמסס
פּיסרױנים	פּיתרון
פּיסרען	פּיתרון
פּיִעט	פּיוט
פּיקאָדן	פּקדון
פּיקדױנעס	פּקדון
פּיקועך־נעפֿעש	פּיקוח־נפֿש
פּיקײעך	פּיקח
פּיקײעכטע	פּיקחטע
פּיקכים	פּיקח
פּיקכעס	פּיקחות
פּיקכעס	פּיקחית
פּיקעך	פּיקח
פּיקעכטע	פּיקחטע
פּירסעם	פּירסום
פּירקע־אָװעס	פּירקי־אָבֿות
פּכאָדים	פּחד
פּכאָדימדיק	פּחדימדיק
פּכאָר	בכור
פּכאָרטע	בכורטע
פּכױרים	בכור
פּכױרע	בכורה
פּכױרעס	בכורות
פּכינע	בחינה
פּכיסעס־האַקאָװעד	פּחיתות־הכּבֿוד
פּכיִע	בכיה
פּכיִע־לעדױרעס	בכיה־לדורות
פּכיר	בחיר
פּכירע	בחירה
פּלאָיִם	פּלא
פּלױנע	פּלוני
פּלױנע־אַלמױנע	פּלוני־אַלמוני
פּלױנע־בען־פּלױנע	פּלוני־בן־פּלוני
פּלױנעס(־באַס־פּלױנעס)	פּלונית(־בת־פּלונית)
פּלױנעסטע	פּלוניתטע
פּלוקטע	פּלוגתּא
פּלײטים	פּליט
פּלײטע	פּליטה
פּליִע	פּליאה
פּליִעדיק	פּליאהדיק
פּלישטי	פּלישתּי
פּלישטים	פּלישתּים
פּנײ	פּני
פּנײ־האָיִר	פּני־העיר
פּנימיעס	פּנימיות
פּנינע	פּנינה
פּניִע	פּניה
פּסאָיִם	פּתי
פּסאָכים	פּסחים
פּסאַכיע	פּתחיה
פּסאָמים	בשׂמים
פּסאָמים־ביקס	בשׂמים־ביקס
פּסאַק	פּסק
פּסאַק־געלט	פּסק־געלט
פּסאַקדין	פּסק־דין
פּסאָקים	פּסק
פּסױלעס	פּסולת
פּסול	פּסול
פּסולים	בתולים
פּסולע	בתולה
פּסולע	מזל בתולה
פּסוקים	פּסוק
פּסורע	בשׂורה
פּסורע־טױװע	בשׂורה־טובֿה
פּסורע־ראָע	בשׂורה־רעה
פּסיכע(נע)ן	פּתיחה(נע)ן
פּעאָמים	פּעמים
פּעגיריש	פּגיריש
פּעגע	פּגע
פּעגע־ראַ	פּגע־רע
פּעלע	פּלא
פּענעמל	פּנים: דימינוטיװ פּנימל
פּענעמל	פּנימל
פּענעמער	פּנים
פּעסי	פּתי
פּעסי־יאַאַמען	פּתי־יאמין
פּע־עכעד	פּה־אחד
פּע־על־פּע	פּה־אל־פּה
פּער	פּאר
פּערושים	פּירוש
פּערע	פּרא
פּערעאָדעם	פּרא־אָדם
פּערעץ	פּרץ
פּקודע	פּקודי
פּראַט	פּרט
פּראַט	פּרט־נאָמען
פּראָטים	פּרט
פּראָיִם	פּרא
פּראַס	פּרת
פּראַקדען	פּרקדן
פּראָקים	פּרק
פּרוטע	פּרוטה
פּרױזדער	פּרוזדור
פּרוצים	פּרוץ
פּרוצע	פּרוצה
פּרושים	פּרוש
פּרושים	פּרושים
פּרי־אײץ־האָדער	פּרי־עץ־הדר
פּריִע	פּריעה
פּריִע־אורװיִע	פּריה־ורבֿיה
פּריצטע	פּריצטע
פּריצים	פּריץ
פּריציש	פּריציש
פּריצע	פּריצה
פּריצעדיק	פּריצהדיק
פּריצעס	פּריצות
פּשאַט	פּשט
פּשאָטים	פּשט
פּשאָיִם	פּשעים
פּשאָרע	פּשרה
פּשוטע־קעמאַשמאָע	פּשוטו־כּמשמעו
פּשעטל	פּשטל
פּשעטלדיק	פּשטלדיק
פּשעטלען	פּשטלען —> פּשטלען זיך
פֿ
פֿאָצן	פֿצון
פֿאַראַקשענען	פֿאַרעקשנען —> פֿאַרעקשנען זיך
פֿאַרדװײקעט	פֿאַרדבֿקעט
פֿאַרדײַגעט	פֿאַרדאגהט
פֿאַרטאַכלעװען	פֿאַרתּכלעװען
פֿאַריאָסעמט	פֿאַריתומט
פֿאַריפּעשט	פֿאַרעיפּושט
פֿאַרכאַסמע(נע)ן	פֿאַרחתמע(נע)ן
פֿאַרכױװען	פֿאַרחובֿען —> פֿאַרחובֿען זיך
פֿאַרכױשעכט	פֿאַרחושכט
פֿאַרכושט	פֿאַרחושט
פֿאַרמאָרעשכױרעט	פֿאַרמרה־שחורהט
פֿאַרמאַשקענען	פֿאַרמשכּ(ו)נען
פֿאַרמאַשקענען	פֿאַרמשכּ(ו)נען —> פֿאַרמשכּ(ו)נען זיך
פֿאַרמױעכן	פֿאַרמוחן —> פֿאַרמוחן זיך
פֿאַרמױשעװט	פֿאַרמושבֿט
פֿאַרמישפּעטן	פֿאַרמישפּטן
פֿאַרסאַרפֿען	פֿאַרשׂרפֿען
פֿאַרפּײסעך	פֿאַרפּסח
פֿאַרקױסעט	פֿאַרכּוסעט
פֿאַרקישעפֿט	פֿאַרכּישופֿט
פֿאַרקנאַסן	פֿאַרקנסן
פֿאַרשיקערן	פֿאַרשיכּורן
פֿאַרשעמט	פֿאַרשמט
פֿײ	פֿ
פֿײ	פֿא

צאַד	צד
צאַד־האַשאָװע	צד־השװה
צאַד־האַשױנע	צד־השונה
צאַדי	צדי
צאַדיקים	צדיק
צאַדיקים־טמימים	צדיק־תּמים
צאַדיקע־האַדאָר	צדיק־הדור
צאַדעק	צ
צאָדעק	צדוק
צאַדעק	צדיק
צאַדעק	צדיק
צאַדעק־האַדאָר	צדיק־הדור
צאַדעק־טאָמעם	צדיק־תּמים
צאָדקאָ מימעני	צדקה ממני
צאַד־שעקענעגדע	צד־שכּנגדו
צאַד־שעקענעגעד	צד־שכּנגד
צאָהאָלע	צהלה
צאָהאַלע־װעסאָמײכע	צהלה־ושׂמחה
צאַװ	צו
צאַװאָע	צואה
צאַװאָע	צװאה
צאַלמאָװעס	צלמװת
צאַלעל	צלאל / צלל
צאָם	צום
צאָמגעדאַליע	צום־גדליה
צאַנע־דימלע־סיפֿרע	צנא־דמלא־סיפֿרא
צאָן־קאָדאָשים	צאָן־קדשים
צאָפֿן	צפֿון
צאָץ	צץ
צאַר	צער
צאָראַאַס	צרעת
צאַר־אַיִן	צר־עין
צאַר־באַלעכאַיִם	צער־בעלי־חײם
צאַר־גידל־באָנים	צער־גידול־בנים
צאָרכע־ציבער	צרכי־ציבור
צאָרכע־ראַבים	צרכי־רבים
צאָרע	צרה
צאָרעדיק	צרהדיק
צאָרעס־האַקלאַל	צרות־הכּלל
צאָרעס־ײִסראָעל	צרות־ישׂראל
צאָרעס־צרורעס	צרות־צרורות
צאָרעס־ראַבים	צרת־רבים
צאָרעס־ראַבים כאָצי־נעכאָמע	צרת־רבים חצי־נחמה
צאָרערים	צורר
צאָרע־שעלױ־סאָװױ	צרה־שלא־תבֿוא
צדאָדים	צד
צדאָקע	צדקה
צדאָקע	צדקה־פּושקע
צדאָקע־גדױלע	צדקה־גדולה
צדאָקע טאַצל מימאָװעס	צדקה תּציל ממװת
צדוקים	צדוקים
צװוּאַטשען	צבֿועטשען
צװוּאַטשקע	צבֿועטשקע
צװוּאַק	צבֿועק
צװוּיאַטשען	צבֿױאַטשען
צװוּיאַטשקע	צבֿױאַטשקע
צװוּיאַק	צבֿױאַק
צװי	צבֿי
צװיִעס	צבֿיעות
צױמײעך	צומח
צױע	צואה
צױער	צוהר
צױרעך	צורך
צױרער	צורר
צױרער־האַיעהודים	צורר־היהודים
צױרער־ײִסראָעל	צורר־ישׂראל
צופּאַסקע(נע)ן	צופּסקע(נע)ן
צורװע־דעראַבאָנען	צורבֿא־דרבנן
צורע	צורה
צורעס־אַלעף	צורת־אַלף
צורעס־אָס	צורת־אות
צורעס־מאַטבײע	צורת־מטבע
ציבער	ציבור
צידעק־האַדין	צידוק־הדין
ציװיע	צבֿיה
ציִױני	ציוני
ציִױנעס	ציונות
ציִונים	ציון
ציטקאָניעס	צדקנית
ציטקאָנעס	צדקנית
ציטקעס	צידקות
צײדע־לאַדערעך	צדה־לדרך
צײלעם	צלם
צײלעמניצע	צלמניצע
צײלעמניק	צלמניק
צײלעם־עלױהים	צלם־אלוהים
צײלעם־עלױקים	צלם־אלוקים
צײלעמען	צלמען —> צלמען זיך
צײלעם־קאָפּ	צלם־קאָפּ
צײס־האַקױכאָװים	צאת־הכּוכבֿים
צײסכע(ם)־לעשאָלעם	צאתכ(ם)־לשלום
צײרופֿים	צירוף
צײרופֿע־אױסיעס	צירופֿי־אותיות
צײרע	צירי
צײרעף	צירוף
צימוקים	צימוקים
צימצעם	צימצום
צינױרעס	צינור
צינער	צינור
ציִען	ציון
ציִען	ציון
ציִעניזם	ציוניזם
ציִעניסט	ציוניסט
ציפּױרע	צפּורה
ציצע	ציצה
ציצעס	ציצה
ציצע־קאַנפֿעס	ציצה־כּנפֿות
צלאָמים	צלם
צמאָכים	צמחים
צנוע	צנועה
צניִעס	צניעות
צעדאַמען	צעדמען
צעדײקעס	צדקת
צעדײקעסטע	צדקתטע
צעדעק	צדק
צעכושט	צעחושט
צעלאָכעס	להכעיס: אױף צו להכעיס
צעלאָכעס	צולהכעיס
צעלאָכעסדיק	צולהכעיסדיק
צעלאָכעסניצע	צולהכעיסניצע
צעלאָכעסניק	צולהכעיסניק
צעמאַזעקן	צעמזיקן
צעמעך	צמח
צענערענע	צאינה־וראינה
צפֿאַניע	צפֿניה
צפֿאַס	צפֿת
צפֿאַרדײע	דצ״ך עד״ש באח״ב: צפֿרדע
צראָכים	צורך

קאָאָל	קהל
קאַאַלאָס	כּעלות
קאַאַלאָס־האַבױקער	כּעלות־הבוקר
קאַאַלאָס־האַשאַכער	כּעלות־השחר
קאָאָליש	קהליש
קאָאָלן	קהלן —> קהלן זיך
קאָאָלס	קהלס־מאַן
קאָאָלש	קהלש
קאַאַס	כּעס
קאַאַס־װעכײמע	כּעס־וחמה
קאַאַרע	קערה
קאַבאָלע	קבלה
קאַבאָלע־איִוניס	קבלה־עיונית
קאַבאָלע־מײַסיס	קבלה־מעשׂית
קאַבאָלעס־פּאָנעם	קבלת־פּנים
קאַבאָלעס־קיניען	קבלת־קנין
קאַבאָלעס־שאַבעס	קבלת־שבת
קאַבלו דאַטי	קבלו דעתּי
קאַבצאָנים	קבצן
קאַבצאָנעס	קבצנות
קאַבצן	קבצן
קאַבצנטע	קבצנטע
קאַבצענען	קבצנען
קאַבראָנים	קברן
קאַברען	קברן
קאַדאָכעס	קדחת
קאַדאָכעס־רעװיִעס	קדחת־רבֿיעית
קאַדאָכעס־שלישעס	קדחת־שלישית
קאָדאָשים	קדשים
קאָדאָשים־קאַלים	קדשים־קלים
קאַדײשים	קדיש
קאַדמױנים	קדמון
קאַדמע־װעאַזלע	קדמא־ואזלא
קאַדמען	קדמון
קאַדער־האָאָרעץ	כּדור־האָרץ
קאָדעש	קדוש
קאַדעש	קדיש
קאָדעש־װעטאָהער	קדוש־וטהור
קאַדעשניק	קדישניק
קאָדשים	קדשים
קאָדשים־קאַלים	קדשים־קלים
קאָדשע־קאָדאָשים	קדשי־קדשים
קאָהײנע־װעכאָהײנע	כּהנא־וכהנא
קאַװאָנע	כּװנה
קאַװ־האַיאָשער	קבֿ־הישר
קאַװיאָכל	כּבֿיכול
קאָװעד	כּבֿוד
קאַזװאָנים	כּזבֿן
קאַזװן	כּזבֿן
קאַזװנטע	כּזבֿנטע
קאָזעװ	כּזבֿ
קאָזעװ־װעשעקער	כּזבֿ־ושקר
קאַט	כּתּ
קאַטאָװעס	כּתּבֿות
קאַט־דילײ	כּתּ־דיליה
קאָטױנטי	קטנתּי
קאַטײגער	קטיגור
קאַטלאָנים	קטלן
קאַטלאַניעס	קטלנית
קאַטלאַנעס	קטלנית
קאַט־לײצאָנים	כּתּ־ליצנים
קאַטלען	קטלן
קאַטלע־קאַניע	קטלא־קניא
קאָטן	קטן
קאַטנעס־דעמױכן	קטנות־דמוחין
קאָיאַנים	כּהן
קאָיאַנים־גדױלים	כּהן־גדול
קאַיאָר	כּאור
קאַיאָר	כּיאור
קאַיִן	קין
קאַך־האַװע	כּך־הװה
קאַך־הױע	כּך־היה
קאַך־װעקאַך	כּך־וכּך
קאָל	כּל־
קאָל	קול
קאַל	קל
קאָל־אַװױדעזאָרעס־שעבאָױלעם	כּל־עבֿודות־זרות־שבעולם
קאָל אױרעװ לעמינײהע	כּל עורבֿ למינהו
קאָלאַמינים	כּל־המינים
קאָלבױ	כּל־בו
קאָלבױניצע	כּל־בוניצע
קאָלבױניק	כּל־בוניק
קאָל־דאָװער־אָסער	כּל־דבֿר־אָסור
קאָל־דװאַר־שױרעש	כּל־דבֿר־שורש
קאָל־דיכפֿין	כּל־דכפֿין
קאָל־האַ…	כּל־ה…
קאָל־האַטױעװעס	כּל־התּועבֿות
קאָל־האַטױרע	קול־התּורה
קאָל־האַטױרע־קולע	כּל־התּורה־כּולה
קאָל־האַטײַמים	כּל־הטעמים
קאָל־האָן־דעאַלמע	כּל־הון־דעלמא
קאָל־האַפּאַסלאָנעס	כּל־הפּסלנות
קאָל־האַפּאַסלאָנעס־שעבאָױלעם	כּל־הפּסלנות־שבעולם
קאָל האַקױדעם זאָכע	כּל הקודם זכה
קאָל־הױן־דעאַלמע	כּל־הון־דעלמא
קאַלװעכױמער	קל־וחומר
קאָלװעלאָך	כּל־ולך
קאָלװעלאָכטע	כּל־ולכטע
קאָלו קאָל האַקיצן	כּלו כּל הקיצין
קאָלזמאַן	כּל־זמן
קאָלזמאַן שעהאַנ(ע)שאָמע בעקירבי	כּל־זמן שהנשמה בקירבי
קאָל־טוּװ	כּל־טובֿ
קאָל־טפֿוצעס־ײִסראָעל	כּל־תּפֿוצות־ישׂראל
קאָל־יאָכל	כּל־יכול
קאָל־יאָמײַ	כּל־ימי
קאָל־יאָמעװ	כּל־ימיו
קאָל־ײִסראָעל	כּל־ישׂראל
קאָל ײִסראָעל כאַװײרים	כּל ישׂראל חבֿרים
קאָל־יעמײהעם	כּל־ימיהם
קאָל־כאַמאָסאָ	כּל־חמתו
קאָל־כאַמאָסאָם	כּל־חמתם
קאָל־כאַמאָסע	כּל־חמתה
קאָל מאַמינים שעהו	כּל מאמינים שהוא
קאָל־מינע	כּל־מיני
קאָל־מעװאַסער	קול־מבֿשׂר
קאַלמען	קלמן
קאָלנידרע	כּל־נדרי
קאָל־נעגינע	קול־נגינה
קאַלע	כּלה
קאַלע	כּלה־מױד
קאָלעלים	כּולל
קאַלעס	קלות
קאַלעס־דאַאַס	קלות־דעת
קאַלעס־ראָש	קלות־ראָש
קאָלערלײ	כּלערלײ
קאַלפּע	קלפּי
קאַלפֿע	קלפֿי
קאָלקױרע	קול־קורא
קאָל־שױרעש־דאָװער	כּל־שורש־דבֿר
קאַל־שעבעקאַלים	קל־שבקלים
קאָלשקײן	כּל־שכּן
קאַמײע	קמיע
קאַמע	כּמה
קאַמע־װעקאַמע	כּמה־וכּמה
קאַמעס	כּמות
קאָמעץ	קמץ
קאַמצאָנים	קמצן
קאַמצאָנעס	קמצנות
קאַמצן	קמצן
קאַמצנטע	קמצנטע
קאָמרים	כּומר
קאַן	ק״ן
קאַנאָיִ	קנאָי
קאַנאַל	כּנ״ל
קאַנאָעס	קנאָות
קאַן בױכן	כּאַן בוכין
קאַנסע(נע)ן	קנסע(נע)ן
קאָנע	קנה
קאָס	כּוס
קאַסװע(נע)ן	כּתבֿע(נע)ן
קאַסװע־ראַבע	כּתבֿא־רבא
קאָסעװ־װעכאָסעם	כּתובֿ־וחתום
קאַסריל	כּתריאל
קאַסריל	כּתריאל
קאַסריליק	כּתריאליק
קאַסרילעװקע	כּתריאלעװקע
קאַסריִעל	כּתריאל
קאָף	כּ
קאָף	כּף
קאַפּאָרע	כּפּרה
קאַפּאָרע	כּפּרה־הינדל
קאַפּאָרעניצע	כּפּרהניצע
קאַפּדאָנים	קפּדן
קאַפּדן	קפּדן
קאַפּצאָנים	קבצן
קאַפּצאָנעס	קבצנות
קאַפּצן	קבצן
קאַפּצנטע	קבצנטע
קאַפּצענען	קבצנען
קאַף־האַקעלע	כּף־הקלע
קאַפֿאַקאַל	כּף־הקל
קאַפֿאַקל	כּף־הקל
קאַפֿטערן	כּפֿתּורן
קאָפֿל־שמױנע	כּפֿול־שמונה
קאָפֿל־שמױנעדיק	כּפֿול־שמונהדיק
קאָפֿע־טױװע	כּפֿױ־טובֿה
קאָפֿע־טױװעניק	כּפֿױ־טובֿהניק
קאָפֿרים	כּופֿר
קאָפֿרים־בעיִקער	כּופֿר־בעיקר
קאַפֿריסן	קפֿריסין
קאַפֿריסנדיק	קפֿריסינדיק
קאַצאָװים	קצבֿ
קאַצאָװעס	קצבֿות
קאָצן	קצין
קאַצעװ	קצבֿ
קאַצעװטע	קצבֿטע
קאַק	ק״ק
קאַקאָסעװ	כּכּתובֿ
קאָרבאָנעס	קרבן
קאָרבן	קרבן
קאָרבן־מינכע	קרבן־מינחה
קאָרבן־מינכע־סידער	קרבן־מינחה־סידור
קאָרײסעס	כּריתות
קאָרים־אוקסאָסעס	כּרים־וכּסתות
קאָרעװ	קרובֿ
קאָרעװ	קרובֿ
קאָרעװטע	קרובֿטע
קאָרעװ־לעמאַלכעס	קרובֿ־למלכות
קאָרעװ־לעמײקעך	קרובֿ־למקח
קאָרעװ־לעעמעס	קרובֿ־לאמת
קאָרעס	כּרת
קאַרפּעס	כּרפּס
קאַרקאָעס	קרקע
קאַרקע	קרקע
קאַרקע־פּסולע	קרקע־בתולה
קאָשע	קשה
קאַשע	קשיא
קאַשעס	מזל קשת
קאַשעס	קשת
קאָשער	כּשר
קאָשער	כּשר־טאַנץ
קאָשער־װעיאָשער	כּשר־ױשר
קאָשער־לעפּײסעך	כּשר־לפּסח
קאַשערן	כּשרן
קאַשרעס	כּשרות
קדאָרים	קדר
קדױשים	קדוש
קדױשים	קדושים
קדױשים־אוטעהױרים	קדוש־וטהור
קדושע	קדושה
קובוץ	קובוץ
קודשע־בעריך־הו	קודשא־בריך־הוא
קװאָד	כּבֿוד־
קװאָד־האַראַװ	כּבֿוד־: כּבֿוד־הרבֿ
קװאַד־לאָשן	כּבֿד־לשון
קװאַטפּע	כּבֿד־פּה
קװאָרים	קבֿר
קװאָרעס	קבֿרות
קװאָרעס	קבֿרות־בלעטער
קװאָרעס	קבֿרות־ײִד
קװאָרעס	קבֿרות־מאַן
קװאָרעס	קבֿרות־שטיבל
קװאָרעסניק	קבֿרותניק
קװוּרע	קבֿורה
קװוּרעס־ײִסראָעל	קבֿורת־ישׂראל
קװוּרעס־כאַמער	קבֿורת־חמור
קװיִעס	קבֿיעות
קוזרי	כּוזרי
קוזרים	כּוזרים
קױדעם	קודם
קױדעם־לאַקל	קודם־לכּל
קױדעמקאָל	קודם־כּל
קױדעש	קודש
קױדעש־קאָדאָשים	קודש־קדשים
קױהעלעס	קהלת
קױװײע	קובֿע —> קובֿע זײַן
קױװער	קובֿר —> קובֿר זײַן
קױכאָװים־אומאַזאָלעס	כּוכבֿים־ומזלות
קױכעס	כּוח
קױלעל	כּולל
קױלעל	כּולל —> כּולל זײַן
קױלעס	קול
קױלעס	קולות
קױלעס־אוּװראָקים	קולות־ובֿרקים
קױלע־קױלעס	קולי־קולות
קױמעמיִעס	קוממיות
קױמער	כּומר
קױנים	קונה
קױנע	קונה
קױנע־אױלעם	קונה־עולם —> קונה־עולם זײַן —> זײַן זיך
קױנע־האַקל	קונה־הכּל
קױנעטע	קונהטע
קױנע־סכוס	קונה־זכות —> קונה־זכות זײַן —> זײַן זיך
קױנע־שעם	קונה־שם —> קונה־שם זײַן —> זײַן זיך
קױסל־מאַראָװי	כּותל־מערבֿי
קױסע	כּוס(י)ע
קױסע(נע)ן	כּוסע(נע)ן
קױסעס	כּוס
קױעך	כּוח
קױעך־גאַװרע	כּוח־גבֿרא
קױעך־האַדאַם	כּוח־הדם
קױעך־האַדיבער	כּוח־הדיבור
קױעך־האַדימיען	כּוח־הדמיון
קױעך־האַמױשעך	כּוח־המושך
קױעך־האַמעדאַמע	כּוח־המדמה
קױעך־האַרשאָע	כּוח־הרשאה
קױעכן	כּוחן —> כּוחן זיך
קױען	כּהן
קױען־גאָדל	כּהן־גדול
קױענדיק	כּהנדיק
קױפֿעץ־בעראָש	קופֿץ־בראָש
קױפֿער	כּופֿר
קױפֿער	כּופֿר —> כּופֿר זײַן
קױפֿער־בעיִקער	כּופֿר־בעיקר
קױפֿער־האַקל	כּופֿר־הכּל
קױצע־שעליוד	קוצו־של־יוד
קױרײע	קורע —> קורע זײַן —> זײַן זיך
קױרײע־קעדאַג	קורע־כּדג —> קורע־כּדג זײַן
קױרים	כּורעים
קױרים־אומישטאַכװים	כּורעים־ומשתּחװים
קױרים־ניכבאָדים	קורא־ניכבד
קױרעך	קורח
קױרעך	קרח
קױרע־ניכבעד	קורא־ניכבד
קױרעס־בריס	כּורת־ברית —> כּורת־בֿית זײַן
קױרעש	כּורש
קולע	כּולו
קולע	קולא
קולע הײַ	כּולי האַי
קולע זאַקע	כּולו זכּאי
קולע טױרע	כּולה תּורה
קולע כײַעװ	כּולו חײבֿ
קולעם	כּולם
קולע מוקשע	כּולו מוקשה
קולע רעװעך	כּולו רװח
קונדײסים	קונדס
קונדעס	קונדס
קונדעסערײַ	קונדסערײַ
קונטרײסים	קונטרס
קונטרעס	קונטרס
קוף	ק
קוף	קוף
קופּע־שעל־שראָצים	קופּה־של־שרצים
קוצע־שעליוד	קוצו־של־יוד
קוש	כּוש
קזאָװים	כּזבֿ
קטאַנײ־עמאָנע	קטני־אמנה
קטאַנײ־עמונע	קטני־אמונה
קטאַנים	קטן
קטױרעס	קטורת
קיבודים	כּיבוד
קיבוץ	קיבוץ
קיבוצים	קיבוץ
קיבעד	כּיבוד
קיבעד	כּיבוד
קיבעד־אָװ	כּיבוד־אָבֿ
קיבעד־אײם	כּיבוד־אם
קיבעץ	קיבוץ
קיבעץ־גאָליעס	קיבוץ־גלױות
קידוש(י)ן	קידושין
קידעש	קדוש
קידעש	קידוש
קידעש־האַכױדעש	קידוש־החודש
קידעש־האַשעם	קידוש־השם
קידעש־לעװאָנע	קידוש־לבֿנה
קידעש־לעװאָנע־אױסיעס	קידוש־לבֿנה־אותיות
קי־הו־זע	כּי־הוא־זה
קיװן	כּיװן
קיזוּװים	כּיזובֿ
קיזעװ	כּיזובֿ
קיטניעס	קיטניות
קיטע	כּיתּה
קיטעס	כּתּ
קיטרעג	קיטרוג
קײדער	קדר
קײװער	קבֿר
קײװער־אָװעס	קבֿר־אָבֿות
קײװער־ײִסראָעל	קבֿר־ישׂראל
קײלים	כּלי
קײלים	כּלים
קײלע	כּלי
קײלע־ניפֿלאָע	כּלי־נפֿלאה
קײלע־שײנע	כּלי־שני
קײלע־שלײמע	כּלי־שלמה
קײַמעלאָן	קײַמא־לן
קײַסאָנים	כּעסן
קײסאָרים	קיסר
קײַסן	כּעסן
קײַסן	כּעסן —> כּעסן זיך
קײַסנטע	כּעסנטע
קײַסענען	כּעסנען —> כּעסנען זיך
קײסער	קיסר
קײסער יאָרעם הױדע	קיר״ה: קיסר ירום הודו
קײסערינ(י)ע	קיסרינ(י)ע
קײע	קיאה
קײפֿל	כּפֿל
קײפֿלען	כּפֿלען
קײפֿל־קעפֿלאַיִם	כּפֿל־כּפֿלים
קײַרע	קערה
קײרע	קרי
קילאַיִם	כּילאַים
קילאַכער־יאַד	כּלאַחר־יד
קילכױך־האַשאָר	כּלחוך־השור
קילעיאָדע	כּלא־ידע
קימאַט	כּמעט
קימכע־דעפּאַסכע	קמחא־דפּסחא
קינהאָג	כּנהוג
קיניאָנים	קנין
קינים	דצ״ך עד״ש באח״ב: כּינים
קינים	כּינה
קינים	קינים
קיניען	קנין
קיניען־האַקאָאָל	קנין־הקהל
קינע	כּינה
קינע	קינאה
קינע	קינה
קינע־סינע	קינאה־שׂינאה
קינעס־סאָפֿרים	קינאת־סופֿרים
קיס	כּיס
קי־סאָװאָ	כּי־תבֿוא
קיסװע־האַקױדעש	כּיתבֿי־הקודש
קיסװע־יאַד	כּתבֿ־יד
קיסװע־פּלאַסטער	כּתבֿ־פּלסתּר
קי־סײצע	כּי־תצא
קי־סיסאָ	כּי־תישׂא
קיסלעװ	כּיסלו
קיסלער	כּיסלער
קיסע־האַמאַלכעס	כּיסא־המלכות
קיסע־האַקאָװעד	כּיסא־הכּבֿוד
קיסע־האַראַבאָנעס	כּיסא־הרבנות
קיסע־האַראַכמים	כּיסא־הרחמים
קיסע־ראַבאָנעס	כּיסא־רבנות
קיסע־שעל־עליאָהו (האַנאָװי)	כּיסא־של־אליהו (הנבֿיא)
קיסריִיִם	קיסר
קיִעם	קיום
קיִעם־האָומע	קיום־האומה
קיִער	כּיור
קיצװע	קיצבֿה
קיצורים	קיצור
קיצער	קיצור
קיצער־האַדאָװער	קיצור־הדבֿר
קיצער־האַמײַסע	קיצור־המעשׂה
קיצער־יאָמים	קיצור־ימים
קיקױען־דעיױנע	קקיון־דיונה
קיקער־לעכעם	כּיכּר־לחם
קירכױק־מיזרעך־מימײַרעװ	כּרחוק־מיזרח־ממערבֿ
קירע	קיר״ה
קירע־דײַטש	קיר״ה: קיר״ה־דײַטש
קישופֿים	כּישוף
קישעף	כּישוף
קישעפֿן	כּישופֿן
קישרױנעס	כּישרון
קישרען	כּישרון
קלאַװטע	כּלבֿטע
קלאָװים	כּלבֿ
קלאַל	כּלל
קלאַל	כּלל
קלאַל	כּלל
קלאַל־איניאָנים	כּלל־ענינים
קלאַל־זאַך	כּלל־זאַך
קלאַל־טוער	כּלל־טוער
קלאַל־ײִדיש	כּלל־ײִדיש
קלאַל־ײִסראָעל	כּלל־ישׂראל
קלאָלים	כּלל
קלאַליִעס	כּלליות
קלאָלע	קללה
קלאָלען	קללהן
קלאָלעס־(או)כראָמעס	קללות־(ו)חרמות
קלאָלעס־נימראָצעס	קללות־נימרצות
קלאַל־שפּראַך	כּלל־שפּראַך
קלאַסטער־פּאָנעם	קלסתּר־פּנים
קלאַפּע	כּלפּי
קלאַפּע־כוץ	כּלפּי־חוץ
קלאַפּע־פּנים	כּלפּי־פּנים
קלאַפֿטע	כּלבֿטע
קלאָץ	קשיא: קלאָץ־קשיא
קלױמער	כּלומר
קלױמערשט	כּלומרשט
קלױנעמעס	קלונימוס
קלײנשאַס	ש״ס: קלײן־ש״ס
קלימעפֿױער	כּלי־מפֿואר
קליפּע	קליפּה
קלע־באַיִס	כּלי־בית
קלע־זאָהאָװ	כּלי־זהבֿ
קלע־זאַיִן	כּלי־זײן
קלעזמאָרים	כּלי־זמר
קלעזמער	כּלי־זמר
קלעזמערײַ	כּלי־זמרײַ
קלעזמערן	כּלי־זמרין
קלע־יאָקער	כּלי־יקר
קלע־מאַשכיס	כּלי־משחית
קלע־קױדעש	כּלי־קודש
קלע־קסיװע	כּלי־כּתיבֿה
קלע־קעסעף	כּלי־כּסף
קמױ	כּמו
קנאַאַן	כּנען
קנאַס	קנס
קנאַס	קנס־מאָל
קנאָסים	קנס
קנוניע	קנוניא
קנופֿיע	כּנופֿיא
קניִע	קניה
קנעסעט	כּנסתּ
קנעסעס־האַגדױלע	כּנסת־הגדולה
קנעסעס־ײִסראָעל	כּנסת־ישׂראל
קסאַװ	כּתבֿ
קסאַװ	כּתבֿ
קסאַװיאַד	כּתבֿ־יד
קסאָװים	כּתבֿ
קסאַװ־פּלאַסטער	כּתבֿ־פּלסתּר
קסאַװ־ראַבאָנעס	כּתבֿ־רבנות
קסאָרים	כּתר
קסובע	כּתובה
קסובעס	כּתובות
קסוּװים	כּתובֿים
קסיװ	כּתיבֿ
קסיװיש	כּתיבֿיש
קסיװע	כּתיבֿה
קסיװע װעכסימע טױװע	כּתיבֿה וחתימה טובֿה
קסיװען	כּתיבֿהן
קסיסע	גסיסה
קע…	כּ…
קעאַל־קאַף־האַיאַד	כּעל־כּף־היד
קעאָני־באַפּעסעך	כּעני־בפּתח
קעאַפֿרע־דעאַרע	כּעפֿרא־דאַרעא
קעאָר	כּאור
קעאָר־האַבױקער	כּאור־הבוקר
קעדאַיִק	כּדאַיִק
קעדאַס	כּדת
קעדאַס־מױשע־װיסראָעל	כּדת־משה־ױשׂראל
קעדאַרקע	כּדרכּו / כּדרכּה
קעדױמע	כּדומה
קעדױמע־לעמאָשל	כּדומה־למשל
קעדײַ	כּדאַי
קעדײ	כּדי
קעדין	כּדין
קעדין־אוקעדאַס / ־װעקעדאַס	כּדין־וכּדת
קעדעבאָע	כּדבעי
קעדערעך־האַטעװע	כּדרך־הטבֿע
קעהאַװײַע	כּהװיה
קעהאַלאָכע	כּהלכה
קעהאַל־כ(אַ)סידים	קהל־חסידים
קעהאַנים	כּהן
קעהונע	כּהונה
קעהײַ־לישנע	כּהאַי־לישנא
קעהילע	קהילה
קעהילע־קדױשע	קהילה־קדושה
קעזאַיִס	כּזית
קעזײסים	כּזית
קעזעװ	כּזבֿ
קעיאַד־האַגװיר	כּיד־הגבֿיר
קעיאַד־האַמײלעך	כּיד־המלך
קעיִלע	כּאילו
קעיעדוע	כּידוע
קעכוט־האַסײרע	מדקדק —> מדקדק זײַן: מדקדק —> מדקדק זײַן כּחוט־השׂערה
קעכױל־האַיאַם	כּחול־הים
קעכױמער בעיאַד־האַיױצער	כּחומר ביד־היוצר
קעכערעס־האַנישבער	כּחרס־הנישבר
קעכצאָס־האַלײַלע	כּחצות־הלילה
קעלאָס־האַנעפֿעש	כּלות־הנפֿש
קעלױ־הױע	כּלא־היה
קעלכל	קול:  דימינוטיװ קולכל
קעלכל	קולכל
קעלעװ	כּלבֿ
קעלעװ־שעבאַקלאָװים	כּלבֿ־שבכּלבֿים
קעלעכל	קול:  דימינוטיװ קולעכל
קעלעכל	קולעכל
קעלער	קול
קעמוּװן	כּמובֿן
קעמוּװן־מעײלעװ	כּמובֿן־מאליו
קעמײלעך־ביגדוד	כּמלך־בגדוד
קעמינהאָגע	כּמינהגה / כּמינהגו
קעמיקעדעם	כּמקדם
קעמעך־פּײסעך	קמח־פּסח
קענאָהעג	כּנהוג
קען־יאָװדו	כּן־יאָבֿדו
קען־ײִרבו	כּן־ירבו
קעניסקער לעײל	כּנ״ל: כּניזכּר לעיל
קענעגדים	כּנגד
קענעגעד	כּנגד
קענעגעד	כּנגד
קענציפּער	קן־ציפּור
קעסײדער	כּסדר
קעסעף	כּסף
קעסעף־טאָהער	כּסף־טהור
קעסער	כּתר
קעעכאָד־האָאָדעם	כּאחד־האָדם
קעעכאָד־האָרײקים	כּאחד־הריקים
קעפּשוטע	כּפּשוטו
קעפֿי	כּפֿי
קעץ	קץ
קעצאַפּיכעס־בידװאָש	כּצפּיחית־בדבֿש
קעץ־האַיאָמען	קץ־הימין
קעצױן־ב(ע)לי־רױע	כּצאן־בלי־רועה
קעקליפּעס־האַשום	כּקליפּת־השום
קעקעלע־קאָאָל	ק״קעלע־קהל
קעקריִעס־יאַמסוף	כּקריעת־ים־סוף
קערי	קרי
קערן	קרן
קערן־קאַיעמעס	קרן־קימת
קערעך	כּרך
קערעף־אַיִן	כּהרף־עין
קעשורע	כּשורה
קעשער	קשר
קפּײדע	קפּידא / קפּידה
קפֿוּיע־טױװע	כּפֿױ־טובֿה
קפֿיצעס־האַדערעך	קפֿיצת־הדרך
קפֿירע	כּפֿירה
קצינים	קצין
קראָיִ	קראָי
קראַך	כּרך
קראָכים	כּרך
קראָשים	קרשים
קרוּװ	כּרובֿ
קרוז	כּרוז
קרױװים	קרובֿ
קרױװים־לעמאַלכעס	קרובֿ־למלכות
קרױװישאַפֿט	קרובֿישאַפֿט
קרױװע	קרובֿה
קרױװעטע	קרובֿהטע
קרוע־אוּװלוע	קרועה־ובֿלױה
קרוע־בלוע	קרוע־בלוע
קרי	קרי
קרײװעס	קרבֿות
קרײַע־דאַבועדיק	כּרעיה־דאַבוהדיק
קריִע	קריעה
קריִעס־האַטױרע	קריאת־התּורה
קריִעס־יאַמסוף	קריעת־ים־סוף
קרירע	קרירה
קרישמע	קריאת־שמע
קשאַל־בערעך	כּשל־ברך
קשאָמים	גשם
קשי־אױרעף	קשי־עורף
קשײ־אױרעף	קשה־עורף
קשײרים	כּשרים

ראַבאָנים	רבֿ
ראַבאָניש	רבניש
ראַבאָנען־קאַדעש	רבנן־קדיש
ראַבאָנעס	רבנות
ראַבױסײַ	רבותי
ראַבױסים	רבותים
ראַבײנו	רבנו
ראַבײנו טאַם	רבנו תּם
ראַבײנו טאַמס טפֿילן	רבנו תּמס תּפֿילין
ראַבים	רבים
ראַבע באַר־באַר־כאָנע	רבה / רבא בר־בר־חנה
ראַבעיִם	רבי
ראַבעיִש	רבײִש
ראַגזאָנים	רגזן
ראַגזאָנעס	רגזנות
ראַגזן	רגזן
ראַגזנטע	רגזנטע
ראָגל	רגיל
ראַגלאַיִם	רגלים
ראָדפֿע־קאָװעד	רודף־כּבֿוד
ראָדפֿע־שאָלעם	רודף־שלום
ראָװ	רבֿ
ראַװ	רבֿ
ראָװ	רובֿ
ראָװביניען־װעראָװקיניען	רובֿ־בנין־ורובֿ־קנין
ראָװגאָדלע־װעראָװאָשרע	רובֿ־גדלו־ורובֿ־עשרו
ראָװ־דײעס	רובֿ־דעות
ראַװ־האַקױלעל	רבֿ־הכּולל
ראַװ־האָראָשי	רבֿ־הראָשי
ראָװמיניען־װעראָװביניען	רובֿ־מנין־ורובֿ־בנין
ראָװ־קאָס	רובֿ־כּוס
ראַזיעל	רזיאל
ראָזן־דעראָזן	רזין־דרזין
ראָטפֿע־קאָװעד	רודף־כּבֿוד
ראָטפֿע־שאָלעם	רודף־שלום
ראַיאָסי	רעיתי
ראַיאָסע	רעיתו
ראַיױנעס	רעיון
ראַכאַש	רח״ש
ראַך־האַנױלעד	רך־הנולד
ראַך־האַנימל	רך־הנימול
ראַכװעס	רחבֿות
ראַכװעסדיק	רחבֿותדיק
ראָכל	רחל
ראַך־לעװ	רך־לבֿ
ראַכמאָנים	רחמן
ראַכמאָנע־יעצילײנע	רחמנא־יצילינו
ראַכמאָנע־ליצלאַן	רחמנא־לצלן
ראַכמאָנעס	רחמנות
ראַכמאָנעס־פּאָנעם	רחמנות־פּנים
ראַכמאָנעס־פּענעמער	רחמנות־פּנים
ראַכמיל	רחמיאל
ראַכמים	רחמים
ראַכמיִעל	רחמיאל
ראַכמען	רחמן
ראָכעװ (האַזױנע)	רחבֿ (הזונה)
ראַכעם	רחום
ראַכעם־װעכאַנען	רחום־וחנון
ראָכעק	רחוק
ראַמאָיִם	רמאַי
ראַמאַך	רמ״ח
ראַמאַך אײװרים	רמ״ח אבֿרים
ראַמאָעס	רמאָות
ראַמבאַם	רמבם / רמב״ם
ראַמײַ	רמאַי
ראָע	ראָױ
ראָע	רעה
ראָע־לעהױראָע	ראָױ־להוראה
ראָע־לעכופּע	ראָױ־לחופּה
ראָפֿע	רפֿה
ראַצכאָנים	רצחן
ראָצכים	רוצח
ראַצכן	רצחן
ראַצכע(נע)ן	רצחע(נע)ן
ראָצן	רצון
ראַק	רק
ראָש	רא״ש
ראָש	ראָש
ראַש	רעש
ראָשאַקאָאָל	ראָש־הקהל
ראָש־בעז(ד)ן	ראָש־בית־דין
ראָש־האַגױלע	ראָש־הגולה
ראָש־האַדאַיאָנים	ראָש־הדײנים
ראָש־האַמעדאַברים	ראָש־המדברים
ראָש־װערישן	ראָש־וראשון
ראָשײטע	רשעטע
ראָשיעשיװע	ראָש־ישיבֿה
ראַשן	רעשן
ראַשע	רשי / רש״י
ראָשע	רשע
ראָשע־בעז(ד)ן	ראָש־בית־דין
ראָשע־גאָמער	רשע־גמור
ראָשע־האַגױלע	ראָש־הגולה
ראָשע־האַמעדאַברים	ראָש־המדברים
ראָשעטײװעס	ראָשי־תּיבֿות
ראָשעטע	רשעטע
ראָשע־יעשיװעס	ראָש־ישיבֿה
ראָשע־מערושע	רשע־מרושע
ראָשעפּראָקים	ראָשי־פּרקים
ראָשעקאָאָל	ראָש־הקהל
ראַשע־קסאַװ	רשי־כּתבֿ
ראָשעשאָנע	ראָש־השנה
רובל־קעסעף	רו״ך / רו״כ / רו״כּ: רובל־כּסף
רוגזע	רוגזה / רוגזא
רוּװן	ראובֿן
רױגעז	רוגז
רױדעף־קאָװעד	רודף־כּבֿוד
רױדעף־שאָלעם	רודף־שלום
רױדעף־שאָלעמניק	רודף־שלומניק
רױדעפֿן	רודפֿן
רױע־װעײנע־נירע	רואה־ואינו־ניראה
רױע־כעזשבם	רואה־חשבון
רױפֿים	רופֿא
רױפֿע	רופֿא
רױפֿעטע	רופֿאטע
רױפֿע־כױלים	רופֿא־חולים
רױשי־װערובי	ראשי־ורובי
רױשע־װערובע	ראשו־ורובו
רױשעם	רושם
רוכניִעס	רוחניות
רוכעס	רוח
רוכעס־ראָיִם	רוח־רע
רוכעס־ראָעס	רוח־רעה
רוס	רות
רועך	רוח
רועך־האַכאַיִם	רוח־החײם
רועך־האַקױדעש	רוח־הקודש
רועך־כאַיִם	רוח־חײם
רועך־ראַ	רוח־רע
רועך־ראָע	רוח־רעה
רועך־שטוס	רוח־שטות
ריבױנע־דעאַלמע (־קולע)	רבונא־דעלמא(־כּולא)
ריבעס	ריבית
ריבעסניק	ריביתניק
ריװקע	רבֿקה
רײכעס	ריח
רײַע	ראַיה
רײע	ריאה
רײעך	ריח
רײעך־טױרע	ריח־תּורה
רײעך־ניכױעך	ריח־ניחוח
רײַע־לעדאָװער	ראַיה־לדבֿר
רײַען	רעיון
רײַעס־ברורעס	ראַיות־ברורות
רײק	ריק
רײש	ר
רײש	ריש
רײש־גאָלוסע	ריש־גלותא
רײשעס	ראשית
רײשעס־דאָװער	ראשית־דבֿר
רײשעס־כאָכמע	ראשית־חכמה
ריסעק־אײװרים	ריסוק־אבֿרים
ריִע	ראיה
ריפֿקע	רבֿקה
ריקודים	ריקוד
ריקעד	ריקוד
רישױנים	ראשונים
רישן	ראשון
רישעס	רישעות
רעב	ר׳
רעב	רב
רעבױנע־שעלױלעם	רבונו־של־עולם
רעביסטװע	רביסטװע
רעבע	רבי
רעבע	רבי
רעבע־געלט	רבי־געלט
רעבעניו	רביניו
רעבעצן	רביצין
רעבעש	רביש
רעבעשאַפֿט	רבישאַפֿט
רעגאָלים	רגל
רעגילים	רגיל
רעגילעס	רגילות
רעגל	רגל
רעגע	רגע
רעגע־קעמעמרע	רגע־כּמימרא
רעדיפֿע	רדיפֿה
רעװאָכים	רװח
רעװוּסע	רבֿותא
רעװיִיִ	רבֿיעי
רעװל	רבֿל
רעװעך	רװח
רעײ	ראה
רעכאַש	רח״ש
רעכילעס	רכילות
רעכילעסן	רכילותן
רעכילעסניצע	רכילותניצע
רעכילעסניק	רכילותניק
רעמאָ	רמ״א
רעמאָזים	רמז
רעמאַך	רמ״ח
רעמאַך אײװרים	רמ״ח אבֿרים
רעמעז	רמז
רעפֿאָעל	רפֿאל
רעפֿוע	רפֿואה
רעפֿוע־בדוקע	רפֿואה־בדוקה
רעפֿוע־שלײמע	רפֿואה־שלמה
רעצוע	רצועה
רעצײעך	רוצח
רעצײעכטע	רוצחטע
רעציכע	רציחה
רעקידע	רקידה
רעקײעך	חסידי־אַשכּנז: ר׳ אלעזר רוקח
רעשאָיִם	רשע
רעשאָיִם־גמורים	רשע־גמור
רעשאַנטע	רשענטע
רעשוס	רשות
רעשוס־האַיאָכעד	רשות־היחיד
רעשוס־האָראַבים	רשות־הרבים
רעשײרן	ראש־עירון
רעשימע	רשימה
רעשכױדעש	ראָש־חודש
רעשכױדעש	ראָש־חודש־געלט
רעשכױדעש	ראָש־חודש־רעטעכל

שאָ	שעה
שאַאַר	שער
שאַאַר־האָאַשפּע	שער־האַשפּה
שאַאַרע־דמאָעס	שערי־דמעות
שאַאַרע־טפֿילע	שערי־תּפֿילה
שאַאַרע־ראַכמים	שערי־רחמים
שאַבאָסים	שבת
שאַבײסענאַכט(ס)	שבתע־נאַכט(ס)
שאַבעס	שבת
שאַבעס־ברײשעס	שבת־בראשית
שאַבעס־גאָיִם	שבת־גױ
שאַבעסגױ	שבת־גױ
שאַבעס־גױע	שבת־גױע
שאַבעס־האַגאָדל	שבת־הגדול
שאַבעס־טשוּװע	שבת־תּשובֿה
שאַבעס־כאַזאָן	שבת־חזון
שאַבעס־ליכט	שבת־ליכט
שאַבעס־מעװאָרכים	שבת־מבֿרכים
שאַבעס־נאַכמו	שבת־נחמו
שאַבעס־קױדעש	שבת־קודש
שאַבעס־שאַבאָסן	שבת־שבתון
שאַבעס־שוּװע	שבת־שובֿה
שאַבעס־שטעך / ־שטעפּ	שבת־שטעך / ־שטעפּ
שאַבעס־שירע	שבת־שירה
שאַדאַר	שד״ר
שאַדײַ	שדי
שאַדײַ קראַ סאָטן	שדי קרע שׂטן
שאָװע־בעשאָװע	שװה־בשװה
שאָװע־לעקאָלנעפֿעש	שװה־לכּל־נפֿש
שאָװע־קעסעף	שװה־כּסף
שאַװעשעקער	שװא־ושקר
שאַװרירע ברירע רירע רי	שבֿרירי ברירי רירי רי
שאַטיע	שטיא
שאַטכאָנים	שדכן
שאַטכאָנעס	שדכנות
שאַטכן	שדכן
שאַטכנטע	שדכנטע
שאַטכענען	שדכנען
שאַטנעז	שעטנז
שאַיאָרע	שײרה
שאָכטים	שוחט
שאָכטעס	שוחטות
שאָכן	שכן
שאָכנטע	שכנטע
שאָכנײ־אָפֿער	שוכן־עפֿר
שאַכנע	שכנא
שאַכרײסים	שחרית
שאַכרעס	שחרית
שאַלװע	שלװה
שאַלאַכמאָנעס	שלח־מנות
שאָל־טאַכטיס	שאול־תּחתּית
שאָל־טאַכטיִע	שאול־תּחתּיה
שאָלעם	שלום
שאָלעם	שלום
שאָלעם־אַלײכעם	שלום־עליכם
שאָלעם־באַיִס	שלום־בית
שאָלעם־װעשאַלװע	שלום־ושלװה
שאָלעם־זאָכער	שלום־זכר
שאָלעם־לאַהוּװי	שלום־לאַהובֿי־בריװ
שאָלעש	שליש
שאַלעשודעס	שלש־סעודות
שאָלעש־רעגאָלים	שלש־רגלים
שאַלשעלעס	שלשלת
שאַלשעלעס־האַיאָכסן	שלשלת־היוחסין
שאַמאָסים	שמשׂ
שאַמאָסעס	שמשׂות
שאָ־מוצלאַכעס	שעה־מוצלחת
שאַמײַ	שמאי
שאַמע	שמאי
שאַמעס	שמשׂ
שאַמעסטע	שמשׂטע
שאָמרים	שומר
שאָמרע־שאַבעס	שומר־שבת
שאָנים	שנה
שאָנים	שנים
שאָנע	שנה
שאָנע (האָכע)	שאָני (הכא)
שאָנע־טױװע	שנה־טובֿה
שאָנע־מעובערעס	שנה־מעוברת
שאַס	ש״ס / שס
שאַסאַ	שס״ה
שאַסאַ גידן	שס״ה גידין
שאַס־האַטכאַק	שעת־הדחק
שאַס־האַקױשער	שעת־הכּושר
שאַסטכינע	ש״ס־תּחינה
שאָסקים	שותק
שאַס־ראָצן	שעת־רצון
שאָעל	שאָול
שאַפּסע	שבתי
שאַפּסע־צװי	שבתי־צבֿי
שאַפּסע־צװיניק	שבתי־צבֿיניק
שאָפֿטים	שופֿט
שאָפֿטים	שופֿטים
שאָפֿל	שפֿל
שאַץ	ש״ץ
שאַקלע־װעטאַריע	שקלא־וטריא
שאַקראָנים	שקרן
שאַקרען	שקרן
שאָר	מזל שור
שאָר	שור
שאַר	שער־בלאַט
שאָראַבאָר	שור־הבר
שאָר־אַראָצעס	שאָר־אַרצות
שאָר־האַניסקל	שור־הניסקל
שאַרװעט	שרבֿיט
שאָריעראָקעס	שאָר־ירקות
שאָרע־בעצאַאַר	שרױ־בצער
שאַרפּאַט	שרפּ״ט
שבײסענאַכט(ס)	שבת־צו־נאַכט(ס)
שװאָ	שװאָ
שװאַט	שבֿט
שװאָטים	שבֿט
שװאַך	שבֿח
שװאָכים	שבֿח
שװאָכים	שבֿחים
שװאָרים	שבֿרים
שװאַרצמײעדיק	שװאַרץ־מאהדיק
שװאַרצמײעניק	שװאַרץ־מאהניק
שװוּע	שבֿועה
שװוּעס	שבֿועות
שװוּעסל	שבֿועתל
שװיִיִ	שבֿיעי
שװיִיִס	שבֿיעית
שװיִיִ־שעל־פּײסעך	שבֿיעי־של־פּסח
שוטעף	שותּף
שוטעפֿטע	שותּפֿטע
שוטפֿים	שותּף
שוטפֿיש	שותּפֿיש
שוטפֿעס	שותּפֿות
שוטפֿעסדיק	שותּפֿותדיק
שױגעג	שוגג
שױטים	שוטה
שױטע	שוטה
שױכן־אָפֿער	שוכן־עפֿר
שױכעד	שוחד
שױכעט	שוחט
שױכעטקע	שוחטקע
שױלעט	שולט —> שולט זײַן
שױמו שאָמאַיִם	שומו שמים
שױמער	שומר
שױמער־אומאַצל	שומר־ומציל —> שומר־ומציל זײַן
שױמער־ײִסראָעל	שומר־ישׂראל
שױמער־כינעם	שומר־חינם
שױמער־סאָכער	שומר־שׂכר
שױמער־פּסאָיִם	שומר־פּתאָים
שױמער־שאַבעס	שומר־שבת
שױסעק	שותק
שױעל	שואל
שױעל־אײצע	שואל־עצה —> שואל־עצה זײַן —> זײַן זיך
שױפֿעט	שופֿט
שױפֿעך־דאַם	שופֿך־דם —> שופֿך־דם זײַן
שױפֿעך־דאָמים	שופֿך־דמים —> שופֿך־דמים זײַן
שױפֿער	שופֿר
שױפֿער־שעל־מעשיִעך	שופֿר־של־משיח
שױפֿרעס	שופֿר
שױרעש	שורש
שױשאַנעס־יאַנקעװ	שושנת־יעקבֿ
שולאַמיס	שולמית
שולכן	שולחן
שולכן־אָרעך	שולחן־ערוך
שום	שום
שופֿרע־דעשופֿרע	שופֿרא־דשופֿרא
שורע	שורה
שורע	שורה־גריזל
שורעק	שורק
שושן־האַבירע	שושן־הבירה
שושן־פּורים	שושן־פּורים
שטאַדלאָנים	שתּדלן
שטאַדלאָנעס	שתּדלנות
שטאַדלען	שתּדלן
שטאַדלענטע	שתּדלנטע
שטאַדלענען	שתּדלנען —> שתּדלנען זיך
שטאָכים	שטח
שטאָנע	השתּנה
שטאַר	שטר
שטאָרים	שטר
שטאַר־כאָצי־זאָכער	שטר־חצי־זכר
שטאַרכױװ	שטר־חובֿ
שטאַר־מעכירע	שטר־מכירה
שטאָרעס	שטר
שטוס	שטות
שטוסערײַ	שטותערײַ
שטיִע	שתּיה
שטיִען	שתּיהן
שטיקע	שתּיקה
שטיקע קעהױדאָע (דאַמיע)	שתּיקה כּהודאה (דמיא)
שיבושים	שיבוש
שיבעד	שיעבוד
שיבעד־גאָליעס	שיעבוד־גלױות
שיבעש	שיבוש
שיגאָנען	שגעון
שיגאָען	שגעון
שיגױנעס	שגעון
שידוכים	שידוך
שידע	שידה
שידעך	שידוך
שיװאָסער־בעטאַמעז	שיבֿעה־עשׂר־בתּמוז
שיװים	שיבֿעים
שיװים־אומעס	שיבֿעים־אומות
שיװים־לאָשן / ־לעשױנעס	שיבֿעים־לשונ(ות)
שיװיסי	שױתי
שיװיסי אַדױשעם לענעגדי טאָמעד	שױתי:  שױתי ה׳ לנגדי תּמיד
שיװע	שיבֿעה
שיװע־טוּװע־האָיִר	שיבֿעה־טובֿי־העיר
שיװע־יאַמים / ־יאַמען	שיבֿעה־ימים
שיװע־מעדורע־גענעם	שיבֿעה־מדורי־גיהנום
שיװעס־יעמײ־האַמישטע	שיבֿעת־ימי־המישתּה
שיװעס־ציִען	שיבֿת־ציון
שיװרע־לוכעס	שיבֿרי־לוחות
שיװרעלעװ	שיבֿרי־לבֿ
שיװרעס־האַלעװ	שיבֿרות־הלבֿ
שיװרע־קײלע	שיבֿרי־כּלי
שיִורים	שיעור
שיטין־נישמין	שיתּין־נשמין
שיטע	שיטה
שײַ	ש״י
שײַ אױלעמעס / אױלאָמעס	ש״י עולמות
שײַגעס־אַריע	שאגת־אַריה
שײגעץ	שײגעץ
שײדים	שד
שײװע	שװא
שײװעט	שבֿט
שײַכעס	שײַכות
שײַלע	שאלה
שײַלעס־אוטשוּװעס	שאלות־ותּשובֿות
שײַלעס־האָרײע	שאלת־הריאה
שײַלעס־טשוּװע	שאלת־תּשובֿה
שײַלעס־טשוּװעס	שאלות־תּשובֿות
שײַלעס־נאָשים	שאלת־נשים
שײמע	שײמע
שײמעס	שײמע
שײמעס	שם
שײמעס	שמות
שײניס	שנית
שײַנע	הושענא
שײנע־לעמאַלכעס	שני־למלכות
שײנע־לעמײלעך	שני־למלך
שײנעס	שנית
שײַנע־ראַבע	הושענא־רבה
שײנע־שעבעשלישי	שני־שבשלישי
שײַע	שעיה
שײַעך	שײך
שײרבאָסער	שאר־בשׂר
שײרעס	שארית
שײרעס־האַפּלײטע	שארית־הפּליטה
שײשעס־יעמײ־ברײשעס	ששת־ימי־בראשית
שילעמען	שילמען
שילשל	שילשול
שימען	שמעון
שימען באַר־יעכײַ	שמעון בר־יוחאי
שימענעסרע	שמונה־עשׂרה
שימשן	שמשון
שימשן האַגיבער	שמשון הגיבור
שין	ש
שין	שין
שינױִם	שינױ
שינע	שינױ
שינע־מאָקעם	שינױ־מקום
שינעשעם	שינױ־שם
שיִעס	שהיות
שיִע־פּיִע	שהי־פּהי
שיִער	שיעור
שיפּױִם	שיפּוע
שיפּוע	שיפּוע
שיפֿכע	שיפֿחה
שיפֿכע־באַלשעמטאָװ	שבֿחי־בעל־שם־טובֿ
שיפֿכע־האַבעשט	שבֿחי־הבעש״ט
שיפֿלעס	שיפֿלות
שיפֿרע	שפֿרה
שיקאָרניצע	שכּורניצע
שיקאָרניק	שכּורניק
שיקורים	שיכּור
שיקכע	שיכּחה
שיקעץ־מעשױמעם	שיקוץ־משומם
שיקער	שיכּור
שיקער	שיכּור
שיקערטע	שיכּורטע
שיקערן	שיכּורן
שיקרעס	שיכּרות
שיקרעס	שיקרות
שיר	שיר
שיראַיִם	שירײם
שיר־(ה)אַמײַלעס	שיר־המעלות
שיר־(ה)אַשירים	שיר־השירים
שירים־װעטישבאָכעס	שירים־ותּשבחות
שירע	שירה
שישי	שישי
שישים	שישים
שישים ריבױ	שישים ריבוא
שישע־נײרעס	שישה־נרות
שישע ס(ע)דאָרים	ש״ס: שישה סדרים
שכיװמעראַ	שכיבֿ־מרע
שכיטע	שחיטה
שכיטעס־כולין	שחיטת־חולין
שכיטעס־כוץ	שחיטת־חוץ
שכײנים	שכן
שכײניש	שכניש
שכײנע	שכנה
שכײנעס	שכנות
שכײנעסדיק	שכנותדיק
שכין	דצ״ך עד״ש באח״ב: שחין
שכינע	שכינה
שכיִעך	שכיח
שלאַך	שלח
שלאַכמאָנעס	שלח־מנות
שלאַל	שלל
שלאָסמעם	מם: שלאָס־מם
שלױמע	שלמה
שלױמע האַמײלעך	שלמה המלך
שלױשים	שלושים
שלױשע־דװאָרים	שלשה־דבֿרים
שלױשעס־יעמײ־האַגבאָלע	שלשת־ימי־הגבלה
שלוכים	שליח
שלוכים־מעיוכאָדים	שליח־מיוחד
שלוכע־דעראַבאָנען	שד״ר: שלוחא־דרבנן
שלוכע־ציבער	שליח־ציבור
שלומיִעל	שלומיאל
שליטע	שליט״א
שליטע	שליטה
שלײמעס	שלמות
שליכים	שליח
שליכים־מעיוכאָדים	שליח־מיוחד
שליכעס	שליחות
שליכע־ציבער	שליח־ציבור
שלימאַזל	שלימזל
שלימאַזל	שלימזל
שלימעזאַלניצע	שלימזלניצע
שלימעזאַלניק	שלימזלניק
שלימ־שלימאַזל	שלים־שלימזל
שלישי	שלישי
שלישים	שליש
שלישעס	שלישות
שמאַד	שמד
שמאַדיש	שמדיש
שמאַדן	שמדן
שמאַדניצע	שמדניצע
שמאַדניק	שמדניק
שמאַדעלניצע	שמדעלניצע
שמאַדעלניק	שמדעלניק
שמאַדקײט	שמדקײט
שמאַטשטיק	שמד־שטיק
שמאַ־ײִסראָעל	שמע־ישׂראל
שמאַ־קױלײנו	שמע־קולנו
שמאַקעלײנע	שמע־קולנו
שמאַריע	שמריה(ו)
שמױנים	שמונים
שמױנע	שמונה
שמױס	שמות
שמױס־האַטומע	שמות־הטומאה
שמוע	שמועה
שמועל	שמואל
שמועל האַנאָװי	שמואל הנבֿיא
שמורע	שמורה
שמורעמאַצע	שמורה־מצה
שמורעניק	שמורהניק
שמיטע	שמיטה
שמײַע	שמעיה
שמײַען	שמעיהן
שמינאַצערעס	שמיני־עצרת
שמיני	שמיני
שמיניס־שעבעשמיניס	שמינית־שבשמינית
שמיִע	שמיעה
שמירע	שמירה
שנאָדערן	שנדרן
שנאַיִם	שנים
שנאַס	שנת
שנאַס־באַצױרעס	שנת־בצורת
שנײ	שני
שנײ לוכעס האַבריס	של״ה: שני לוחות הברית
שנײער	שניאור
שע…	ש…
שעאָרים	שער
שעבאַ…	שב…
שעבאַלפּע	שבעל־פּה
שעביקסאַװ	שבכּתבֿ
שעבע…	שב…
שעד	שד
שעדעכע	שדיכע
שעהאַקל	שהכּל
שעװאַך	שבֿח
שעװע	שבֿע
שעװע־בראָכעס	שבֿע־ברכות
שעװע־בראָכעס	שבֿע־ברכות
שעװעך	שבֿח
שעװע־כאָכמעס	שבֿע־חכמות
שעװעס־אַכים	שבֿת־אַחים
שעװער	שבֿר
שעטיכיע	שתּחיה
שעטעך	שטח
שעײִכיע לעױרעך יאָמים טױװים אָמײן	שליט״א: שיחיה לאורך ימים טובֿים אָמן
שעײן מאַקירן	שאין מכּירין
שעײנע־יעדײע־לישױל	שאינו־יודע־לשאול
שעײן קױכעם עלאָ בעפֿיהעם	שאין כּוחם אלא בפֿיהם
שעכטן	שחטן
שעכעיאָנו	שהחײנו
שעל	של
שעלאַ	של״ה
שעלאַ־האַקאָדעש	של״ה: דער של״ה־הקדוש
שעלאָך	שלך
שעלױ	שלא־
שעלױ־לעװײַעש	שלא־לבֿײש
שעלױ־מין־האַײִשעװ	שלא־מן־הישובֿ
שעלױ־קעדערעך־האַטעװע	שלא־כּדרך־הטבֿע
שעלי	שלי
שעליאַד	של־יד
שעליטע	שליט״א
שעליִעך	שליח
שעליִעך־מעיוכעד	שליח־מיוחד
שעליִעך־ציבער	שליח־ציבור
שעלי שעלאָך שעלכאָ שעלי	שלי שלך שלך שלי
שעלי שעלי שעלכאָ שעלאָך	שלי שלי שלך שלך
שעלכאָ	שלך
שעלראָש	של־ראָש
שעם	שם
שעם	שם
שעמאַ	שמא
שעמדאָװער	שם־דבֿר
שעם־האַװײַע	שם־הװיה
שעם־האַמפֿױרעש	שם־המפֿורש
שעמטאָװ	שם־טובֿ
שעמען	שמען
שעמען־זאַיִס	שמן־זית
שעמען־זאַיִסדיק	שמן־זיתדיק
שעמעץ	שמץ
שעמראַ	שם־רע
שענאָדערן	שנדרן
שעסאַ	שס״ה
שעסאַ גידן	שס״ה גידין
שעסי־װאָערעװ	שתי־וערבֿ
שעפֿע	שפֿע
שעקל	שקל
שעקער	שקר
שעקער־װעקאָזעװ	שקר־וכּזבֿ
שעקער־װעשלימאַזל	שקר: שקר־ושלימזל
שעראָשים	שורש
שערעץ	שרץ
שפֿױכאַמאָסכע	שפֿוך־חמתך
שפֿױך־כאַמאָסכאָ	שפֿוך־חמתך
שפֿיכעס־דאָמים	שפֿיכת־דמים
שקאָלים	שקל
שקאָלים	שקלים
שקאָץ	שקאָץ
שקאָצים	שײגעץ
שקאָצים	שקאָץ
שקאָרים	שקר
שקאָרים־אוכזאָװים	שקר־וכּזבֿ
שקױעך	ײשר־כּוח
שקיִע	שקיעה
שקיִעס־האַכאַמע	שקיעת־החמה
שראַגע	שרגא
שראָצים	שרץ
שרוּיע	שרױה
