'בטלן'	' ב ט ל ן '
'הענדום'	' ה ע נ ד ו ם '
'וואלוול'	' ו ו א ל ו ו ל '
'זיצן'	' ז י צ ן '
'טאנאך'	' ט א נ א ך '
'ס'	' ס '
'סכנה'	' ס כ נ ה '
'סמך'	' ס מ ך '
'עט'	' ע ט '
'פכע'	' פ כ ע '
'פענדום'	' פ ע נ ד ו ם '
'פש'	' פ ש '
־איר	־ א י ר
־דער	־ ד ע ר
־וואס	־ ו ו א ס
א	א
א'	א '
א־אין	א ־ א י ן
אב־בית־דין	א ב ־ ב י ת ־ ד י ן
אבה	א ב ה
אבות־אבותינו	א ב ו ת ־ א ב ו ת י נ ו
אבי	א ב י
אבי־ווער	א ב י ־ ו ו ע ר
אבינו	א ב י נ ו
אביסק	א ב י ס ק
אבן	א ב ן
אבן־טוב	א ב ן ־ ט ו ב
אבער	א ב ע ר
אבר	א ב ר
אבראקאדאברא	א ב ר א ק א ד א ב ר א
אברהם	א ב ר ה ם
אברים	א ב ר י ם
אגב	א ג ב
אגרעס	א ג ר ע ס
אדוואקאט	א ד ו ו א ק א ט
אדוואקאטן	א ד ו ו א ק א ט ן
אדון	א ד ו ן
אדורך	א ד ו ר ך
אדורכגעשפארט	א ד ו ר כ ג ע ש פ א ר ט
אדם	א ד ם
אדער	א ד ע ר
אדר	א ד ר
אדרבא	א ד ר ב א
אדרעס	א ד ר ע ס
אהא	א ה א
אהבת	א ה ב ת
אהיים	א ה י י ם
אהיימגיין	א ה י י מ ג י י ן
אהיימגעגאנגען	א ה י י מ ג ע ג א נ ג ע ן
אהיימגעקומען	א ה י י מ ג ע ק ו מ ע ן
אהיימגעשיקט	א ה י י מ ג ע ש י ק ט
אהיימצוגיין	א ה י י מ צ ו ג י י ן
אהיימצוקומען	א ה י י מ צ ו ק ו מ ע ן
אהין	א ה י ן
אהינגעקומען	א ה י נ ג ע ק ו מ ע ן
אהער	א ה ע ר
אהערפארנדיק	א ה ע ר פ א ר נ ד י ק
אוגערקע	א ו ג ע ר ק ע
אודאי	א ו ד א י
אוהב	א ו ה ב
אוודאי	א ו ו ד א י
אוונט	א ו ו נ ט
אוונט־ווינטל	א ו ו נ ט ־ ו ו י נ ט ל
אוונטן	א ו ו נ ט ן
אוועק	א ו ו ע ק
אוועקגיין	א ו ו ע ק ג י י ן
אוועקגעבן	א ו ו ע ק ג ע ב ן
אוועקגעגאנגען	א ו ו ע ק ג ע ג א נ ג ע ן
אוועקגעגעבן	א ו ו ע ק ג ע ג ע ב ן
אוועקגעזעצט	א ו ו ע ק ג ע ז ע צ ט
אוועקגעחלשט	א ו ו ע ק ג ע ח ל ש ט
אוועקגעלייגט	א ו ו ע ק ג ע ל י י ג ט
אוועקגענומען	א ו ו ע ק ג ע נ ו מ ע ן
אוועקגעפאלן	א ו ו ע ק ג ע פ א ל ן
אוועקגעפירט	א ו ו ע ק ג ע פ י ר ט
אוועקגערופן	א ו ו ע ק ג ע ר ו פ ן
אוועקגעשטעלט	א ו ו ע ק ג ע ש ט ע ל ט
אוועקזעצן	א ו ו ע ק ז ע צ ן
אוועקיאגן	א ו ו ע ק י א ג ן
אוועקלאזן	א ו ו ע ק ל א ז ן
אוועקמאכן	א ו ו ע ק מ א כ ן
אוועקפליען	א ו ו ע ק פ ל י ע ן
אוועקצוגיין	א ו ו ע ק צ ו ג י י ן
אוועקצורוקן	א ו ו ע ק צ ו ר ו ק ן
אוועקצורייסן	א ו ו ע ק צ ו ר י י ס ן
אוועקשליידערן	א ו ו ע ק ש ל י י ד ע ר ן
אויב	א ו י ב
אויבן	א ו י ב ן
אויבן־אן	א ו י ב ן ־ א ן
אויבנאן	א ו י ב נ א ן
אויבערהאר	א ו י ב ע ר ה א ר
אויבערפלעכע	א ו י ב ע ר פ ל ע כ ע
אויבערשטער	א ו י ב ע ר ש ט ע ר
אויג	א ו י ג
אויגן	א ו י ג ן
אויגעלעך	א ו י ג ע ל ע ך
אויוון	א ו י ו ו ן
אויוון־אן	א ו י ו ו ן ־ א ן
אויך	א ו י ך
אויס	א ו י ס
אויס־און	א ו י ס ־ א ו ן
אויסבילדעווען	א ו י ס ב י ל ד ע ו ו ע ן
אויסבעסערונגען	א ו י ס ב ע ס ע ר ו נ ג ע ן
אויסגיין	א ו י ס ג י י ן
אויסגעבויגן	א ו י ס ג ע ב ו י ג ן
אויסגעבויט	א ו י ס ג ע ב ו י ט
אויסגעבראכן	א ו י ס ג ע ב ר א כ ן
אויסגעברענט	א ו י ס ג ע ב ר ע נ ט
אויסגעגאנגען	א ו י ס ג ע ג א נ ג ע ן
אויסגעגאסן	א ו י ס ג ע ג א ס ן
אויסגעגלאצטע	א ו י ס ג ע ג ל א צ ט ע
אויסגעגראבן	א ו י ס ג ע ג ר א ב ן
אויסגעדינטער	א ו י ס ג ע ד י נ ט ע ר
אויסגעהאלטן	א ו י ס ג ע ה א ל ט ן
אויסגעהערט	א ו י ס ג ע ה ע ר ט
אויסגעוואקסן	א ו י ס ג ע ו ו א ק ס ן
אויסגעוויזן	א ו י ס ג ע ו ו י ז ן
אויסגעווען	א ו י ס ג ע ו ו ע ן
אויסגעזען	א ו י ס ג ע ז ע ן
אויסגעטראכט	א ו י ס ג ע ט ר א כ ט
אויסגעטרייסלט	א ו י ס ג ע ט ר י י ס ל ט
אויסגעטריקנט	א ו י ס ג ע ט ר י ק נ ט
אויסגעלאזט	א ו י ס ג ע ל א ז ט
אויסגעלייזט	א ו י ס ג ע ל י י ז ט
אויסגעלייזטן	א ו י ס ג ע ל י י ז ט ן
אויסגעלערנט	א ו י ס ג ע ל ע ר נ ט
אויסגעמאלט	א ו י ס ג ע מ א ל ט
אויסגעמיטן	א ו י ס ג ע מ י ט ן
אויסגעמישט	א ו י ס ג ע מ י ש ט
אויסגעניכטערט	א ו י ס ג ע נ י כ ט ע ר ט
אויסגעפאטשט	א ו י ס ג ע פ א ט ש ט
אויסגעפאלן	א ו י ס ג ע פ א ל ן
אויסגעפאלענע	א ו י ס ג ע פ א ל ע נ ע
אויסגעפירט	א ו י ס ג ע פ י ר ט
אויסגעפרוירן	א ו י ס ג ע פ ר ו י ר ן
אויסגעצויגן	א ו י ס ג ע צ ו י ג ן
אויסגעצייכנט	א ו י ס ג ע צ י י כ נ ט
אויסגעקוילעט	א ו י ס ג ע ק ו י ל ע ט
אויסגעקליבן	א ו י ס ג ע ק ל י ב ן
אויסגעקערט	א ו י ס ג ע ק ע ר ט
אויסגעקערעוועט	א ו י ס ג ע ק ע ר ע ו ו ע ט
אויסגעקראצט	א ו י ס ג ע ק ר א צ ט
אויסגערוט	א ו י ס ג ע ר ו ט
אויסגערופן	א ו י ס ג ע ר ו פ ן
אויסגעריסן	א ו י ס ג ע ר י ס ן
אויסגערעדט	א ו י ס ג ע ר ע ד ט
אויסגעשטודירט	א ו י ס ג ע ש ט ו ד י ר ט
אויסגעשטעלט	א ו י ס ג ע ש ט ע ל ט
אויסגעשטעלטע	א ו י ס ג ע ש ט ע ל ט ע
אויסגעשטערנט	א ו י ס ג ע ש ט ע ר נ ט
אויסגעשטרעקט	א ו י ס ג ע ש ט ר ע ק ט
אויסגעשלאגן	א ו י ס ג ע ש ל א ג ן
אויסגעשלעפט	א ו י ס ג ע ש ל ע פ ט
אויסגעשמירט	א ו י ס ג ע ש מ י ר ט
אויסגעשפאנט	א ו י ס ג ע ש פ א נ ט
אויסגעשפיגן	א ו י ס ג ע ש פ י ג ן
אויסדערציילן	א ו י ס ד ע ר צ י י ל ן
אויסהאלטן	א ו י ס ה א ל ט ן
אויסהערן	א ו י ס ה ע ר ן
אויסווייניק	א ו י ס ו ו י י נ י ק
אויסזוכן	א ו י ס ז ו כ ן
אויסזיצן	א ו י ס ז י צ ן
אויסטאן	א ו י ס ט א ן
אויסטענהן	א ו י ס ט ע נ ה ן
אויסטערליש	א ו י ס ט ע ר ל י ש
אויסטערליש־ווונדערלעכע	א ו י ס ט ע ר ל י ש ־ ו ו ו נ ד ע ר ל ע כ ע
אויסטערלישע	א ו י ס ט ע ר ל י ש ע
אויסטערלישער	א ו י ס ט ע ר ל י ש ע ר
אויסטראכטענישן	א ו י ס ט ר א כ ט ע נ י ש ן
אויסלאזן	א ו י ס ל א ז ן
אויסלאנד	א ו י ס ל א נ ד
אויסלייגן	א ו י ס ל י י ג ן
אויסלייגעכץ־רעפארמען	א ו י ס ל י י ג ע כ ץ ־ ר ע פ א ר מ ע ן
אויסלערנען	א ו י ס ל ע ר נ ע ן
אויסמיידנדיק	א ו י ס מ י י ד נ ד י ק
אויסן	א ו י ס ן
אויסנווייניק	א ו י ס נ ו ו י י נ י ק
אויסנייען	א ו י ס נ י י ע ן
אויסניכטערן	א ו י ס נ י כ ט ע ר ן
אויסנעמעניש	א ו י ס נ ע מ ע נ י ש
אויסער	א ו י ס ע ר
אויספארשן	א ו י ס פ א ר ש ן
אויספירן	א ו י ס פ י ר ן
אויספרווון	א ו י ס פ ר ו ו ו ן
אויסצאלן	א ו י ס צ א ל ן
אויסצובעטלען	א ו י ס צ ו ב ע ט ל ע ן
אויסצולערנען	א ו י ס צ ו ל ע ר נ ע ן
אויסצורעדן	א ו י ס צ ו ר ע ד ן
אויסציען	א ו י ס צ י ע ן
אויסקויקלען	א ו י ס ק ו י ק ל ע ן
אויסקומען	א ו י ס ק ו מ ע ן
אויסקערן	א ו י ס ק ע ר ן
אויסרוען	א ו י ס ר ו ע ן
אויסריידן	א ו י ס ר י י ד ן
אויסרייסן	א ו י ס ר י י ס ן
אויסרעדן	א ו י ס ר ע ד ן
אויסרעכענען	א ו י ס ר ע כ ע נ ע ן
אויסשטיין	א ו י ס ש ט י י ן
אויסשטרעקנדיק	א ו י ס ש ט ר ע ק נ ד י ק
אויסשלאגן	א ו י ס ש ל א ג ן
אויסשלייפן	א ו י ס ש ל י י פ ן
אויער	א ו י ע ר
אויערן	א ו י ע ר ן
אויף	א ו י ף
אויפבויען	א ו י פ ב ו י ע ן
אויפגעבויט	א ו י פ ג ע ב ו י ט
אויפגעגעסן	א ו י פ ג ע ג ע ס ן
אויפגעגעסענע	א ו י פ ג ע ג ע ס ע נ ע
אויפגעדעקט	א ו י פ ג ע ד ע ק ט
אויפגעהאלטן	א ו י פ ג ע ה א ל ט ן
אויפגעהויבן	א ו י פ ג ע ה ו י ב ן
אויפגעהערט	א ו י פ ג ע ה ע ר ט
אויפגעוועקט	א ו י פ ג ע ו ו ע ק ט
אויפגעזאמלט	א ו י פ ג ע ז א מ ל ט
אויפגעטרייסלט	א ו י פ ג ע ט ר י י ס ל ט
אויפגעכאפט	א ו י פ ג ע כ א פ ט
אויפגעלאפן	א ו י פ ג ע ל א פ ן
אויפגעלייגט	א ו י פ ג ע ל י י ג ט
אויפגעלעבט	א ו י פ ג ע ל ע ב ט
אויפגענייט	א ו י פ ג ע נ י י ט
אויפגעפוצט	א ו י פ ג ע פ ו צ ט
אויפגעקומענער	א ו י פ ג ע ק ו מ ע נ ע ר
אויפגערוימט	א ו י פ ג ע ר ו י מ ט
אויפגערופן	א ו י פ ג ע ר ו פ ן
אויפגעריכט	א ו י פ ג ע ר י כ ט
אויפגעשטאנען	א ו י פ ג ע ש ט א נ ע ן
אויפגעשטעלטע	א ו י פ ג ע ש ט ע ל ט ע
אויפגעשיינט	א ו י פ ג ע ש י י נ ט
אויפגעשריבן	א ו י פ ג ע ש ר י ב ן
אויפהייבן	א ו י פ ה י י ב ן
אויפהענגען	א ו י פ ה ע נ ג ע ן
אויפהער	א ו י פ ה ע ר
אויפהערן	א ו י פ ה ע ר ן
אויפכאפן	א ו י פ כ א פ ן
אויפלאג	א ו י פ ל א ג
אויפן	א ו י פ ן
אויפנייען	א ו י פ נ י י ע ן
אויפצוהויבן	א ו י פ צ ו ה ו י ב ן
אויפצוהערן	א ו י פ צ ו ה ע ר ן
אויפצוזעצן	א ו י פ צ ו ז ע צ ן
אויפצוכאווען	א ו י פ צ ו כ א ו ו ע ן
אויפצורופן	א ו י פ צ ו ר ו פ ן
אויפצוריכטן	א ו י פ צ ו ר י כ ט ן
אויפצושטיין	א ו י פ צ ו ש ט י י ן
אויפקלערן	א ו י פ ק ל ע ר ן
אויפשטיין	א ו י פ ש ט י י ן
אויפשיין	א ו י פ ש י י ן
אויפשיינען	א ו י פ ש י י נ ע ן
אוירינגל	א ו י ר י נ ג ל
אום	א ו ם
אומאן	א ו מ א ן
אומאנער	א ו מ א נ ע ר
אומבאשרייבלעך	א ו מ ב א ש ר י י ב ל ע ך
אומגליק	א ו מ ג ל י ק
אומגליקלעכער	א ו מ ג ל י ק ל ע כ ע ר
אומגליקן	א ו מ ג ל י ק ן
אומגעדולדיקער	א ו מ ג ע ד ו ל ד י ק ע ר
אומגעזוכט	א ו מ ג ע ז ו כ ט
אומגעלומפערטן	א ו מ ג ע ל ו מ פ ע ר ט ן
אומגעלומפערטע	א ו מ ג ע ל ו מ פ ע ר ט ע
אומגעקערט	א ו מ ג ע ק ע ר ט
אומגעריכט	א ו מ ג ע ר י כ ט
אומגערעכט	א ו מ ג ע ר ע כ ט
אומדרייען	א ו מ ד ר י י ע ן
אומהיימלעך	א ו מ ה י י מ ל ע ך
אומזיסט	א ו מ ז י ס ט
אומזיסטינע	א ו מ ז י ס ט י נ ע
אומחן	א ו מ ח ן
אומיסטן	א ו מ י ס ט ן
אומכבוד	א ו מ כ ב ו ד
אוממעגלעך	א ו מ מ ע ג ל ע ך
אומעטום	א ו מ ע ט ו ם
אומעטיק	א ו מ ע ט י ק
אומעטיקע	א ו מ ע ט י ק ע
אומריינע	א ו מ ר י י נ ע
אומשלעפן	א ו מ ש ל ע פ ן
און	א ו ן
אונ	א ו נ
אונגעריכט	א ו נ ג ע ר י כ ט
אונדז	א ו נ ד ז
אונדזער	א ו נ ד ז ע ר
אונדזערע	א ו נ ד ז ע ר ע
אונטן	א ו נ ט ן
אונטער	א ו נ ט ע ר
אונטער־געסל	א ו נ ט ע ר ־ ג ע ס ל
אונטער־עסל	א ו נ ט ע ר ־ ע ס ל
אונטערגיין	א ו נ ט ע ר ג י י ן
אונטערגעבן	א ו נ ט ע ר ג ע ב ן
אונטערגעגאנגען	א ו נ ט ע ר ג ע ג א נ ג ע ן
אונטערגעהאלפן	א ו נ ט ע ר ג ע ה א ל פ ן
אונטערגעווארפן	א ו נ ט ע ר ג ע ו ו א ר פ ן
אונטערגעכאפט	א ו נ ט ע ר ג ע כ א פ ט
אונטערגעצונדן	א ו נ ט ע ר ג ע צ ו נ ד ן
אונטערגעשריבן	א ו נ ט ע ר ג ע ש ר י ב ן
אונטערהוסטן	א ו נ ט ע ר ה ו ס ט ן
אונטערזוכט	א ו נ ט ע ר ז ו כ ט
אונטערחתמענען	א ו נ ט ע ר ח ת מ ע נ ע ן
אונטערן	א ו נ ט ע ר ן
אונטערצוהעלפן	א ו נ ט ע ר צ ו ה ע ל פ ן
אונטערצינדן	א ו נ ט ע ר צ י נ ד ן
אונטערשערן	א ו נ ט ע ר ש ע ר ן
אונטערשרייבן	א ו נ ט ע ר ש ר י י ב ן
אוניווערסיטעט	א ו נ י ו ו ע ר ס י ט ע ט
אונקוקן	א ו נ ק ו ק ן
אופן	א ו פ ן
אוצר	א ו צ ר
אוצרות	א ו צ ר ו ת
אור	א ו ר
אורח	א ו ר ח
אורחים	א ו ר ח י ם
אותיות	א ו ת י ו ת
אז	א ז
אזא	א ז א
אזדוביסטאן	א ז ד ו ב י ס ט א ן
אזוי	א ז ו י
אזוינס	א ז ו י נ ס
אזוינע	א ז ו י נ ע
אזוינעם	א ז ו י נ ע ם
אזוינער	א ז ו י נ ע ר
אזעלכע	א ז ע ל כ ע
אזעלכענע	א ז ע ל כ ע נ ע
אזעלכער	א ז ע ל כ ע ר
אזש	א ז ש
אחדות	א ח ד ו ת
אחוץ	א ח ו ץ
אחים	א ח י ם
אחינו	א ח י נ ו
אחר	א ח ר
אט	א ט
אט־דא	א ט ־ ד א
אטבער	א ט ב ע ר
אטעם	א ט ע ם
אטעמט	א ט ע מ ט
אטעמען	א ט ע מ ע ן
אטעסטאט	א ט ע ס ט א ט
אטשערעדע	א ט ש ע ר ע ד ע
אי	א י
איבער	א י ב ע ר
איבעראל	א י ב ע ר א ל
איבערבעט	א י ב ע ר ב ע ט
איבערבעטן	א י ב ע ר ב ע ט ן
איבערגיין	א י ב ע ר ג י י ן
איבערגעבויגן	א י ב ע ר ג ע ב ו י ג ן
איבערגעבן	א י ב ע ר ג ע ב ן
איבערגעבראכן	א י ב ע ר ג ע ב ר א כ ן
איבערגעגעבן	א י ב ע ר ג ע ג ע ב ן
איבערגעדרוקט	א י ב ע ר ג ע ד ר ו ק ט
איבערגעדרייט	א י ב ע ר ג ע ד ר י י ט
איבערגעזונגען	א י ב ע ר ג ע ז ו נ ג ע ן
איבערגעזען	א י ב ע ר ג ע ז ע ן
איבערגעזעצט	א י ב ע ר ג ע ז ע צ ט
איבערגעחזרט	א י ב ע ר ג ע ח ז ר ט
איבערגעלאזט	א י ב ע ר ג ע ל א ז ט
איבערגעלייגט	א י ב ע ר ג ע ל י י ג ט
איבערגעלעבט	א י ב ע ר ג ע ל ע ב ט
איבערגעלעגטע	א י ב ע ר ג ע ל ע ג ט ע
איבערגענומען	א י ב ע ר ג ע נ ו מ ע ן
איבערגעפאלן	א י ב ע ר ג ע פ א ל ן
איבערגעפארן	א י ב ע ר ג ע פ א ר ן
איבערגעקוקט	א י ב ע ר ג ע ק ו ק ט
איבערגעקלונגען	א י ב ע ר ג ע ק ל ו נ ג ע ן
איבערגעקערט	א י ב ע ר ג ע ק ע ר ט
איבערגעקריגט	א י ב ע ר ג ע ק ר י ג ט
איבערגעריסן	א י ב ע ר ג ע ר י ס ן
איבערגערעכנט	א י ב ע ר ג ע ר ע כ נ ט
איבערגעשפיצטער	א י ב ע ר ג ע ש פ י צ ט ע ר
איבערגעשריגן	א י ב ע ר ג ע ש ר י ג ן
איבערהויפט	א י ב ע ר ה ו י פ ט
איבערחזרן	א י ב ע ר ח ז ר ן
איבערטון	א י ב ע ר ט ו ן
איבערטראכטן	א י ב ע ר ט ר א כ ט ן
איבעריק	א י ב ע ר י ק
איבעריקן	א י ב ע ר י ק ן
איבעריקס	א י ב ע ר י ק ס
איבערלאזן	א י ב ע ר ל א ז ן
איבערלייענען	א י ב ע ר ל י י ע נ ע ן
איבערמארגן	א י ב ע ר מ א ר ג ן
איבערן	א י ב ע ר ן
איבערנעכטיקן	א י ב ע ר נ ע כ ט י ק ן
איבערנעמען	א י ב ע ר נ ע מ ע ן
איבערפילט	א י ב ע ר פ י ל ט
איבערפרעגן	א י ב ע ר פ ר ע ג ן
איבערצוג	א י ב ע ר צ ו ג
איבערצולאזן	א י ב ע ר צ ו ל א ז ן
איבערצונעכטיקן	א י ב ע ר צ ו נ ע כ ט י ק ן
איבערצוקומען	א י ב ע ר צ ו ק ו מ ע ן
איבערקוקן	א י ב ע ר ק ו ק ן
איבערקלייבערין	א י ב ע ר ק ל י י ב ע ר י ן
איבעררעדן	א י ב ע ר ר ע ד ן
איבערשמועסן	א י ב ע ר ש מ ו ע ס ן
איבערשפארן	א י ב ע ר ש פ א ר ן
איוב	א י ו ב
איוואן	א י ו ו א ן
איז	א י ז
איזוואשטשיקעס	א י ז ו ו א ש ט ש י ק ע ס
איזשביצער	א י ז ש ב י צ ע ר
איטלעכן	א י ט ל ע כ ן
איטלעכע	א י ט ל ע כ ע
איטלעכער	א י ט ל ע כ ע ר
איטע	א י ט ע
איטשע	א י ט ש ע
איי	א י י
אייאושדיקער	א י י א ו ש ד י ק ע ר
אייביק	א י י ב י ק
אייביקע	א י י ב י ק ע
אייבערשטן	א י י ב ע ר ש ט ן
אייגנטלעך	א י י ג נ ט ל ע ך
אייגנס	א י י ג נ ס
אייגעלעך	א י י ג ע ל ע ך
אייגענע	א י י ג ע נ ע
אייגענעם	א י י ג ע נ ע ם
אייגענער	א י י ג ע נ ע ר
איידל	א י י ד ל
איידלען	א י י ד ל ע ן
איידלער	א י י ד ל ע ר
איידלקייט	א י י ד ל ק י י ט
איידעלן	א י י ד ע ל ן
איידעלע	א י י ד ע ל ע
איידעלער	א י י ד ע ל ע ר
איידעם	א י י ד ע ם
איידעמס	א י י ד ע מ ס
איידער	א י י ד ע ר
אייז	א י י ז
אייזיק	א י י ז י ק
אייזיק־מאיר	א י י ז י ק ־ מ א י ר
אייזל־קאפ	א י י ז ל ־ ק א פ
אייזערן	א י י ז ע ר ן
אייך	א י י ך
איילן	א י י ל ן
איילנדיקע	א י י ל נ ד י ק ע
איילסטו	א י י ל ס ט ו
איילעניש	א י י ל ע נ י ש
איין	א י י ן
איינגיין	א י י נ ג י י ן
איינגעארדנט	א י י נ ג ע א ר ד נ ט
איינגעבעטן	א י י נ ג ע ב ע ט ן
איינגעבראכן	א י י נ ג ע ב ר א כ ן
איינגעגאנגען	א י י נ ג ע ג א נ ג ע ן
איינגעגעבן	א י י נ ג ע ג ע ב ן
איינגעגעסענע	א י י נ ג ע ג ע ס ע נ ע
איינגעדרעמלט	א י י נ ג ע ד ר ע מ ל ט
איינגעהאלטן	א י י נ ג ע ה א ל ט ן
איינגעהאנדלט	א י י נ ג ע ה א נ ד ל ט
איינגעהויקערט	א י י נ ג ע ה ו י ק ע ר ט
איינגעהערט	א י י נ ג ע ה ע ר ט
איינגעוווינט	א י י נ ג ע ו ו ו י נ ט
איינגעוויגט	א י י נ ג ע ו ו י ג ט
איינגעוויקלט	א י י נ ג ע ו ו י ק ל ט
איינגעזונקען	א י י נ ג ע ז ו נ ק ע ן
איינגעלאדן	א י י נ ג ע ל א ד ן
איינגעלייגט	א י י נ ג ע ל י י ג ט
איינגעמאכץ	א י י נ ג ע מ א כ ץ
איינגענומען	א י י נ ג ע נ ו מ ע ן
איינגעעקשנט	א י י נ ג ע ע ק ש נ ט
איינגעפאלן	א י י נ ג ע פ א ל ן
איינגעפינען	א י י נ ג ע פ י נ ע ן
איינגעפלאנסט	א י י נ ג ע פ ל א נ ס ט
איינגערעדט	א י י נ ג ע ר ע ד ט
איינגעשטימט	א י י נ ג ע ש ט י מ ט
איינגעשלאפן	א י י נ ג ע ש ל א פ ן
איינגעשפאנט	א י י נ ג ע ש פ א נ ט
איינגעשפארט	א י י נ ג ע ש פ א ר ט
איינגעשרומפענע	א י י נ ג ע ש ר ו מ פ ע נ ע
איינגעשריבן	א י י נ ג ע ש ר י ב ן
איינדרוק	א י י נ ד ר ו ק
איינהאלטן	א י י נ ה א ל ט ן
איינהילן	א י י נ ה י ל ן
איינווייקן	א י י נ ו ו י י ק ן
איינזיצן	א י י נ ז י צ ן
אייניקל	א י י נ י ק ל
אייניקלעך	א י י נ י ק ל ע ך
אייננעמען	א י י נ נ ע מ ע ן
איינס	א י י נ ס
איינע	א י י נ ע
איינעם	א י י נ ע ם
איינעסן	א י י נ ע ס ן
איינער	א י י נ ע ר
איינפאל	א י י נ פ א ל
איינפאלן	א י י נ פ א ל ן
איינפירן	א י י נ פ י ר ן
איינפעדעמען	א י י נ פ ע ד ע מ ע ן
איינציק	א י י נ צ י ק
איינציקווייז	א י י נ צ י ק ו ו י י ז
איינציקן	א י י נ צ י ק ן
איינציקע	א י י נ צ י ק ע
איינציקער	א י י נ צ י ק ע ר
איינקויפן	א י י נ ק ו י פ ן
איינשטודירען	א י י נ ש ט ו ד י ר ע ן
איינשטעלן	א י י נ ש ט ע ל ן
איינשלאפן	א י י נ ש ל א פ ן
איינשפאנען	א י י נ ש פ א נ ע ן
אייער	א י י ע ר
אייערן	א י י ע ר ן
אייערנעכטיק	א י י ע ר נ ע כ ט י ק
אייערס	א י י ע ר ס
אייערע	א י י ע ר ע
אייערער	א י י ע ר ע ר
אייראפע	א י י ר א פ ע
איישישאק	א י י ש י ש א ק
איך	א י ך
אילון	א י ל ו ן
אים	א י ם
אים־ירצה־השם	א י ם ־ י ר צ ה ־ ה ש ם
אימה	א י מ ה
אימער	א י מ ע ר
אימשטאנד	א י מ ש ט א נ ד
אין	א י ן
אין־יעקב	א י ן ־ י ע ק ב
אינגעווייד	א י נ ג ע ו ו י י ד
אינדזל	א י נ ד ז ל
אינדיאנער	א י נ ד י א נ ע ר
אינדיטשקע	א י נ ד י ט ש ק ע
אינטעליגענץ	א י נ ט ע ל י ג ע נ ץ
אינטערעס	א י נ ט ע ר ע ס
אינטערעסאנט	א י נ ט ע ר ע ס א נ ט
אינטערעסאנטע	א י נ ט ע ר ע ס א נ ט ע
אינטערעסירט	א י נ ט ע ר ע ס י ר ט
אינטריגע	א י נ ט ר י ג ע
אינס	א י נ ס
אינסטיטוציעס	א י נ ס ט י ט ו צ י ע ס
אינסטרומענטן	א י נ ס ט ר ו מ ע נ ט ן
אינסינואציעס	א י נ ס י נ ו א צ י ע ס
אינעווייניק	א י נ ע ו ו י י נ י ק
אינעם	א י נ ע ם
איצט	א י צ ט
איצטיקע	א י צ ט י ק ע
איצטיקער	א י צ ט י ק ע ר
איצטער	א י צ ט ע ר
איר	א י ר
איר'ט	א י ר ' ט
איריקן	א י ר י ק ן
איריקע	א י ר י ק ע
אירן	א י ר ן
אירס	א י ר ס
אירע	א י ר ע
אירער	א י ר ע ר
איש	א י ש
אך	א ך
אכט	א כ ט
אכטונג	א כ ט ו נ ג
אכילה	א כ י ל ה
אכסניא	א כ ס נ י א
אכסניה	א כ ס נ י ה
אכציק	א כ צ י ק
אכצן	א כ צ ן
אכצנהונדערט	א כ צ נ ה ו נ ד ע ר ט
אל	א ל
אל־מלך־נאמן	א ל ־ מ ל ך ־ נ א מ ן
אל־פי	א ל ־ פ י
אלאבאסטער	א ל א ב א ס ט ע ר
אלדי	א ל ד י
אלט	א ל ט
אלט־אלט	א ל ט ־ א ל ט
אלטבאקאנטער	א ל ט ב א ק א נ ט ע ר
אלטן	א ל ט ן
אלטס	א ל ט ס
אלטע	א ל ט ע
אלטעלע	א ל ט ע ל ע
אלטער	א ל ט ע ר
אלטערטום־פארשער	א ל ט ע ר ט ו ם ־ פ א ר ש ע ר
אליהו	א ל י ה ו
אליין	א ל י י ן
אלמן	א ל מ ן
אלמנה	א ל מ נ ה
אלס	א ל ס
אלסדינג	א ל ס ד י נ ג
אלע	א ל ע
אלעם	א ל ע ם
אלעמען	א ל ע מ ע ן
אלעמענס	א ל ע מ ע נ ס
אלעס	א ל ע ס
אלעקסאנדער	א ל ע ק ס א נ ד ע ר
אלערליי	א ל ע ר ל י י
אלף	א ל ף
אלף־בית	א ל ף ־ ב י ת
אלץ	א ל ץ
אלצדינג	א ל צ ד י נ ג
אלשיך	א ל ש י ך
אם	א ם
אמאל	א מ א ל
אמאליקע	א מ א ל י ק ע
אמונה	א מ ו נ ה
אמן	א מ ן
אמער	א מ ע ר
אמעריקאניזירט	א מ ע ר י ק א נ י ז י ר ט
אמעריקאניזירן	א מ ע ר י ק א נ י ז י ר ן
אמעריקאניזם	א מ ע ר י ק א נ י ז ם
אמעריקאנער	א מ ע ר י ק א נ ע ר
אמעריקע	א מ ע ר י ק ע
אמת	א מ ת
אמת־זאגער	א מ ת ־ ז א ג ע ר
אמתדיק	א מ ת ד י ק
אמתן	א מ ת ן
אמתע	א מ ת ע
אמתער	א מ ת ע ר
אן	א ן
אנאנד	א נ א נ ד
אנארכיסט	א נ א ר כ י ס ט
אנבאטן	א נ ב א ט ן
אנבאלאנגט	א נ ב א ל א נ ג ט
אנבייסן	א נ ב י י ס ן
אנגיין	א נ ג י י ן
אנגעבאקן	א נ ג ע ב א ק ן
אנגעבויגן	א נ ג ע ב ו י ג ן
אנגעביסן	א נ ג ע ב י ס ן
אנגעגאנגען	א נ ג ע ג א נ ג ע ן
אנגעגאסן	א נ ג ע ג א ס ן
אנגעגרייט	א נ ג ע ג ר י י ט
אנגעדראלענע	א נ ג ע ד ר א ל ע נ ע
אנגעדרייט	א נ ג ע ד ר י י ט
אנגעהויבן	א נ ג ע ה ו י ב ן
אנגעהוייבן	א נ ג ע ה ו י י ב ן
אנגעוויזן	א נ ג ע ו ו י ז ן
אנגעזאגט	א נ ג ע ז א ג ט
אנגעזאלעט	א נ ג ע ז א ל ע ט
אנגעזליאקעט	א נ ג ע ז ל י א ק ע ט
אנגעזען	א נ ג ע ז ע ן
אנגעטאן	א נ ג ע ט א ן
אנגעטוענער	א נ ג ע ט ו ע נ ע ר
אנגעטראגן	א נ ג ע ט ר א ג ן
אנגעטראפן	א נ ג ע ט ר א פ ן
אנגעכאפט	א נ ג ע כ א פ ט
אנגעלייגט	א נ ג ע ל י י ג ט
אנגעלענט	א נ ג ע ל ע נ ט
אנגעמאכט	א נ ג ע מ א כ ט
אנגענומען	א נ ג ע נ ו מ ע ן
אנגעפאלן	א נ ג ע פ א ל ן
אנגעפאקט	א נ ג ע פ א ק ט
אנגעפארן	א נ ג ע פ א ר ן
אנגעפלויגן	א נ ג ע פ ל ו י ג ן
אנגעפעלצטע	א נ ג ע פ ע ל צ ט ע
אנגעפראפט	א נ ג ע פ ר א פ ט
אנגעצונדן	א נ ג ע צ ו נ ד ן
אנגעקומען	א נ ג ע ק ו מ ע ן
אנגעקלאפט	א נ ג ע ק ל א פ ט
אנגעקליבן	א נ ג ע ק ל י ב ן
אנגעקלעפט	א נ ג ע ק ל ע פ ט
אנגעקערט	א נ ג ע ק ע ר ט
אנגערופן	א נ ג ע ר ו פ ן
אנגערירט	א נ ג ע ר י ר ט
אנגעשוואלענע	א נ ג ע ש ו ו א ל ע נ ע
אנגעשטאפט	א נ ג ע ש ט א פ ט
אנגעשטויסן	א נ ג ע ש ט ו י ס ן
אנגעשמירטע	א נ ג ע ש מ י ר ט ע
אנגעשמעקט	א נ ג ע ש מ ע ק ט
אנגעשפארט	א נ ג ע ש פ א ר ט
אנגעשפיגן	א נ ג ע ש פ י ג ן
אנגעשריבן	א נ ג ע ש ר י ב ן
אנדער	א נ ד ע ר
אנדערטהאלבן	א נ ד ע ר ט ה א ל ב ן
אנדערן	א נ ד ע ר ן
אנדערע	א נ ד ע ר ע
אנדערער	א נ ד ע ר ע ר
אנדערש	א נ ד ע ר ש
אנהייב	א נ ה י י ב
אנהייצן	א נ ה י י צ ן
אנווינטשעווען	א נ ו ו י נ ט ש ע ו ו ע ן
אנוועזנדיקע	א נ ו ו ע ז נ ד י ק ע
אנוועזנדע	א נ ו ו ע ז נ ד ע
אנווענדן	א נ ו ו ע נ ד ן
אנווערן	א נ ו ו ע ר ן
אנומלט	א נ ו מ ל ט
אנומלטן	א נ ו מ ל ט ן
אנזעצער	א נ ז ע צ ע ר
אנחידושן	א נ ח י ד ו ש ן
אנטאן	א נ ט א ן
אנטגאנגען	א נ ט ג א נ ג ע ן
אנטדרעמלט	א נ ט ד ר ע מ ל ט
אנטיסעמיט	א נ ט י ס ע מ י ט
אנטיק	א נ ט י ק
אנטיקלעך	א נ ט י ק ל ע ך
אנטלאפן	א נ ט ל א פ ן
אנטלויף	א נ ט ל ו י ף
אנטלויפט	א נ ט ל ו י פ ט
אנטלויפן	א נ ט ל ו י פ ן
אנטלויפנדיק	א נ ט ל ו י פ נ ד י ק
אנטפלעקט	א נ ט פ ל ע ק ט
אנטקעגן	א נ ט ק ע ג ן
אנטקעגנגעשטעלט	א נ ט ק ע ג נ ג ע ש ט ע ל ט
אנטרויען	א נ ט ר ו י ע ן
אנטשלאפן	א נ ט ש ל א פ ן
אנטשליסן	א נ ט ש ל י ס ן
אנידער	א נ י ד ע ר
אנידערגעלייגט	א נ י ד ע ר ג ע ל י י ג ט
אנידערלייגן	א נ י ד ע ר ל י י ג ן
אניט	א נ י ט
אנכאפן	א נ כ א פ ן
אנלייגן	א נ ל י י ג ן
אנמעסטן	א נ מ ע ס ט ן
אננייען	א נ נ י י ע ן
אננעמען	א נ נ ע מ ע ן
אנעקדאטן	א נ ע ק ד א ט ן
אנערקענען	א נ ע ר ק ע נ ע ן
אנפאנג	א נ פ א נ ג
אנצוג	א נ צ ו ג
אנצוהויבן	א נ צ ו ה ו י ב ן
אנצוהערענישן	א נ צ ו ה ע ר ע נ י ש ן
אנצוזאגן	א נ צ ו ז א ג ן
אנצוטאן	א נ צ ו ט א ן
אנצוטאפן	א נ צ ו ט א פ ן
אנצוקומען	א נ צ ו ק ו מ ע ן
אנצוקוקן	א נ צ ו ק ו ק ן
אנצורופן	א נ צ ו ר ו פ ן
אנצינדן	א נ צ י נ ד ן
אנציען	א נ צ י ע ן
אנקוועלן	א נ ק ו ו ע ל ן
אנקומען	א נ ק ו מ ע ן
אנקוקן	א נ ק ו ק ן
אנשטאט	א נ ש ט א ט
אנשטאלט	א נ ש ט א ל ט
אנשיקעניש	א נ ש י ק ע נ י ש
אנשיקענישן	א נ ש י ק ע נ י ש ן
אנשל	א נ ש ל
אנשלאגן	א נ ש ל א ג ן
אנשלן	א נ ש ל ן
אנשלס	א נ ש ל ס
אנשרייבן	א נ ש ר י י ב ן
אסור	א ס ו ר
אסטר	א ס ט ר
אסטרא	א ס ט ר א
אסנע	א ס נ ע
אסרן	א ס ר ן
אסתר	א ס ת ר
אפ	א פ
אפאטעמען	א פ א ט ע מ ע ן
אפבייטן	א פ ב י י ט ן
אפבענטשן	א פ ב ע נ ט ש ן
אפגעאטעמט	א פ ג ע א ט ע מ ט
אפגעבן	א פ ג ע ב ן
אפגעברענט	א פ ג ע ב ר ע נ ט
אפגעגאנגען	א פ ג ע ג א נ ג ע ן
אפגעגאסן	א פ ג ע ג א ס ן
אפגעגילדטע	א פ ג ע ג י ל ד ט ע
אפגעגעסן	א פ ג ע ג ע ס ן
אפגעגריזשעטע	א פ ג ע ג ר י ז ש ע ט ע
אפגעדאוונט	א פ ג ע ד א ו ו נ ט
אפגעהאקטע	א פ ג ע ה א ק ט ע
אפגעהארעוועטער	א פ ג ע ה א ר ע ו ו ע ט ע ר
אפגעוויינען	א פ ג ע ו ו י י נ ע ן
אפגעווישט	א פ ג ע ו ו י ש ט
אפגעזאגט	א פ ג ע ז א ג ט
אפגעזעגנט	א פ ג ע ז ע ג נ ט
אפגעטאן	א פ ג ע ט א ן
אפגעטראטן	א פ ג ע ט ר א ט ן
אפגעטרונקען	א פ ג ע ט ר ו נ ק ע ן
אפגעטרייסלט	א פ ג ע ט ר י י ס ל ט
אפגעכאפט	א פ ג ע כ א פ ט
אפגעלאזט	א פ ג ע ל א ז ט
אפגעלאפן	א פ ג ע ל א פ ן
אפגעלייגט	א פ ג ע ל י י ג ט
אפגעלייזט	א פ ג ע ל י י ז ט
אפגעלייקנט	א פ ג ע ל י י ק נ ט
אפגעמאסטן	א פ ג ע מ א ס ט ן
אפגעמישפט	א פ ג ע מ י ש פ ט
אפגענארט	א פ ג ע נ א ר ט
אפגעענטפערט	א פ ג ע ע נ ט פ ע ר ט
אפגעפאלענע	א פ ג ע פ א ל ע נ ע
אפגעפאנפעט	א פ ג ע פ א נ פ ע ט
אפגעפארטיקט	א פ ג ע פ א ר ט י ק ט
אפגעפארן	א פ ג ע פ א ר ן
אפגעפוצטע	א פ ג ע פ ו צ ט ע
אפגעפרוירן	א פ ג ע פ ר ו י ר ן
אפגעצייכנט	א פ ג ע צ י י כ נ ט
אפגעקאסט	א פ ג ע ק א ס ט
אפגעקומען	א פ ג ע ק ו מ ע ן
אפגעקינדלט	א פ ג ע ק י נ ד ל ט
אפגעקלונגען	א פ ג ע ק ל ו נ ג ע ן
אפגעקערט	א פ ג ע ק ע ר ט
אפגערופן	א פ ג ע ר ו פ ן
אפגעריבענע	א פ ג ע ר י ב ע נ ע
אפגעריבענעם	א פ ג ע ר י ב ע נ ע ם
אפגעריסן	א פ ג ע ר י ס ן
אפגעריסענע	א פ ג ע ר י ס ע נ ע
אפגערעדטער	א פ ג ע ר ע ד ט ע ר
אפגעשטאנען	א פ ג ע ש ט א נ ע ן
אפגעשטעלט	א פ ג ע ש ט ע ל ט
אפגעשיקט	א פ ג ע ש י ק ט
אפגעשלאפן	א פ ג ע ש ל א פ ן
אפגעשלעפט	א פ ג ע ש ל ע פ ט
אפגעשמועסט	א פ ג ע ש מ ו ע ס ט
אפגעשניטן	א פ ג ע ש נ י ט ן
אפגעשניטענע	א פ ג ע ש נ י ט ע נ ע
אפגעשריבן	א פ ג ע ש ר י ב ן
אפגרונט	א פ ג ר ו נ ט
אפדרוקן	א פ ד ר ו ק ן
אפדרייען	א פ ד ר י י ע ן
אפווארטן	א פ ו ו א ר ט ן
אפווארטנדיק	א פ ו ו א ר ט נ ד י ק
אפזיצן	א פ ז י צ ן
אפט	א פ ט
אפטאן	א פ ט א ן
אפטיילן	א פ ט י י ל ן
אפטשעפען	א פ ט ש ע פ ע ן
אפילו	א פ י ל ו
אפיקורס	א פ י ק ו ר ס
אפיקורסים	א פ י ק ו ר ס י ם
אפיר	א פ י ר
אפלאדיסמענטן	א פ ל א ד י ס מ ע נ ט ן
אפלויבן	א פ ל ו י ב ן
אפמעקן	א פ מ ע ק ן
אפן	א פ ן
אפנעמען	א פ נ ע מ ע ן
אפעטיט	א פ ע ט י ט
אפענע	א פ ע נ ע
אפענער	א פ ע נ ע ר
אפער	א פ ע ר
אפעראציע	א פ ע ר א צ י ע
אפעראציעס	א פ ע ר א צ י ע ס
אפפאסטן	א פ פ א ס ט ן
אפפארן	א פ פ א ר ן
אפפירן	א פ פ י ר ן
אפצודאנקען	א פ צ ו ד א נ ק ע ן
אפצולויבן	א פ צ ו ל ו י ב ן
אפצונעמען	א פ צ ו נ ע מ ע ן
אפקאסטן	א פ ק א ס ט ן
אפקויפן	א פ ק ו י פ ן
אפקערן	א פ ק ע ר ן
אפרוען	א פ ר ו ע ן
אפריכטן	א פ ר י כ ט ן
אפשייד	א פ ש י י ד
אפשלאפן	א פ ש ל א פ ן
אפשר	א פ ש ר
אפשרעקען	א פ ש ר ע ק ע ן
אצונד	א צ ו נ ד
אצינד	א צ י נ ד
אקארשט	א ק א ר ש ט
אקוראט	א ק ו ר א ט
אקט	א ק ט
אקטיאר	א ק ט י א ר
אקטיארן	א ק ט י א ר ן
אקטן	א ק ט ן
אקס	א ק ס
אקסל	א ק ס ל
אקסן	א ק ס ן
אקעגן	א ק ע ג ן
אקעגניבער	א ק ע ג נ י ב ע ר
אקעוויט	א ק ע ו ו י ט
אקציע	א ק צ י ע
אר	א ר
אראפ	א ר א פ
אראפבייגן	א ר א פ ב י י ג ן
אראפגעבראכט	א ר א פ ג ע ב ר א כ ט
אראפגעגנבעט	א ר א פ ג ע ג נ ב ע ט
אראפגעווארפן	א ר א פ ג ע ו ו א ר פ ן
אראפגעווונקען	א ר א פ ג ע ו ו ו נ ק ע ן
אראפגעכאפט	א ר א פ ג ע כ א פ ט
אראפגעלאזט	א ר א פ ג ע ל א ז ט
אראפגעלאזטן	א ר א פ ג ע ל א ז ט ן
אראפגעלאזטע	א ר א פ ג ע ל א ז ט ע
אראפגעלאזטער	א ר א פ ג ע ל א ז ט ע ר
אראפגענומען	א ר א פ ג ע נ ו מ ע ן
אראפגעפאלן	א ר א פ ג ע פ א ל ן
אראפגעקוקט	א ר א פ ג ע ק ו ק ט
אראפגערוקט	א ר א פ ג ע ר ו ק ט
אראפגעשלונגען	א ר א פ ג ע ש ל ו נ ג ע ן
אראפגעשפרונגען	א ר א פ ג ע ש פ ר ו נ ג ע ן
אראפגעשריגן	א ר א פ ג ע ש ר י ג ן
אראפפארן	א ר א פ פ א ר ן
ארבע־כנפות	א ר ב ע ־ כ נ פ ו ת
ארבעט	א ר ב ע ט
ארבעטן	א ר ב ע ט ן
ארבעטסט	א ר ב ע ט ס ט
ארגיע	א ר ג י ע
ארדענונג	א ר ד ע נ ו נ ג
ארויס	א ר ו י ס
ארויסגיין	א ר ו י ס ג י י ן
ארויסגעבן	א ר ו י ס ג ע ב ן
ארויסגעגאנגען	א ר ו י ס ג ע ג א נ ג ע ן
ארויסגעגעבן	א ר ו י ס ג ע ג ע ב ן
ארויסגעדרונגען	א ר ו י ס ג ע ד ר ו נ ג ע ן
ארויסגעווארפן	א ר ו י ס ג ע ו ו א ר פ ן
ארויסגעוויזן	א ר ו י ס ג ע ו ו י ז ן
ארויסגעזאגט	א ר ו י ס ג ע ז א ג ט
ארויסגעטריבן	א ר ו י ס ג ע ט ר י ב ן
ארויסגעכאפט	א ר ו י ס ג ע כ א פ ט
ארויסגעלאזט	א ר ו י ס ג ע ל א ז ט
ארויסגעלאזן	א ר ו י ס ג ע ל א ז ן
ארויסגעלאפן	א ר ו י ס ג ע ל א פ ן
ארויסגעמשלחט	א ר ו י ס ג ע מ ש ל ח ט
ארויסגענומען	א ר ו י ס ג ע נ ו מ ע ן
ארויסגעפארן	א ר ו י ס ג ע פ א ר ן
ארויסגעקומען	א ר ו י ס ג ע ק ו מ ע ן
ארויסגעקוקט	א ר ו י ס ג ע ק ו ק ט
ארויסגעקראכן	א ר ו י ס ג ע ק ר א כ ן
ארויסגערויטלט	א ר ו י ס ג ע ר ו י ט ל ט
ארויסגעריסן	א ר ו י ס ג ע ר י ס ן
ארויסגערעדט	א ר ו י ס ג ע ר ע ד ט
ארויסגעשטעלט	א ר ו י ס ג ע ש ט ע ל ט
ארויסגעשטעקט	א ר ו י ס ג ע ש ט ע ק ט
ארויסגעשטרעקטער	א ר ו י ס ג ע ש ט ר ע ק ט ע ר
ארויסגעשלעפט	א ר ו י ס ג ע ש ל ע פ ט
ארויסדרייען	א ר ו י ס ד ר י י ע ן
ארויסווארפן	א ר ו י ס ו ו א ר פ ן
ארויסזען	א ר ו י ס ז ע ן
ארויסזעצן	א ר ו י ס ז ע צ ן
ארויסטראגן	א ר ו י ס ט ר א ג ן
ארויסטרעטן	א ר ו י ס ט ר ע ט ן
ארויסלאזן	א ר ו י ס ל א ז ן
ארויסנעמען	א ר ו י ס נ ע מ ע ן
ארויסצוווארפן	א ר ו י ס צ ו ו ו א ר פ ן
ארויסצולאזן	א ר ו י ס צ ו ל א ז ן
ארויסצולויפן	א ר ו י ס צ ו ל ו י פ ן
ארויסרייסן	א ר ו י ס ר י י ס ן
ארויף	א ר ו י ף
ארויפארבעטן	א ר ו י פ א ר ב ע ט ן
ארויפגיין	א ר ו י פ ג י י ן
ארויפגעזעצט	א ר ו י פ ג ע ז ע צ ט
ארויפגעלייגט	א ר ו י פ ג ע ל י י ג ט
ארויפגענומען	א ר ו י פ ג ע נ ו מ ע ן
ארויפגעפלאטערט	א ר ו י פ ג ע פ ל א ט ע ר ט
ארויפגעקראכן	א ר ו י פ ג ע ק ר א כ ן
ארויפגערוקטן	א ר ו י פ ג ע ר ו ק ט ן
ארויפלייגן	א ר ו י פ ל י י ג ן
ארויפקומען	א ר ו י פ ק ו מ ע ן
ארום	א ר ו ם
ארומגיין	א ר ו מ ג י י ן
ארומגעגאנגען	א ר ו מ ג ע ג א נ ג ע ן
ארומגעדרייט	א ר ו מ ג ע ד ר י י ט
ארומגעוואלגערט	א ר ו מ ג ע ו ו א ל ג ע ר ט
ארומגעוויקלט	א ר ו מ ג ע ו ו י ק ל ט
ארומגעכאפט	א ר ו מ ג ע כ א פ ט
ארומגעלאפן	א ר ו מ ג ע ל א פ ן
ארומגעפלאנטערט	א ר ו מ ג ע פ ל א נ ט ע ר ט
ארומגעקוקט	א ר ו מ ג ע ק ו ק ט
ארומגעשוועבט	א ר ו מ ג ע ש ו ו ע ב ט
ארומגעשטעקט	א ר ו מ ג ע ש ט ע ק ט
ארומוואלגערן	א ר ו מ ו ו א ל ג ע ר ן
ארומזען	א ר ו מ ז ע ן
ארומלויפן	א ר ו מ ל ו י פ ן
ארומפארן	א ר ו מ פ א ר ן
ארון	א ר ו ן
ארט	א ר ט
ארטיסטן	א ר ט י ס ט ן
אריבער	א ר י ב ע ר
אריבערגעצויגן	א ר י ב ע ר ג ע צ ו י ג ן
אריבערגעשפאנט	א ר י ב ע ר ג ע ש פ א נ ט
אריבערטראגן	א ר י ב ע ר ט ר א ג ן
אריבערפירן	א ר י ב ע ר פ י ר ן
אריין	א ר י י ן
אריינברענגען	א ר י י נ ב ר ע נ ג ע ן
אריינגעבן	א ר י י נ ג ע ב ן
אריינגעבראקט	א ר י י נ ג ע ב ר א ק ט
אריינגעדרייט	א ר י י נ ג ע ד ר י י ט
אריינגעווארפן	א ר י י נ ג ע ו ו א ר פ ן
אריינגעווארצלט	א ר י י נ ג ע ו ו א ר צ ל ט
אריינגעטאן	א ר י י נ ג ע ט א ן
אריינגעטראגן	א ר י י נ ג ע ט ר א ג ן
אריינגעכאפט	א ר י י נ ג ע כ א פ ט
אריינגעלאפן	א ר י י נ ג ע ל א פ ן
אריינגעלייגט	א ר י י נ ג ע ל י י ג ט
אריינגענומען	א ר י י נ ג ע נ ו מ ע ן
אריינגעפאלן	א ר י י נ ג ע פ א ל ן
אריינגעפלאנטערט	א ר י י נ ג ע פ ל א נ ט ע ר ט
אריינגעקומען	א ר י י נ ג ע ק ו מ ע ן
אריינגעקוקט	א ר י י נ ג ע ק ו ק ט
אריינגערעכנט	א ר י י נ ג ע ר ע כ נ ט
אריינגעשטעלט	א ר י י נ ג ע ש ט ע ל ט
אריינגעשריען	א ר י י נ ג ע ש ר י ע ן
אריינדזשמענטס	א ר י י נ ד ז ש מ ע נ ט ס
אריינווארפן	א ר י י נ ו ו א ר פ ן
אריינלאזן	א ר י י נ ל א ז ן
אריינלייגנדיק	א ר י י נ ל י י ג נ ד י ק
אריינפאלן	א ר י י נ פ א ל ן
אריינקוקן	א ר י י נ ק ו ק ן
ארימאן	א ר י מ א ן
ארימער	א ר י מ ע ר
ארכו	א ר כ ו
ארן	א ר ן
ארעם	א ר ע ם
ארעמאן	א ר ע מ א ן
ארעמס	א ר ע מ ס
ארעמע	א ר ע מ ע
ארעמע־לייט	א ר ע מ ע ־ ל י י ט
ארעמער	א ר ע מ ע ר
ארעמקייט	א ר ע מ ק י י ט
ארענדע	א ר ע נ ד ע
ארעסט	א ר ע ס ט
ארץ־	א ר ץ ־
ארץ־ישראל	א ר ץ ־ י ש ר א ל
ארץ־ישראל־ערד	א ר ץ ־ י ש ר א ל ־ ע ר ד
אש	א ש
אש־להבה	א ש ־ ל ה ב ה
אשה	א ש ה
אשר	א ש ר
אשרי	א ש ר י
אשת	א ש ת
אשת־איש	א ש ת ־ א י ש
אתרוג	א ת ר ו ג
ב	ב
בא	ב א
באבע	ב א ב ע
באגאסן	ב א ג א ס ן
באגייווערטע	ב א ג י י ו ו ע ר ט ע
באגיין	ב א ג י י ן
באגייסטערט	ב א ג י י ס ט ע ר ט
באגלייט	ב א ג ל י י ט
באגליקן	ב א ג ל י ק ן
באגעגנט	ב א ג ע ג נ ט
באגעגעניש	ב א ג ע ג ע נ י ש
באגעגענישן	ב א ג ע ג ע נ י ש ן
באגערט	ב א ג ע ר ט
באגראבן	ב א ג ר א ב ן
באדארף	ב א ד א ר ף
באדארפט	ב א ד א ר פ ט
באדארפן	ב א ד א ר פ ן
באדט	ב א ד ט
באדנדיק	ב א ד נ ד י ק
באדענקט	ב א ד ע נ ק ט
באדעקט	ב א ד ע ק ט
באדעקנס	ב א ד ע ק נ ס
באהאלט	ב א ה א ל ט
באהאלטן	ב א ה א ל ט ן
באהאלטענע	ב א ה א ל ט ע נ ע
באהאנגן	ב א ה א נ ג ן
באהיט	ב א ה י ט
באוואסערט	ב א ו ו א ס ע ר ט
באוואקסענע	ב א ו ו א ק ס ע נ ע
באווארנט	ב א ו ו א ר נ ט
באוווסטן	ב א ו ו ו ס ט ן
באוויזן	ב א ו ו י ז ן
באווייז	ב א ו ו י י ז
באווייזט	ב א ו ו י י ז ט
באווייזן	ב א ו ו י י ז ן
באזארגן	ב א ז א ר ג ן
באזוכן	ב א ז ו כ ן
באזונדער	ב א ז ו נ ד ע ר
באזונדערע	ב א ז ו נ ד ע ר ע
באזונדערער	ב א ז ו נ ד ע ר ע ר
באזעצט	ב א ז ע צ ט
באטאפן	ב א ט א פ ן
באטראכט	ב א ט ר א כ ט
באל	ב א ל
באלאדע	ב א ל א ד ע
באלאן	ב א ל א ן
באלד	ב א ל ד
באלוט	ב א ל ו ט
באלויכטן	ב א ל ו י כ ט ן
באליידיקט	ב א ל י י ד י ק ט
באלמעלאכעס	ב א ל מ ע ל א כ ע ס
באלעבאטים	ב א ל ע ב א ט י ם
באלעבאס	ב א ל ע ב א ס
באלערנדיק	ב א ל ע ר נ ד י ק
באלקן	ב א ל ק ן
באמיען	ב א מ י ע ן
באמערק	ב א מ ע ר ק
באמערקונגען	ב א מ ע ר ק ו נ ג ע ן
באמערקט	ב א מ ע ר ק ט
באמערקען	ב א מ ע ר ק ע ן
באמת	ב א מ ת
באן	ב א ן
באנאנד	ב א נ א נ ד
באנד	ב א נ ד
באנוצט	ב א נ ו צ ט
באנוצן	ב א נ ו צ ן
באנטשע	ב א נ ט ש ע
באנטשען	ב א נ ט ש ע ן
באנטשעס	ב א נ ט ש ע ס
באנייט	ב א נ י י ט
באניע	ב א נ י ע
באנק	ב א נ ק
באנקעס	ב א נ ק ע ס
באנקראטירט	ב א נ ק ר א ט י ר ט
באפאלן	ב א פ א ל ן
באפוילן	ב א פ ו י ל ן
באפעל	ב א פ ע ל
באפעסטיקט	ב א פ ע ס ט י ק ט
באפריינדעט	ב א פ ר י י נ ד ע ט
באצאלט	ב א צ א ל ט
באצאלן	ב א צ א ל ן
באציט	ב א צ י ט
באקאנט	ב א ק א נ ט
באקאנטן	ב א ק א נ ט ן
באקאנטע	ב א ק א נ ט ע
באקאנטער	ב א ק א נ ט ע ר
באקומט	ב א ק ו מ ט
באקומען	ב א ק ו מ ע ן
באקומענדיק	ב א ק ו מ ע נ ד י ק
באקוקט	ב א ק ו ק ט
באקלאגן	ב א ק ל א ג ן
באקן	ב א ק ן
באקענט	ב א ק ע נ ט
באר	ב א ר
באר־מיצווה	ב א ר ־ מ י צ ו ו ה
בארג	ב א ר ג
בארג־אראפ	ב א ר ג ־ א ר א פ
בארג־ארויף	ב א ר ג ־ א ר ו י ף
בארד	ב א ר ד
בארוועס	ב א ר ו ו ע ס
בארוועסע	ב א ר ו ו ע ס ע
בארימט	ב א ר י מ ט
בארימטע	ב א ר י מ ט ע
בארימטער	ב א ר י מ ט ע ר
בארימען	ב א ר י מ ע ן
בארעדט	ב א ר ע ד ט
בארעדעוודיק	ב א ר ע ד ע ו ו ד י ק
בארעכנט	ב א ר ע כ נ ט
בארשט	ב א ר ש ט
באשאפן	ב א ש א פ ן
באשולדיקונג	ב א ש ו ל ד י ק ו נ ג
באשטיין	ב א ש ט י י ן
באשטעלט	ב א ש ט ע ל ט
באשיימפערלעך	ב א ש י י מ פ ע ר ל ע ך
באשיצט	ב א ש י צ ט
באשלאגן	ב א ש ל א ג ן
באשלאסן	ב א ש ל א ס ן
באשמעקן	ב א ש מ ע ק ן
באשעפעניש	ב א ש ע פ ע נ י ש
באשעפער	ב א ש ע פ ע ר
באשערט	ב א ש ע ר ט
באשפיגן	ב א ש פ י ג ן
באשפריצט	ב א ש פ ר י צ ט
באשר	ב א ש ר
באשריבן	ב א ש ר י ב ן
בגד	ב ג ד
בגדים	ב ג ד י ם
בדחן	ב ד ח ן
בדיל	ב ד י ל
בדעה	ב ד ע ה
בדרך	ב ד ר ך
בהיותו	ב ה י ו ת ו
בהלה	ב ה ל ה
בהמה	ב ה מ ה
בהמות	ב ה מ ו ת
בהן	ב ה ן
בודעפערען	ב ו ד ע פ ע ר ע ן
בוודאי	ב ו ו ד א י
בוזעמס	ב ו ז ע מ ס
בויבעריק	ב ו י ב ע ר י ק
בויג	ב ו י ג
בויגן	ב ו י ג ן
בויגעוודיק	ב ו י ג ע ו ו ד י ק
בויגעלע	ב ו י ג ע ל ע
בויד	ב ו י ד
בוידעם	ב ו י ד ע ם
בויך	ב ו י ך
בוים	ב ו י ם
בוימל	ב ו י מ ל
בוימער	ב ו י מ ע ר
בויען	ב ו י ע ן
בוירן	ב ו י ר ן
בוך	ב ו ך
בוכהאלטער	ב ו כ ה א ל ט ע ר
בוכשטאב	ב ו כ ש ט א ב
בולט	ב ו ל ט
בולקע	ב ו ל ק ע
בורא	ב ו ר א
בוריקעס־בארשט	ב ו ר י ק ע ס ־ ב א ר ש ט
בורשטין	ב ו ר ש ט י ן
בושה	ב ו ש ה
בזיון	ב ז י ו ן
בזיונות	ב ז י ו נ ו ת
בזשעווזאווסקיס	ב ז ש ע ו ו ז א ו ו ס ק י ס
בזשעזאווסקי	ב ז ש ע ז א ו ו ס ק י
בזשעזאווסקיס	ב ז ש ע ז א ו ו ס ק י ס
בחור	ב ח ו ר
בחורים	ב ח ו ר י ם
בחורימלעך	ב ח ו ר י מ ל ע ך
בחוש	ב ח ו ש
בחינם	ב ח י נ ם
בחצי־חינם	ב ח צ י ־ ח י נ ם
בחרם	ב ח ר ם
בטבע	ב ט ב ע
בטהרה	ב ט ה ר ה
בטוח	ב ט ו ח
בטחון	ב ט ח ו ן
בטל	ב ט ל
בטלט	ב ט ל ט
ביד	ב י ד
בידנע	ב י ד נ ע
ביוש	ב י ו ש
ביז	ב י ז
ביזט	ב י ז ט
ביזן	ב י ז ן
ביטול	ב י ט ו ל
ביטער	ב י ט ע ר
ביטערע	ב י ט ע ר ע
ביי	ב י י
בייגט	ב י י ג ט
בייגעטראגן	ב י י ג ע ט ר א ג ן
ביידל	ב י י ד ל
ביידן	ב י י ד ן
ביידע	ב י י ד ע
בייז	ב י י ז
בייז־ווונדער	ב י י ז ־ ו ו ו נ ד ע ר
בייזן	ב י י ז ן
בייזע	ב י י ז ע
בייזערט	ב י י ז ע ר ט
בייטאג	ב י י ט א ג
בייטלע	ב י י ט ל ע
בייטש	ב י י ט ש
בייטשל	ב י י ט ש ל
בייל	ב י י ל
ביילע־יענטע	ב י י ל ע ־ י ע נ ט ע
ביים	ב י י ם
ביימל	ב י י מ ל
ביימער	ב י י מ ע ר
ביינדל	ב י י נ ד ל
ביינער	ב י י נ ע ר
בייסן	ב י י ס ן
בייסעניש	ב י י ס ע נ י ש
ביישפיל	ב י י ש פ י ל
ביכלעך	ב י כ ל ע ך
ביכעלעך	ב י כ ע ל ע ך
ביכער	ב י כ ע ר
בילבול	ב י ל ב ו ל
בילגארייער	ב י ל ג א ר י י ע ר
בילדונג	ב י ל ד ו נ ג
בילדן	ב י ל ד ן
בילדער	ב י ל ד ע ר
ביליק	ב י ל י ק
בילן	ב י ל ן
בימה	ב י מ ה
בימים	ב י מ י ם
בין	ב י ן
בינדט	ב י נ ד ט
בינטל	ב י נ ט ל
ביסט	ב י ס ט
ביסטו	ב י ס ט ו
ביסל	ב י ס ל
ביסלעך	ב י ס ל ע ך
ביסן	ב י ס ן
ביסעלע	ב י ס ע ל ע
בירגער	ב י ר ג ע ר
בירושה	ב י ר ו ש ה
בישיבה	ב י ש י ב ה
בית	ב י ת
בית־דין	ב י ת ־ ד י ן
בית־דין־שטוב	ב י ת ־ ד י ן ־ ש ט ו ב
בית־המדרש	ב י ת ־ ה מ ד ר ש
בית־המדרש־גמרות	ב י ת ־ ה מ ד ר ש ־ ג מ ר ו ת
בית־המיקדש	ב י ת ־ ה מ י ק ד ש
בית־מדרש	ב י ת ־ מ ד ר ש
ביתר	ב י ת ר
בכבודיקע	ב כ ב ו ד י ק ע
בכבודיקערע	ב כ ב ו ד י ק ע ר ע
בכוח	ב כ ו ח
בכל	ב כ ל
בכלל	ב כ ל ל
בכן	ב כ ן
בלאז	ב ל א ז
בלאזט	ב ל א ז ט
בלאזן	ב ל א ז ן
בלאט	ב ל א ט
בלאטע	ב ל א ט ע
בלאטעס	ב ל א ט ע ס
בלאטער	ב ל א ט ע ר
בלאנדזשע	ב ל א נ ד ז ש ע
בלאנדזשען	ב ל א נ ד ז ש ע ן
בלאנקט	ב ל א נ ק ט
בלאס	ב ל א ס
בלאסער	ב ל א ס ע ר
בלוט	ב ל ו ט
בלוטיק	ב ל ו ט י ק
בלוטיקן	ב ל ו ט י ק ן
בלוטן	ב ל ו ט ן
בלוי	ב ל ו י
בלויז	ב ל ו י ז
בלויזן	ב ל ו י ז ן
בלויזער	ב ל ו י ז ע ר
בלויע	ב ל ו י ע
בלויען	ב ל ו י ע ן
בלומכע	ב ל ו מ כ ע
בלומען	ב ל ו מ ע ן
בליט	ב ל י ט
בלייבט	ב ל י י ב ט
בלייבן	ב ל י י ב ן
בלייכע	ב ל י י כ ע
בליצט	ב ל י צ ט
בליק	ב ל י ק
בלישטשעט	ב ל י ש ט ש ע ט
בלישטשען	ב ל י ש ט ש ע ן
בלעטערט	ב ל ע ט ע ר ט
בלעך	ב ל ע ך
בלעכענער	ב ל ע כ ע נ ע ר
בלענדנדיקער	ב ל ע נ ד נ ד י ק ע ר
במנוחה	ב מ נ ו ח ה
במצוות	ב מ צ ו ו ת
בן	ב ן
בן־ציון	ב ן ־ צ י ו ן
בן־תורה	ב ן ־ ת ו ר ה
בני	ב נ י
בני־בית	ב נ י ־ ב י ת
בני־ביתן	ב נ י ־ ב י ת ן
בעדער	ב ע ד ע ר
בעזעם	ב ע ז ע ם
בעזעמס	ב ע ז ע מ ס
בעט	ב ע ט
בעטגעוואנט	ב ע ט ג ע ו ו א נ ט
בעטלברויט	ב ע ט ל ב ר ו י ט
בעטלען	ב ע ט ל ע ן
בעטלער	ב ע ט ל ע ר
בעטן	ב ע ט ן
בעך	ב ע ך
בעכטעוו	ב ע כ ט ע ו ו
בעכטעווער	ב ע כ ט ע ו ו ע ר
בעל	ב ע ל
בעל־דקדוק	ב ע ל ־ ד ק ד ו ק
בעל־דרשער	ב ע ל ־ ד ר ש ע ר
בעל־הבית	ב ע ל ־ ה ב י ת
בעל־הבתישקייט	ב ע ל ־ ה ב ת י ש ק י י ט
בעל־הנס	ב ע ל ־ ה נ ס
בעל־חוב	ב ע ל ־ ח ו ב
בעל־חשבון	ב ע ל ־ ח ש ב ו ן
בעל־כרחך	ב ע ל ־ כ ר ח ך
בעל־לשון־קודש	ב ע ל ־ ל ש ו ן ־ ק ו ד ש
בעל־מלאכה	ב ע ל ־ מ ל א כ ה
בעל־מלאכות	ב ע ל ־ מ ל א כ ו ת
בעל־משגיח	ב ע ל ־ מ ש ג י ח
בעל־עבירהניק	ב ע ל ־ ע ב י ר ה נ י ק
בעל־עגלה	ב ע ל ־ ע ג ל ה
בעל־פרנסה	ב ע ל ־ פ ר נ ס ה
בעל־צדקה	ב ע ל ־ צ ד ק ה
בעל־שם	ב ע ל ־ ש ם
בעל־תאווה	ב ע ל ־ ת א ו ו ה
בעל־תאוות	ב ע ל ־ ת א ו ו ת
בעל־תנך	ב ע ל ־ ת נ ך
בעלי־בתים	ב ע ל י ־ ב ת י ם
בעלי־הבתים	ב ע ל י ־ ה ב ת י ם
בעלי־חיים	ב ע ל י ־ ח י י ם
בעלי־עבירות	ב ע ל י ־ ע ב י ר ו ת
בעלי־עגלות	ב ע ל י ־ ע ג ל ו ת
בעלמע	ב ע ל מ ע
בעלן	ב ע ל ן
בעלנים	ב ע ל נ י ם
בעלקעס	ב ע ל ק ע ס
בעלקעסן	ב ע ל ק ע ס ן
בעלת־צדקה	ב ע ל ת ־ צ ד ק ה
בענטשליכט	ב ע נ ט ש ל י כ ט
בעניע	ב ע נ י ע
בענצן	ב ע נ צ ן
בענצע	ב ע נ צ ע
בענצען	ב ע נ צ ע ן
בענצעס	ב ע נ צ ע ס
בענק	ב ע נ ק
בענקט	ב ע נ ק ט
בענקל	ב ע נ ק ל
בענקעלע	ב ע נ ק ע ל ע
בענקעניש	ב ע נ ק ע נ י ש
בעסטן	ב ע ס ט ן
בעסטע	ב ע ס ט ע
בעסער	ב ע ס ע ר
בעסער־ערגער	ב ע ס ע ר ־ ע ר ג ע ר
בעסערער	ב ע ס ע ר ע ר
בעקלעך	ב ע ק ל ע ך
בער	ב ע ר
בערגל	ב ע ר ג ל
בערגלעך	ב ע ר ג ל ע ך
בערגעלסאן	ב ע ר ג ע ל ס א ן
בערד	ב ע ר ד
בערדל	ב ע ר ד ל
בעריש	ב ע ר י ש
בערישעס	ב ע ר י ש ע ס
בערל	ב ע ר ל
בערן	ב ע ר ן
בערעלע	ב ע ר ע ל ע
בעת	ב ע ת
בפירוש	ב פ י ר ו ש
בפירושע	ב פ י ר ו ש ע
בפרט	ב פ ר ט
בפתח	ב פ ת ח
בצבור	ב צ ב ו ר
בקבלה	ב ק ב ל ה
בקיאות	ב ק י א ו ת
בקשה	ב ק ש ה
בראט	ב ר א ט
בראטן	ב ר א ט ן
בראך	ב ר א ך
בראנזענע	ב ר א נ ז ע נ ע
בראנפן	ב ר א נ פ ן
בראקעניו	ב ר א ק ע נ י ו
בראשית	ב ר א ש י ת
ברוגז	ב ר ו ג ז
ברוגז־טאנץ	ב ר ו ג ז ־ ט א נ ץ
ברודיקע	ב ר ו ד י ק ע
ברודער	ב ר ו ד ע ר
ברויט	ב ר ו י ט
ברויך	ב ר ו י ך
ברוין־און־בלא	ב ר ו י ן ־ א ו ן ־ ב ל א
ברוך	ב ר ו ך
ברוך־הבא	ב ר ו ך ־ ה ב א
ברוך־הוא	ב ר ו ך ־ ה ו א
ברוך־השם	ב ר ו ך ־ ה ש ם
ברונעם	ב ר ו נ ע ם
ברוסט	ב ר ו ס ט
ברוק	ב ר ו ק
ברוקלין	ב ר ו ק ל י ן
ברוקלינער	ב ר ו ק ל י נ ע ר
בריאה	ב ר י א ה
ברידזש	ב ר י ד ז ש
ברידער	ב ר י ד ע ר
בריה	ב ר י ה
בריוו	ב ר י ו ו
בריוול	ב ר י ו ו ל
בריוולעך	ב ר י ו ו ל ע ך
בריוונשטעלערס	ב ר י ו ו נ ש ט ע ל ע ר ס
בריוועלע	ב ר י ו ו ע ל ע
ברייט	ב ר י י ט
ברייטן	ב ר י י ט ן
ברייטע	ב ר י י ט ע
ברייטער	ב ר י י ט ע ר
ברייען	ב ר י י ע ן
ברייצטע	ב ר י י צ ט ע
בריליאנטן	ב ר י ל י א נ ט ן
בריליאנטענע	ב ר י ל י א נ ט ע נ ע
ברילן	ב ר י ל ן
ברירה	ב ר י ר ה
ברית	ב ר י ת
בריתן	ב ר י ת ן
ברכה	ב ר כ ה
ברכות	ב ר כ ו ת
ברעטער	ב ר ע ט ע ר
ברעכן	ב ר ע כ ן
ברענגט	ב ר ע נ ג ט
ברענגען	ב ר ע נ ג ע ן
ברענט	ב ר ע נ ט
ברענען	ב ר ע נ ע ן
ברענענדיקע	ב ר ע נ ע נ ד י ק ע
ברעקל	ב ר ע ק ל
בשום	ב ש ו ם
בשורה	ב ש ו ר ה
בשימחה	ב ש י מ ח ה
בשלום	ב ש ל ו ם
בשעת	ב ש ע ת
בשעת־הדחק	ב ש ע ת ־ ה ד ח ק
בשעת־מעשה	ב ש ע ת ־ מ ע ש ה
בשעתן	ב ש ע ת ן
בשר	ב ש ר
בת	ב ת
בת־יחידה	ב ת ־ י ח י ד ה
בתורה	ב ת ו ר ה
בתי־מדרשים	ב ת י ־ מ ד ר ש י ם
ג'	ג '
גאב	ג א ב
גאדערן	ג א ד ע ר ן
גאון	ג א ו ן
גאונים	ג א ו נ י ם
גאזלאמפטערנס	ג א ז ל א מ פ ט ע ר נ ס
גאזעטן	ג א ז ע ט ן
גאזשע	ג א ז ש ע
גאט	ג א ט
גאט'ס	ג א ט ' ס
גאטלאבער	ג א ט ל א ב ע ר
גאטס	ג א ט ס
גאטעס	ג א ט ע ס
גאטעס־דינסט	ג א ט ע ס ־ ד י נ ס ט
גאל	ג א ל
גאל־שטיינער	ג א ל ־ ש ט י י נ ע ר
גאלד	ג א ל ד
גאלדמאן	ג א ל ד מ א ן
גאלדע	ג א ל ד ע
גאלדענע	ג א ל ד ע נ ע
גאלדענער	ג א ל ד ע נ ע ר
גאלייגט	ג א ל י י ג ט
גאלע	ג א ל ע
גאלער	ג א ל ע ר
גאנג	ג א נ ג
גאנדז	ג א נ ד ז
גאנץ	ג א נ ץ
גאנצן	ג א נ צ ן
גאנצע	ג א נ צ ע
גאנצער	ג א נ צ ע ר
גאס	ג א ס
גאס־לאמטערנס	ג א ס ־ ל א מ ט ע ר נ ס
גאסט	ג א ס ט
גאסטינעץ	ג א ס ט י נ ע ץ
גאסן	ג א ס ן
גאר	ג א ר
גאראדאוואי	ג א ר א ד א ו ו א י
גארגל	ג א ר ג ל
גארגלען	ג א ר ג ל ע ן
גארגלשטיין	ג א ר ג ל ש ט י י ן
גארטל	ג א ר ט ל
גארטן	ג א ר ט ן
גארניט	ג א ר נ י ט
גארנישט	ג א ר נ י ש ט
גארער	ג א ר ע ר
גארשקאוו	ג א ר ש ק א ו ו
גארשקאווער	ג א ר ש ק א ו ו ע ר
גבאי	ג ב א י
גבאים	ג ב א י ם
גבול	ג ב ו ל
גבורה	ג ב ו ר ה
גביר	ג ב י ר
גבירים	ג ב י ר י ם
גבר	ג ב ר
גברת	ג ב ר ת
גדול	ג ד ו ל
גדולה	ג ד ו ל ה
גדלות	ג ד ל ו ת
גדלע	ג ד ל ע
גובערנאטאר	ג ו ב ע ר נ א ט א ר
גוואלד	ג ו ו א ל ד
גוואלדעוועט	ג ו ו א ל ד ע ו ו ע ט
גוזמא	ג ו ז מ א
גוט	ג ו ט
גוט־גוט	ג ו ט ־ ג ו ט
גוט־יום־טוב	ג ו ט ־ י ו ם ־ ט ו ב
גוט־שלעכט	ג ו ט ־ ש ל ע כ ט
גוטן	ג ו ט ן
גוטס	ג ו ט ס
גוטע	ג ו ט ע
גוטער	ג ו ט ע ר
גוי	ג ו י
גויים	ג ו י י ם
גויישן	ג ו י י ש ן
גויישע	ג ו י י ש ע
גולם	ג ו ל ם
גומענע	ג ו מ ע נ ע
גוססן	ג ו ס ס ן
גוף	ג ו ף
גופא	ג ו פ א
גוצקייט	ג ו צ ק י י ט
גור	ג ו ר
גזלנים	ג ז ל נ י ם
גזר־דין	ג ז ר ־ ד י ן
גטן	ג ט ן
גיב	ג י ב
גיבורים	ג י ב ו ר י ם
גיבן	ג י ב ן
גיהנום	ג י ה נ ו ם
גיהנם	ג י ה נ ם
גיט	ג י ט
גיטל	ג י ט ל
גיטער	ג י ט ע ר
גיי	ג י י
גייט	ג י י ט
גייט־אונטער	ג י י ט ־ א ו נ ט ע ר
גייט־צו	ג י י ט ־ צ ו
גיין	ג י י ן
גייסט	ג י י ס ט
גייען	ג י י ע ן
גיך	ג י ך
גיכער	ג י כ ע ר
גיכקייט	ג י כ ק י י ט
גילגול	ג י ל ג ו ל
גילגולים	ג י ל ג ו ל י ם
גילדוינים	ג י ל ד ו י נ י ם
גילדן	ג י ל ד ן
גימנאזיסט	ג י מ נ א ז י ס ט
גינגאלדענע	ג י נ ג א ל ד ע נ ע
גינט	ג י נ ט
גיסט	ג י ס ט
גלאז	ג ל א ז
גלאט	ג ל א ט
גלאטיק	ג ל א ט י ק
גלאנץ	ג ל א נ ץ
גלאנצנדיק־רויטלעך	ג ל א נ צ נ ד י ק ־ ר ו י ט ל ע ך
גלאצט	ג ל א צ ט
גלאק	ג ל א ק
גלאקע	ג ל א ק ע
גלויבט	ג ל ו י ב ט
גלויבן	ג ל ו י ב ן
גלוסט	ג ל ו ס ט
גלוסטן	ג ל ו ס ט ן
גלופסק	ג ל ו פ ס ק
גלופסקער	ג ל ו פ ס ק ע ר
גלות	ג ל ו ת
גלות־געצי	ג ל ו ת ־ ג ע צ י
גליד	ג ל י ד
גליד־גליד־געשוועסטערקינד	ג ל י ד ־ ג ל י ד ־ ג ע ש ו ו ע ס ט ע ר ק י נ ד
גליטשט	ג ל י ט ש ט
גליטשיקע	ג ל י ט ש י ק ע
גלייבן	ג ל י י ב ן
גלייך	ג ל י י ך
גלייכט	ג ל י י כ ט
גלייכן	ג ל י י כ ן
גלייכע	ג ל י י כ ע
גלייכער	ג ל י י כ ע ר
גליק	ג ל י ק
גליקלעך	ג ל י ק ל ע ך
גליקלעכן	ג ל י ק ל ע כ ן
גליקלעכער	ג ל י ק ל ע כ ע ר
גלעזל	ג ל ע ז ל
גלעזלעך	ג ל ע ז ל ע ך
גלעזעלע	ג ל ע ז ע ל ע
גלעזער	ג ל ע ז ע ר
גלעזערנע	ג ל ע ז ע ר נ ע
גלעקלעך	ג ל ע ק ל ע ך
גמור	ג מ ו ר
גמילת־חסדים	ג מ י ל ת ־ ח ס ד י ם
גמרא	ג מ ר א
גמרא־מלמד	ג מ ר א ־ מ ל מ ד
גמרה	ג מ ר ה
גן־עדן	ג ן ־ ע ד ן
גןעדן	ג ן ע ד ן
גנב	ג נ ב
גנבה	ג נ ב ה
גנבהט	ג נ ב ה ט
גנבהנען	ג נ ב ה נ ע ן
גנבות	ג נ ב ו ת
גנבים	ג נ ב י ם
גנבעט	ג נ ב ע ט
גניבה	ג נ י ב ה
געאכטעט	ג ע א כ ט ע ט
געאנט	ג ע א נ ט
געארבעט	ג ע א ר ב ע ט
געארט	ג ע א ר ט
געב־אפ	ג ע ב ־ א פ
געבאטן	ג ע ב א ט ן
געבאקענעם	ג ע ב א ק ע נ ע ם
געבארן	ג ע ב א ר ן
געבויגן	ג ע ב ו י ג ן
געבוירן	ג ע ב ו י ר ן
געבוירענער	ג ע ב ו י ר ע נ ע ר
געבונדן	ג ע ב ו נ ד ן
געבילדעט	ג ע ב י ל ד ע ט
געבלאזן	ג ע ב ל א ז ן
געבליבן	ג ע ב ל י ב ן
געבליט	ג ע ב ל י ט
געבליצט	ג ע ב ל י צ ט
געבן	ג ע ב ן
געבעט	ג ע ב ע ט
געבעטלט	ג ע ב ע ט ל ט
געבעטן	ג ע ב ע ט ן
געבענקט	ג ע ב ע נ ק ט
געבעק	ג ע ב ע ק
געבראטענע	ג ע ב ר א ט ע נ ע
געבראכט	ג ע ב ר א כ ט
געבראכן	ג ע ב ר א כ ן
געבריהט	ג ע ב ר י ה ט
געברענגט	ג ע ב ר ע נ ג ט
געברענט	ג ע ב ר ע נ ט
געגאנגען	ג ע ג א נ ג ע ן
געגט	ג ע ג ט
געגלויבט	ג ע ג ל ו י ב ט
געגלייבט	ג ע ג ל י י ב ט
געגליכן	ג ע ג ל י כ ן
געגנבעט	ג ע ג נ ב ע ט
געגנט	ג ע ג נ ט
געגעבן	ג ע ג ע ב ן
געגעסן	ג ע ג ע ס ן
געגרייזלט	ג ע ג ר י י ז ל ט
געגרייט	ג ע ג ר י י ט
געדאוונט	ג ע ד א ו ו נ ט
געדאכט	ג ע ד א כ ט
געדאנקט	ג ע ד א נ ק ט
געדארפט	ג ע ד א ר פ ט
געדויזשעט	ג ע ד ו י ז ש ע ט
געדויערט	ג ע ד ו י ע ר ט
געדולד	ג ע ד ו ל ד
געדונגען	ג ע ד ו נ ג ע ן
געדיכט	ג ע ד י כ ט
געדיכטע	ג ע ד י כ ט ע
געדינט	ג ע ד י נ ט
געדענק	ג ע ד ע נ ק
געדענקט	ג ע ד ע נ ק ט
געדענקט־זשע	ג ע ד ע נ ק ט ־ ז ש ע
געדענקן	ג ע ד ע נ ק ן
געדענקסט	ג ע ד ע נ ק ס ט
געדענקען	ג ע ד ע נ ק ע ן
געדערים	ג ע ד ע ר י ם
געדראפעט	ג ע ד ר א פ ע ט
געדרונגען	ג ע ד ר ו נ ג ע ן
געדרוקט	ג ע ד ר ו ק ט
געדרייט	ג ע ד ר י י ט
געדרימלט	ג ע ד ר י מ ל ט
געהאדעוועט	ג ע ה א ד ע ו ו ע ט
געהאדעוועטע	ג ע ה א ד ע ו ו ע ט ע
געהאט	ג ע ה א ט
געהאלטן	ג ע ה א ל ט ן
געהאלטען	ג ע ה א ל ט ע ן
געהאלפן	ג ע ה א ל פ ן
געהאנגען	ג ע ה א נ ג ע ן
געהאנדלט	ג ע ה א נ ד ל ט
געהאקט	ג ע ה א ק ט
געהאקטן	ג ע ה א ק ט ן
געהארט	ג ע ה א ר ט
געהארכט	ג ע ה א ר כ ט
געהויבענע	ג ע ה ו י ב ע נ ע
געהונקען	ג ע ה ו נ ק ע ן
געהיימע	ג ע ה י י מ ע
געהייסן	ג ע ה י י ס ן
געהייצט	ג ע ה י י צ ט
געהילץ	ג ע ה י ל ץ
געהיצט	ג ע ה י צ ט
געהעצט	ג ע ה ע צ ט
געהער	ג ע ה ע ר
געהערט	ג ע ה ע ר ט
געהעריק	ג ע ה ע ר י ק
געהעריקע	ג ע ה ע ר י ק ע
געוואלגערט	ג ע ו ו א ל ג ע ר ט
געוואלד	ג ע ו ו א ל ד
געוואלדן	ג ע ו ו א ל ד ן
געוואלט	ג ע ו ו א ל ט
געוואנדלט	ג ע ו ו א נ ד ל ט
געוואנדערט	ג ע ו ו א נ ד ע ר ט
געוואנט־קרעמער	ג ע ו ו א נ ט ־ ק ר ע מ ע ר
געוואקסן	ג ע ו ו א ק ס ן
געוואר	ג ע ו ו א ר
געווארגן	ג ע ו ו א ר ג ן
געווארט	ג ע ו ו א ר ט
געווארטשעט	ג ע ו ו א ר ט ש ע ט
געווארן	ג ע ו ו א ר ן
געווארנט	ג ע ו ו א ר נ ט
געווארפן	ג ע ו ו א ר פ ן
געוואשן	ג ע ו ו א ש ן
געוווינט	ג ע ו ו ו י נ ט
געווויר	ג ע ו ו ו י ר
געוווסט	ג ע ו ו ו ס ט
געוויאקעט	ג ע ו ו י א ק ע ט
געוויזן	ג ע ו ו י ז ן
געוויטער	ג ע ו ו י ט ע ר
געוויין	ג ע ו ו י י ן
געוויינט	ג ע ו ו י י נ ט
געוויינטלעך	ג ע ו ו י י נ ט ל ע ך
געוויינלעך	ג ע ו ו י י נ ל ע ך
געווינען	ג ע ו ו י נ ע ן
געוויס	ג ע ו ו י ס
געוויסן	ג ע ו ו י ס ן
געוויסער	ג ע ו ו י ס ע ר
געוויקלט	ג ע ו ו י ק ל ט
געוויר	ג ע ו ו י ר
געוועזן	ג ע ו ו ע ז ן
געוועלב	ג ע ו ו ע ל ב
געוועלבן	ג ע ו ו ע ל ב ן
געוועלטיקט	ג ע ו ו ע ל ט י ק ט
געווען	ג ע ו ו ע ן
געווענדט	ג ע ו ו ע נ ד ט
געזאגט	ג ע ז א ג ט
געזאלט	ג ע ז א ל ט
געזאמלט	ג ע ז א מ ל ט
געזאנג	ג ע ז א נ ג
געזאנגען	ג ע ז א נ ג ע ן
געזארגט	ג ע ז א ר ג ט
געזוכט	ג ע ז ו כ ט
געזונגן	ג ע ז ו נ ג ן
געזונגען	ג ע ז ו נ ג ע ן
געזונט	ג ע ז ו נ ט
געזונטע	ג ע ז ו נ ט ע
געזונטער	ג ע ז ו נ ט ע ר
געזונטערהייט	ג ע ז ו נ ט ע ר ה י י ט
געזונקען	ג ע ז ו נ ק ע ן
געזידלט	ג ע ז י ד ל ט
געזינדל	ג ע ז י נ ד ל
געזעלן	ג ע ז ע ל ן
געזען	ג ע ז ע ן
געזעסן	ג ע ז ע ס ן
געזעצט	ג ע ז ע צ ט
געזעצטער	ג ע ז ע צ ט ע ר
געזעצע	ג ע ז ע צ ע
געזשאלעוועט	ג ע ז ש א ל ע ו ו ע ט
געזשומעט	ג ע ז ש ו מ ע ט
געחוזקט	ג ע ח ו ז ק ט
געחזרט	ג ע ח ז ר ט
געחלומט	ג ע ח ל ו מ ט
געחלשט	ג ע ח ל ש ט
געחתמעט	ג ע ח ת מ ע ט
געטאגט	ג ע ט א ג ט
געטאן	ג ע ט א ן
געטאנצט	ג ע ט א נ צ ט
געטויגט	ג ע ט ו י ג ט
געטויט	ג ע ט ו י ט
געטונקלט	ג ע ט ו נ ק ל ט
געטלעכער	ג ע ט ל ע כ ע ר
געטענהט	ג ע ט ע נ ה ט
געטראגן	ג ע ט ר א ג ן
געטראכט	ג ע ט ר א כ ט
געטראפן	ג ע ט ר א פ ן
געטרוי	ג ע ט ר ו י
געטרויסט	ג ע ט ר ו י ס ט
געטרויערט	ג ע ט ר ו י ע ר ט
געטרונקען	ג ע ט ר ו נ ק ע ן
געטריבן	ג ע ט ר י ב ן
געטריי	ג ע ט ר י י
געטרייסט	ג ע ט ר י י ס ט
געטשעפעט	ג ע ט ש ע פ ע ט
געיאגט	ג ע י א ג ט
געיאדעט	ג ע י א ד ע ט
געיאמער	ג ע י א מ ע ר
געירשנט	ג ע י ר ש נ ט
געכאפט	ג ע כ א פ ט
געכארכלט	ג ע כ א ר כ ל ט
געל	ג ע ל
געלאזט	ג ע ל א ז ט
געלאטעט	ג ע ל א ט ע ט
געלאכט	ג ע ל א כ ט
געלאפן	ג ע ל א פ ן
געלד	ג ע ל ד
געלויבט	ג ע ל ו י ב ט
געלויכטן	ג ע ל ו י כ ט ן
געלונגען	ג ע ל ו נ ג ע ן
געלזוכט	ג ע ל ז ו כ ט
געלט	ג ע ל ט
געליטן	ג ע ל י ט ן
געלייגט	ג ע ל י י ג ט
געלייזט	ג ע ל י י ז ט
געליימט	ג ע ל י י מ ט
געלייענט	ג ע ל י י ע נ ט
געלן	ג ע ל ן
געלע	ג ע ל ע
געלעבט	ג ע ל ע ב ט
געלעגן	ג ע ל ע ג ן
געלעגנהייט	ג ע ל ע ג נ ה י י ט
געלעגער	ג ע ל ע ג ע ר
געלעזן	ג ע ל ע ז ן
געלעכטער	ג ע ל ע כ ט ע ר
געלעקט	ג ע ל ע ק ט
געלער	ג ע ל ע ר
געלערט	ג ע ל ע ר ט
געלערנט	ג ע ל ע ר נ ט
געמאך	ג ע מ א ך
געמאכט	ג ע מ א כ ט
געמאכטע	ג ע מ א כ ט ע
געמאלט	ג ע מ א ל ט
געמאלן	ג ע מ א ל ן
געמאנט	ג ע מ א נ ט
געמוסרט	ג ע מ ו ס ר ט
געמורמלט	ג ע מ ו ר מ ל ט
געמזענע	ג ע מ ז ע נ ע
געמייזעכץ	ג ע מ י י ז ע כ ץ
געמיינט	ג ע מ י י נ ט
געמיש	ג ע מ י ש
געמישפט	ג ע מ י ש פ ט
געמלט	ג ע מ ל ט
געמעגט	ג ע מ ע ג ט
געמעקעט	ג ע מ ע ק ע ט
געמערט	ג ע מ ע ר ט
געמרוקעט	ג ע מ ר ו ק ע ט
גענאוועפא	ג ע נ א ו ו ע פ א
גענאסן	ג ע נ א ס ן
גענדז	ג ע נ ד ז
גענדזן־שמאלץ	ג ע נ ד ז ן ־ ש מ א ל ץ
גענוג	ג ע נ ו ג
גענוגיקע	ג ע נ ו ג י ק ע
גענוי	ג ע נ ו י
גענומען	ג ע נ ו מ ע ן
געניטער	ג ע נ י ט ע ר
גענייט	ג ע נ י י ט
גענעכטיקט	ג ע נ ע כ ט י ק ט
גענעץ	ג ע נ ע ץ
גענעראל	ג ע נ ע ר א ל
גענעראלן	ג ע נ ע ר א ל ן
געסט	ג ע ס ט
געסטראשעט	ג ע ס ט ר א ש ע ט
געסטרעכירט	ג ע ס ט ר ע כ י ר ט
געסל	ג ע ס ל
געסלעך	ג ע ס ל ע ך
געענדיקט	ג ע ע נ ד י ק ט
געענטפערט	ג ע ע נ ט פ ע ר ט
געעפנט	ג ע ע פ נ ט
געפאלן	ג ע פ א ל ן
געפאלענעם	ג ע פ א ל ע נ ע ם
געפאלענער	ג ע פ א ל ע נ ע ר
געפאסט	ג ע פ א ס ט
געפאקט	ג ע פ א ק ט
געפאקטע	ג ע פ א ק ט ע
געפארן	ג ע פ א ר ן
געפגרט	ג ע פ ג ר ט
געפוילט	ג ע פ ו י ל ט
געפונען	ג ע פ ו נ ע ן
געפטרט	ג ע פ ט ר ט
געפידלט	ג ע פ י ד ל ט
געפיל	ג ע פ י ל
געפילט	ג ע פ י ל ט
געפין	ג ע פ י ן
געפינט	ג ע פ י נ ט
געפינען	ג ע פ י נ ע ן
געפירט	ג ע פ י ר ט
געפירטן	ג ע פ י ר ט ן
געפלאטערט	ג ע פ ל א ט ע ר ט
געפלאצט	ג ע פ ל א צ ט
געפלאצטע	ג ע פ ל א צ ט ע
געפלויגן	ג ע פ ל ו י ג ן
געפלעפט	ג ע פ ל ע פ ט
געפסקנט	ג ע פ ס ק נ ט
געפעלט	ג ע פ ע ל ט
געפעלן	ג ע פ ע ל ן
געפעס	ג ע פ ע ס
געפעפערטע	ג ע פ ע פ ע ר ט ע
געפראוועט	ג ע פ ר א ו ו ע ט
געפרוווט	ג ע פ ר ו ו ו ט
געפרוירן	ג ע פ ר ו י ר ן
געפרייט	ג ע פ ר י י ט
געפרעגט	ג ע פ ר ע ג ט
געצאלט	ג ע צ א ל ט
געצאנקט	ג ע צ א נ ק ט
געצאצקעט	ג ע צ א צ ק ע ט
געצויגן	ג ע צ ו י ג ן
געצוקערטע	ג ע צ ו ק ע ר ט ע
געצי	ג ע צ י
געצי'ן	ג ע צ י ' ן
געצי־גובערנאטאר	ג ע צ י ־ ג ו ב ע ר נ א ט א ר
געציטערט	ג ע צ י ט ע ר ט
געצין	ג ע צ י ן
געציס	ג ע צ י ס
געציקלטער	ג ע צ י ק ל ט ע ר
געצל	ג ע צ ל
געקאטשעט	ג ע ק א ט ש ע ט
געקאכט	ג ע ק א כ ט
געקאנט	ג ע ק א נ ט
געקאסט	ג ע ק א ס ט
געקוועטשט	ג ע ק ו ו ע ט ש ט
געקוועלט	ג ע ק ו ו ע ל ט
געקוילעטע	ג ע ק ו י ל ע ט ע
געקויפט	ג ע ק ו י פ ט
געקומען	ג ע ק ו מ ע ן
געקוקט	ג ע ק ו ק ט
געקלאגט	ג ע ק ל א ג ט
געקלויבן	ג ע ק ל ו י ב ן
געקלונגען	ג ע ק ל ו נ ג ע ן
געקליבן	ג ע ק ל י ב ן
געקליבענע	ג ע ק ל י ב ע נ ע
געקליידט	ג ע ק ל י י ד ט
געקנאלט	ג ע ק נ א ל ט
געקנאקט	ג ע ק נ א ק ט
געקניפט	ג ע ק נ י פ ט
געקנעלט	ג ע ק נ ע ל ט
געקענט	ג ע ק ע נ ט
געקעניגט	ג ע ק ע נ י ג ט
געקראגן	ג ע ק ר א ג ן
געקראכן	ג ע ק ר א כ ן
געקריגן	ג ע ק ר י ג ן
געקרייעט	ג ע ק ר י י ע ט
געקריצט	ג ע ק ר י צ ט
געקרעכצט	ג ע ק ר ע כ צ ט
געראט	ג ע ר א ט
געראטן	ג ע ר א ט ן
געראטעוועט	ג ע ר א ט ע ו ו ע ט
געראטעוועטער	ג ע ר א ט ע ו ו ע ט ע ר
געראטענע	ג ע ר א ט ע נ ע
געראטענער	ג ע ר א ט ע נ ע ר
געראי	ג ע ר א י
גערגעלעך	ג ע ר ג ע ל ע ך
גערודער	ג ע ר ו ד ע ר
גערויש	ג ע ר ו י ש
גערונצלט	ג ע ר ו נ צ ל ט
גערופן	ג ע ר ו פ ן
גערוקט	ג ע ר ו ק ט
גערטנער	ג ע ר ט נ ע ר
געריבן	ג ע ר י ב ן
גערידער	ג ע ר י ד ע ר
גערייד	ג ע ר י י ד
גערייכערט	ג ע ר י י כ ע ר ט
געריכט	ג ע ר י כ ט
געריסן	ג ע ר י ס ן
גערן	ג ע ר ן
גערעדט	ג ע ר ע ד ט
גערעכט	ג ע ר ע כ ט
גערעכטיקייט	ג ע ר ע כ ט י ק י י ט
גערעכנט	ג ע ר ע כ נ ט
גערעכערט	ג ע ר ע כ ע ר ט
גערעשט	ג ע ר ע ש ט
געשאדט	ג ע ש א ד ט
געשאט	ג ע ש א ט
געשאטן	ג ע ש א ט ן
געשאכטן	ג ע ש א כ ט ן
געשאכטענע	ג ע ש א כ ט ע נ ע
געשאלטן	ג ע ש א ל ט ן
געשאסן	ג ע ש א ס ן
געשאקלט	ג ע ש א ק ל ט
געשווארן	ג ע ש ו ו א ר ן
געשווארענע	ג ע ש ו ו א ר ע נ ע
געשוווירן	ג ע ש ו ו ו י ר ן
געשוווירען	ג ע ש ו ו ו י ר ע ן
געשוווירענער	ג ע ש ו ו ו י ר ע נ ע ר
געשווומען	ג ע ש ו ו ו מ ע ן
געשוויגן	ג ע ש ו ו י ג ן
געשווילעכץ	ג ע ש ו ו י ל ע כ ץ
געשווינד	ג ע ש ו ו י נ ד
געשווינדלט	ג ע ש ו ו י נ ד ל ט
געשוועבט	ג ע ש ו ו ע ב ט
געשוירענער	ג ע ש ו י ר ע נ ע ר
געשטאכן	ג ע ש ט א כ ן
געשטאלט	ג ע ש ט א ל ט
געשטאלטן	ג ע ש ט א ל ט ן
געשטאמט	ג ע ש ט א מ ט
געשטאנען	ג ע ש ט א נ ע ן
געשטארבן	ג ע ש ט א ר ב ן
געשטארבענע	ג ע ש ט א ר ב ע נ ע
געשטויגן	ג ע ש ט ו י ג ן
געשטוינט	ג ע ש ט ו י נ ט
געשטופלטער	ג ע ש ט ו פ ל ט ע ר
געשטיקט	ג ע ש ט י ק ט
געשטעל	ג ע ש ט ע ל
געשטעלט	ג ע ש ט ע ל ט
געשטראפט	ג ע ש ט ר א פ ט
געשטרויכלט	ג ע ש ט ר ו י כ ל ט
געשיידט	ג ע ש י י ד ט
געשיכטע	ג ע ש י כ ט ע
געשילדערט	ג ע ש י ל ד ע ר ט
געשיפט	ג ע ש י פ ט
געשיקט	ג ע ש י ק ט
געשלאגן	ג ע ש ל א ג ן
געשלאגען	ג ע ש ל א ג ע ן
געשלאפן	ג ע ש ל א פ ן
געשלעפט	ג ע ש ל ע פ ט
געשמאק	ג ע ש מ א ק
געשמועסט	ג ע ש מ ו ע ס ט
געשמייכלט	ג ע ש מ י י כ ל ט
געשמיסן	ג ע ש מ י ס ן
געשמירט	ג ע ש מ י ר ט
געשעמט	ג ע ש ע מ ט
געשען	ג ע ש ע ן
געשענקט	ג ע ש ע נ ק ט
געשענקטן	ג ע ש ע נ ק ט ן
געשעפט	ג ע ש ע פ ט
געשעפטן	ג ע ש ע פ ט ן
געשעצטעס	ג ע ש ע צ ט ע ס
געשפארט	ג ע ש פ א ר ט
געשפיצט	ג ע ש פ י צ ט
געשפירט	ג ע ש פ י ר ט
געשריבן	ג ע ש ר י ב ן
געשריגן	ג ע ש ר י ג ן
געשריי	ג ע ש ר י י
גראבן	ג ר א ב ן
גראבע	ג ר א ב ע
גראבער	ג ר א ב ע ר
גראגער	ג ר א ג ע ר
גראד	ג ר א ד
גראז	ג ר א ז
גראזן	ג ר א ז ן
גראם	ג ר א ם
גראמאטיק	ג ר א מ א ט י ק
גראס־אינקוויזיטארען	ג ר א ס ־ א י נ ק ו ו י ז י ט א ר ע ן
גראף	ג ר א ף
גראפיניע	ג ר א פ י נ י ע
גראשן	ג ר א ש ן
גרוילעך	ג ר ו י ל ע ך
גרויס	ג ר ו י ס
גרויס־פוילן	ג ר ו י ס ־ פ ו י ל ן
גרויסן	ג ר ו י ס ן
גרויסע	ג ר ו י ס ע
גרויסעס	ג ר ו י ס ע ס
גרויסער	ג ר ו י ס ע ר
גרויסשטאטישן	ג ר ו י ס ש ט א ט י ש ן
גרויען	ג ר ו י ע ן
גרונט	ג ר ו נ ט
גרוש	ג ר ו ש
גריבל	ג ר י ב ל
גריבער	ג ר י ב ע ר
גריידיקער	ג ר י י ד י ק ע ר
גרייז	ג ר י י ז
גרייזן	ג ר י י ז ן
גרייט	ג ר י י ט
גרייטן	ג ר י י ט ן
גריכנלאנד	ג ר י כ נ ל א נ ד
גרימצארן	ג ר י מ צ א ר ן
גרין	ג ר י ן
גרינג	ג ר י נ ג
גרינדן	ג ר י נ ד ן
גרינס	ג ר י נ ס
גרינסן	ג ר י נ ס ן
גרינע	ג ר י נ ע
גרינעם	ג ר י נ ע ם
גרינער	ג ר י נ ע ר
גריסן	ג ר י ס ן
גריץ	ג ר י ץ
גרעזל	ג ר ע ז ל
גרעזער	ג ר ע ז ע ר
גרעסטן	ג ר ע ס ט ן
גרעסטע	ג ר ע ס ט ע
גרעסטער	ג ר ע ס ט ע ר
גרעסער	ג ר ע ס ע ר
גרעסערע	ג ר ע ס ע ר ע
גרעסערער	ג ר ע ס ע ר ע ר
ד	ד
ד'	ד '
דא	ד א
דאגה	ד א ג ה
דאהער	ד א ה ע ר
דאוון	ד א ו ו ן
דאוונט	ד א ו ו נ ט
דאוונען	ד א ו ו נ ע ן
דאווען	ד א ו ו ע ן
דאווענען	ד א ו ו ע נ ע ן
דאורייתא	ד א ו ר י י ת א
דאזיקן	ד א ז י ק ן
דאזיקע	ד א ז י ק ע
דאזיקער	ד א ז י ק ע ר
דאטשע	ד א ט ש ע
דאך	ד א ך
דאך־פענצטערל	ד א ך ־ פ ע נ צ ט ע ר ל
דאכט	ד א כ ט
דאמאלסט	ד א מ א ל ס ט
דאמע	ד א מ ע
דאמען	ד א מ ע ן
דאנטיסט	ד א נ ט י ס ט
דאנערשטאג	ד א נ ע ר ש ט א ג
דאנערשטיק	ד א נ ע ר ש ט י ק
דאנציקער	ד א נ צ י ק ע ר
דאנק	ד א נ ק
דאנקען	ד א נ ק ע ן
דאס	ד א ס
דאסיידיש־לשון	ד א ס י י ד י ש ־ ל ש ו ן
דאקטאר	ד א ק ט א ר
דאקטאר־טיטל	ד א ק ט א ר ־ ט י ט ל
דאקטארקע	ד א ק ט א ר ק ע
דאקטוירים	ד א ק ט ו י ר י ם
דאקטער	ד א ק ט ע ר
דאר	ד א ר
דאראבאן	ד א ר א ב א ן
דארויס	ד א ר ו י ס
דארום	ד א ר ו ם
דארט	ד א ר ט
דארטיקע	ד א ר ט י ק ע
דארטיקער	ד א ר ט י ק ע ר
דארטן	ד א ר ט ן
דארס	ד א ר ס
דארער	ד א ר ע ר
דארף	ד א ר ף
דארפט	ד א ר פ ט
דארפן	ד א ר פ ן
דארפס־הונט	ד א ר פ ס ־ ה ו נ ט
דארפס־ייד	ד א ר פ ס ־ י י ד
דארפסגייער	ד א ר פ ס ג י י ע ר
דארפסטו	ד א ר פ ס ט ו
דאשעק	ד א ש ע ק
דבור	ד ב ו ר
דבורים	ד ב ו ר י ם
דברי	ד ב ר י
דגוש	ד ג ו ש
דו	ד ו
דוד	ד ו ד
דווקא	ד ו ו ק א
דוחק	ד ו ח ק
דויערט	ד ו י ע ר ט
דויערן	ד ו י ע ר ן
דוכט	ד ו כ ט
דוכטן	ד ו כ ט ן
דול	ד ו ל
דונער	ד ו נ ע ר
דופק	ד ו פ ק
דוקא	ד ו ק א
דוקאטן	ד ו ק א ט ן
דור	ד ו ר
דורך	ד ו ר ך
דורכגייענדיק	ד ו ר כ ג י י ע נ ד י ק
דורכגעגאנגען	ד ו ר כ ג ע ג א נ ג ע ן
דורכגענעצט	ד ו ר כ ג ע נ ע צ ט
דורכגעפארן	ד ו ר כ ג ע פ א ר ן
דורכגעפירט	ד ו ר כ ג ע פ י ר ט
דורכגעפלויגן	ד ו ר כ ג ע פ ל ו י ג ן
דורכגעשטופט	ד ו ר כ ג ע ש ט ו פ ט
דורכגעשלאגן	ד ו ר כ ג ע ש ל א ג ן
דורכגעשמועסט	ד ו ר כ ג ע ש מ ו ע ס ט
דורכגעשפאצירט	ד ו ר כ ג ע ש פ א צ י ר ט
דורכהייצן	ד ו ר כ ה י י צ ן
דורכן	ד ו ר כ ן
דורכפאל	ד ו ר כ פ א ל
דורכפארן	ד ו ר כ פ א ר ן
דורכצופירן	ד ו ר כ צ ו פ י ר ן
דורשט	ד ו ר ש ט
די	ד י
דיבוקים	ד י ב ו ק י ם
דיבור	ד י ב ו ר
דיבורים	ד י ב ו ר י ם
דיזן	ד י ז ן
דיזע	ד י ז ע
דיזעם	ד י ז ע ם
דיזער	ד י ז ע ר
דייטש	ד י י ט ש
דייטשישע	ד י י ט ש י ש ע
דייטשל	ד י י ט ש ל
דיין	ד י י ן
דייניקע	ד י י נ י ק ע
דיינע	ד י י נ ע
דיך	ד י ך
דיכטונג	ד י כ ט ו נ ג
דיכטער	ד י כ ט ע ר
דימענט	ד י מ ע נ ט
דין	ד י ן
דינים	ד י נ י ם
דינסטן	ד י נ ס ט ן
דינע	ד י נ ע
דינעם	ד י נ ע ם
דינען	ד י נ ע ן
דיעלע	ד י ע ל ע
דיפלאם	ד י פ ל א ם
דיק	ד י ק
דיקלעכע	ד י ק ל ע כ ע
דיקן	ד י ק ן
דיקס	ד י ק ס
דיר	ד י ר
דירה	ד י ר ה
דישע	ד י ש ע
דלות	ד ל ו ת
דמיון	ד מ י ו ן
דע	ד ע
דעגראדירן	ד ע ג ר א ד י ר ן
דעד	ד ע ד
דעה	ד ע ה
דעות	ד ע ו ת
דעי	ד ע י
דעם	ד ע ם
דעמאלט	ד ע מ א ל ט
דען	ד ע ן
דענסטמאל	ד ע נ ס ט מ א ל
דענצמאל	ד ע נ צ מ א ל
דעסט	ד ע ס ט
דעסטוועגן	ד ע ס ט ו ו ע ג ן
דעקט	ד ע ק ט
דעקל	ד ע ק ל
דעקלאמירט	ד ע ק ל א מ י ר ט
דער	ד ע ר
דערבארעמט	ד ע ר ב א ר ע מ ט
דערביי	ד ע ר ב י י
דערגאנגען	ד ע ר ג א נ ג ע ן
דערגיין	ד ע ר ג י י ן
דערגייען	ד ע ר ג י י ע ן
דערגעבן	ד ע ר ג ע ב ן
דערגרונטעווען	ד ע ר ג ר ו נ ט ע ו ו ע ן
דערהארן	ד ע ר ה א ר ן
דערהערט	ד ע ר ה ע ר ט
דערהערנדיק	ד ע ר ה ע ר נ ד י ק
דערהרגענען	ד ע ר ה ר ג ע נ ע ן
דערוואקסענע	ד ע ר ו ו א ק ס ע נ ע
דערוואקסענעם	ד ע ר ו ו א ק ס ע נ ע ם
דערווארט	ד ע ר ו ו א ר ט
דערוווסט	ד ע ר ו ו ו ס ט
דערווייל	ד ע ר ו ו י י ל
דערוועגן	ד ע ר ו ו ע ג ן
דערויף	ד ע ר ו י ף
דערונטער	ד ע ר ו נ ט ע ר
דערזעט	ד ע ר ז ע ט
דערזען	ד ע ר ז ע ן
דערטאפט	ד ע ר ט א פ ט
דערטראגן	ד ע ר ט ר א ג ן
דעריבער	ד ע ר י ב ע ר
דערין	ד ע ר י ן
דערכאפן	ד ע ר כ א פ ן
דערלאנגט	ד ע ר ל א נ ג ט
דערלאנגען	ד ע ר ל א נ ג ע ן
דערלאנגענדיק	ד ע ר ל א נ ג ע נ ד י ק
דערלויבן	ד ע ר ל ו י ב ן
דערלייגן	ד ע ר ל י י ג ן
דערליידן	ד ע ר ל י י ד ן
דערלעבט	ד ע ר ל ע ב ט
דערלעבן	ד ע ר ל ע ב ן
דערלעג	ד ע ר ל ע ג
דערמאנט	ד ע ר מ א נ ט
דערמאנען	ד ע ר מ א נ ע ן
דערמיט	ד ע ר מ י ט
דערנאך	ד ע ר נ א ך
דערנענטערט	ד ע ר נ ע נ ט ע ר ט
דערפאלגט	ד ע ר פ א ל ג ט
דערפאר	ד ע ר פ א ר
דערפון	ד ע ר פ ו ן
דערפילט	ד ע ר פ י ל ט
דערפער	ד ע ר פ ע ר
דערפרייט	ד ע ר פ ר י י ט
דערצו	ד ע ר צ ו
דערציטערטער	ד ע ר צ י ט ע ר ט ע ר
דערצייל	ד ע ר צ י י ל
דערציילונגען	ד ע ר צ י י ל ו נ ג ע ן
דערציילט	ד ע ר צ י י ל ט
דערציילן	ד ע ר צ י י ל ן
דערקוטשען	ד ע ר ק ו ט ש ע ן
דערקלערט	ד ע ר ק ל ע ר ט
דערקען	ד ע ר ק ע ן
דערקענט	ד ע ר ק ע נ ט
דערקענען	ד ע ר ק ע נ ע ן
דערשטיקטע	ד ע ר ש ט י ק ט ע
דערשיינען	ד ע ר ש י י נ ע ן
דערשלאגענער	ד ע ר ש ל א ג ע נ ע ר
דערשלאפט	ד ע ר ש ל א פ ט
דערשפירט	ד ע ר ש פ י ר ט
דערשראקן	ד ע ר ש ר א ק ן
דערשראקענע	ד ע ר ש ר א ק ע נ ע
דערשראקענעם	ד ע ר ש ר א ק ע נ ע ם
דערשראקענער	ד ע ר ש ר א ק ע נ ע ר
דערשרעקט	ד ע ר ש ר ע ק ט
דעתו	ד ע ת ו
דפן	ד פ ן
דקדוק	ד ק ד ו ק
דר'ערד	ד ר ' ע ר ד
דראמאטישער	ד ר א מ א ט י ש ע ר
דראמע	ד ר א מ ע
דראמען־שרייבער	ד ר א מ ע ן ־ ש ר י י ב ע ר
דראשקעס	ד ר א ש ק ע ס
דרויב	ד ר ו י ב
דרויסן	ד ר ו י ס ן
דרוק	ד ר ו ק
דרוקן	ד ר ו ק ן
דרוקער	ד ר ו ק ע ר
דרוקעריי	ד ר ו ק ע ר י י
דרוקערין	ד ר ו ק ע ר י ן
דריטן	ד ר י ט ן
דריטע	ד ר י ט ע
דריטער	ד ר י ט ע ר
דריי	ד ר י י
דריידלעך	ד ר י י ד ל ע ך
דרייט	ד ר י י ט
דרייסט	ד ר י י ס ט
דרייסיק־פערציק	ד ר י י ס י ק ־ פ ע ר צ י ק
דרייען	ד ר י י ע ן
דרייער	ד ר י י ע ר
דרייפוס	ד ר י י פ ו ס
דרייפוסן	ד ר י י פ ו ס ן
דרייפוסעס	ד ר י י פ ו ס ע ס
דרייציק	ד ר י י צ י ק
דרימל	ד ר י מ ל
דרינגט	ד ר י נ ג ט
דרינגען	ד ר י נ ג ע ן
דרינען	ד ר י נ ע ן
דריקט	ד ר י ק ט
דריקען	ד ר י ק ע ן
דרך	ד ר ך
דרך־ארץ	ד ר ך ־ א ר ץ
דרך־הטבע	ד ר ך ־ ה ט ב ע
דרכי	ד ר כ י
דרענגלעך	ד ר ע נ ג ל ע ך
דרשה	ד ר ש ה
דרשות	ד ר ש ו ת
דרשן	ד ר ש ן
ה'	ה '
האב	ה א ב
האבן	ה א ב ן
האבעליאק	ה א ב ע ל י א ק
האבער	ה א ב ע ר
האדל	ה א ד ל
האווען	ה א ו ו ע ן
האזן	ה א ז ן
האזן־פיסל	ה א ז ן ־ פ י ס ל
האט	ה א ט
האט'ן	ה א ט ' ן
האטץ	ה א ט ץ
האל	ה א ל
האלב	ה א ל ב
האלב־געבעטן	ה א ל ב ־ ג ע ב ע ט ן
האלב־געפרעגט	ה א ל ב ־ ג ע פ ר ע ג ט
האלבן	ה א ל ב ן
האלבע	ה א ל ב ע
האלבער	ה א ל ב ע ר
האלדז	ה א ל ד ז
האלדזן	ה א ל ד ז ן
האלז	ה א ל ז
האלט	ה א ל ט
האלטן	ה א ל ט ן
האלסט	ה א ל ס ט
האלץ	ה א ל ץ
האן	ה א ן
האנאר	ה א נ א ר
האנדל	ה א נ ד ל
האנדלט	ה א נ ד ל ט
האנדלען	ה א נ ד ל ע ן
האנט	ה א נ ט
האנטוך	ה א נ ט ו ך
האנטעך	ה א נ ט ע ך
האנטפאס	ה א נ ט פ א ס
האניק	ה א נ י ק
האניק־קעפלעך	ה א נ י ק ־ ק ע פ ל ע ך
האסט	ה א ס ט
האסטו	ה א ס ט ו
האפט	ה א פ ט
האפענונג	ה א פ ע נ ו נ ג
האפערדיק	ה א פ ע ר ד י ק
האק	ה א ק
האקוס	ה א ק ו ס
האקט	ה א ק ט
האקן	ה א ק ן
האר	ה א ר
האר־פלאקס	ה א ר ־ פ ל א ק ס
הארבן	ה א ר ב ן
הארבעריק	ה א ר ב ע ר י ק
הארבשטארק	ה א ר ב ש ט א ר ק
הארט	ה א ר ט
הארטע	ה א ר ט ע
הארטער	ה א ר ט ע ר
הארינשטיינס	ה א ר י נ ש ט י י נ ס
הארכן	ה א ר כ ן
הארמאניש	ה א ר מ א נ י ש
הארמידער	ה א ר מ י ד ע ר
הארעוועט	ה א ר ע ו ו ע ט
הארעווען	ה א ר ע ו ו ע ן
הארעפאשניקעס	ה א ר ע פ א ש נ י ק ע ס
הארעפאשנעם	ה א ר ע פ א ש נ ע ם
הארפע	ה א ר פ ע
הארץ	ה א ר ץ
הארץ־ווייכיקע	ה א ר ץ ־ ו ו י י כ י ק ע
הארצווייטאג	ה א ר צ ו ו י י ט א ג
הארצט	ה א ר צ ט
הארציק	ה א ר צ י ק
הארציקע	ה א ר צ י ק ע
הארציקער	ה א ר צ י ק ע ר
הארצן	ה א ר צ ן
הבא	ה ב א
הבדלה	ה ב ד ל ה
הבדלות	ה ב ד ל ו ת
הבדלת	ה ב ד ל ת
הבדלתען	ה ב ד ל ת ע ן
הגבור	ה ג ב ו ר
הגדול	ה ג ד ו ל
הגם	ה ג ם
הדאקטאריע	ה ד א ק ט א ר י ע
הדחק	ה ד ח ק
הדל	ה ד ל
הדעות	ה ד ע ו ת
הדר	ה ד ר
הדרשן	ה ד ר ש ן
ההם	ה ה ם
הו־הא	ה ו ־ ה א
הוה	ה ו ה
הויב	ה ו י ב
הויבט	ה ו י ב ט
הוידלקע	ה ו י ד ל ק ע
הוידעט	ה ו י ד ע ט
הוידען	ה ו י ד ע ן
הויז	ה ו י ז
הויזגעזינט	ה ו י ז ג ע ז י נ ט
הויזן	ה ו י ז ן
הויט	ה ו י ט
הויך	ה ו י ך
הויכן	ה ו י כ ן
הויכע	ה ו י כ ע
הויכער	ה ו י כ ע ר
הויל	ה ו י ל
הוילן	ה ו י ל ן
הוילע	ה ו י ל ע
הוילער	ה ו י ל ע ר
הויף	ה ו י ף
הויפטדאמע	ה ו י פ ט ד א מ ע
הויקער	ה ו י ק ע ר
הוליאק	ה ו ל י א ק
הומאניטארע	ה ו מ א נ י ט א ר ע
הומאריסט	ה ו מ א ר י ס ט
הון	ה ו ן
הונגער	ה ו נ ג ע ר
הונגעריק	ה ו נ ג ע ר י ק
הונגעריקער	ה ו נ ג ע ר י ק ע ר
הונגערן	ה ו נ ג ע ר ן
הונדערט	ה ו נ ד ע ר ט
הונדערטער	ה ו נ ד ע ר ט ע ר
הונט	ה ו נ ט
הוסט	ה ו ס ט
הוצאה	ה ו צ א ה
הורוויץ	ה ו ר ו ו י ץ
הורטאווניקעס	ה ו ר ט א ו ו נ י ק ע ס
הושענא־רבה	ה ו ש ע נ א ־ ר ב ה
הושענות	ה ו ש ע נ ו ת
החג	ה ח ג
היבשע	ה י ב ש ע
היגע	ה י ג ע
היגער	ה י ג ע ר
היום	ה י ו ם
היט	ה י ט
היטל	ה י ט ל
היטלען	ה י ט ל ע ן
היטן	ה י ט ן
היי	ה י י
הייבט	ה י י ב ט
הייבן	ה י י ב ן
הייזל	ה י י ז ל
הייזער	ה י י ז ע ר
הייזעריק	ה י י ז ע ר י ק
הייזעריקלעך	ה י י ז ע ר י ק ל ע ך
הייזעריקער	ה י י ז ע ר י ק ע ר
הייזקע	ה י י ז ק ע
הייך	ה י י ך
הייל	ה י י ל
היילט	ה י י ל ט
הייליקן	ה י י ל י ק ן
הייליקע	ה י י ל י ק ע
הייליקער	ה י י ל י ק ע ר
היילן	ה י י ל ן
היים	ה י י ם
היימיש	ה י י מ י ש
היימישן	ה י י מ י ש ן
היימלעכער	ה י י מ ל ע כ ע ר
היינט	ה י י נ ט
היינטיקן	ה י י נ ט י ק ן
היינטיקע	ה י י נ ט י ק ע
הייס	ה י י ס
הייסט	ה י י ס ט
הייסן	ה י י ס ן
הייסע	ה י י ס ע
הייסער	ה י י ס ע ר
הילט	ה י ל ט
הילכט	ה י ל כ ט
הילף	ה י ל ף
הילצערנע	ה י ל צ ע ר נ ע
הילצערנער	ה י ל צ ע ר נ ע ר
הימים	ה י מ י ם
הימל	ה י מ ל
הימעל	ה י מ ע ל
הימעל־פאטער	ה י מ ע ל ־ פ א ט ע ר
הין	ה י ן
הינטישע	ה י נ ט י ש ע
הינטן	ה י נ ט ן
הינטען	ה י נ ט ע ן
הינטער	ה י נ ט ע ר
הינטער־געסלעך	ה י נ ט ע ר ־ ג ע ס ל ע ך
הינטערגעסל	ה י נ ט ע ר ג ע ס ל
הינטערן	ה י נ ט ע ר ן
הינטערשטע	ה י נ ט ע ר ש ט ע
הינער	ה י נ ע ר
הינער־פרעסער	ה י נ ע ר ־ פ ר ע ס ע ר
הינערשע	ה י נ ע ר ש ע
היפשן	ה י פ ש ן
היץ	ה י ץ
הירזשען	ה י ר ז ש ע ן
הכלל	ה כ ל ל
הכנות	ה כ נ ו ת
הכנסת־אורחים	ה כ נ ס ת ־ א ו ר ח י ם
הלואי	ה ל ו א י
הלוואי	ה ל ו ו א י
הלל	ה ל ל
הללויהס	ה ל ל ו י ה ס
הלמאי	ה ל מ א י
המדרש	ה מ ד ר ש
המון	ה מ ו ן
המוציא	ה מ ו צ י א
המות	ה מ ו ת
המזון	ה מ ז ו ן
המכתב	ה מ כ ת ב
המלך	ה מ ל ך
המן	ה מ ן
המנס	ה מ נ ס
המעשה	ה מ ע ש ה
המקומות	ה מ ק ו מ ו ת
הנאה	ה נ א ה
הנביא	ה נ ב י א
הנה	ה נ ה
הסינט	ה ס י נ ט
הסכמה	ה ס כ מ ה
העברעיזמען	ה ע ב ר ע י ז מ ע ן
העברעער	ה ע ב ר ע ע ר
העוויות	ה ע ו ו י ו ת
העזה	ה ע ז ה
העכט	ה ע כ ט
העכסט	ה ע כ ס ט
העכסטנס	ה ע כ ס ט נ ס
העכער	ה ע כ ע ר
העכערע	ה ע כ ע ר ע
העל	ה ע ל
העלד	ה ע ל ד
העלדזער	ה ע ל ד ז ע ר
העלן	ה ע ל ן
העלע	ה ע ל ע
העלענא	ה ע ל ע נ א
העלפט	ה ע ל פ ט
העלפן	ה ע ל פ ן
העמד	ה ע מ ד
העמדלעך	ה ע מ ד ל ע ך
הענגט	ה ע נ ג ט
הענד	ה ע נ ד
הענדום־פענדום	ה ע נ ד ו ם ־ פ ע נ ד ו ם
הענדל	ה ע נ ד ל
הענדלס	ה ע נ ד ל ס
הענדלען	ה ע נ ד ל ע ן
הענט	ה ע נ ט
הענער	ה ע נ ע ר
הענקער	ה ע נ ק ע ר
הענרי	ה ע נ ר י
העפט	ה ע פ ט
העק	ה ע ק
הער	ה ע ר
הערט	ה ע ר ט
הערינג	ה ע ר י נ ג
הערן	ה ע ר ן
הערנדיק	ה ע ר נ ד י ק
הערסט	ה ע ר ס ט
הערצל־קליין	ה ע ר צ ל ־ ק ל י י ן
הערצלעכן	ה ע ר צ ל ע כ ן
הערש־מענדל	ה ע ר ש ־ מ ע נ ד ל
הערשאפטן	ה ע ר ש א פ ט ן
הערשל	ה ע ר ש ל
הערשלס	ה ע ר ש ל ס
הערשלען	ה ע ר ש ל ע ן
הפקר	ה פ ק ר
הפרשה	ה פ ר ש ה
הצלחה	ה צ ל ח ה
הקדש	ה ק ד ש
הקטורת	ה ק ט ו ר ת
הקלע	ה ק ל ע
הקפה	ה ק פ ה
הקפות	ה ק פ ו ת
הר־הזיתים	ה ר ־ ה ז י ת י ם
הרב	ה ר ב
הרגעט	ה ר ג ע ט
הרוביעשויוו	ה ר ו ב י ע ש ו י ו ו
הריגות	ה ר י ג ו ת
השבועות	ה ש ב ו ע ו ת
השביעי	ה ש ב י ע י
השירים	ה ש י ר י ם
השכלה	ה ש כ ל ה
השכלה־זאכן	ה ש כ ל ה ־ ז א כ ן
השם	ה ש ם
השמים	ה ש מ י ם
השנה	ה ש נ ה
השערה	ה ש ע ר ה
התחלה	ה ת ח ל ה
התמדה	ה ת מ ד ה
ו־ק־ד־ל־ת	ו ־ ק ־ ד ־ ל ־ ת
ו־ק־ד־ש־ת	ו ־ ק ־ ד ־ ש ־ ת
ו־קד־לת	ו ־ ק ד ־ ל ת
ואביון	ו א ב י ו ן
ואופן	ו א ו פ ן
ואין	ו א י ן
ואת	ו א ת
ובכל	ו ב כ ל
ובפרט	ו ב פ ר ט
ודורש	ו ד ו ר ש
ודם	ו ד ם
והבדלת	ו ה ב ד ל ת
והכלה	ו ה כ ל ה
והנורא	ו ה נ ו ר א
וואגאן	ו ו א ג א ן
וואגאן־אפטיילונג	ו ו א ג א ן ־ א פ ט י י ל ו נ ג
וואגמייסטער	ו ו א ג מ י י ס ט ע ר
וואגן	ו ו א ג ן
וואזשנע	ו ו א ז ש נ ע
וואיטעק	ו ו א י ט ע ק
וואך	ו ו א ך
וואכן	ו ו א כ ן
וואכנדיקן	ו ו א כ נ ד י ק ן
וואכנס	ו ו א כ נ ס
וואכעדיקן	ו ו א כ ע ד י ק ן
וואכערער	ו ו א כ ע ר ע ר
וואל	ו ו א ל
וואלגערן	ו ו א ל ג ע ר ן
וואלד	ו ו א ל ד
וואלד־אויס	ו ו א ל ד ־ א ו י ס
וואלט	ו ו א ל ט
וואלטן	ו ו א ל ט ן
וואליזקע	ו ו א ל י ז ק ע
וואלן	ו ו א ל ן
וואלעהייד	ו ו א ל ע ה י י ד
וואלקן	ו ו א ל ק ן
וואלקנס	ו ו א ל ק נ ס
וואנאן	ו ו א נ א ן
וואנדערונגען	ו ו א נ ד ע ר ו נ ג ע ן
וואנדערט	ו ו א נ ד ע ר ט
וואנדערן	ו ו א נ ד ע ר ן
וואנט	ו ו א נ ט
וואנטוך	ו ו א נ ט ו ך
וואנטזייגער	ו ו א נ ט ז י י ג ע ר
וואנען	ו ו א נ ע ן
וואנצן	ו ו א נ צ ן
וואנצעס	ו ו א נ צ ע ס
וואס	ו ו א ס
וואס־זשע	ו ו א ס ־ ז ש ע
וואסיל	ו ו א ס י ל
וואסילקאוו	ו ו א ס י ל ק א ו ו
וואסער	ו ו א ס ע ר
וואסער־טרעגער	ו ו א ס ע ר ־ ט ר ע ג ע ר
וואסער־ליליען	ו ו א ס ע ר ־ ל י ל י ע ן
וואסער־פירערס	ו ו א ס ע ר ־ פ י ר ע ר ס
וואסערדיקע	ו ו א ס ע ר ד י ק ע
וואסערלעך	ו ו א ס ע ר ל ע ך
וואסערן	ו ו א ס ע ר ן
וואקסט	ו ו א ק ס ט
וואקסן	ו ו א ק ס ן
וואקסענע	ו ו א ק ס ע נ ע
וואר	ו ו א ר
ווארום	ו ו א ר ו ם
ווארט	ו ו א ר ט
ווארטן	ו ו א ר ט ן
ווארטנדיק	ו ו א ר ט נ ד י ק
ווארע	ו ו א ר ע
ווארעם	ו ו א ר ע ם
ווארעמס	ו ו א ר ע מ ס
ווארעמע	ו ו א ר ע מ ע
ווארעמער	ו ו א ר ע מ ע ר
ווארף	ו ו א ר ף
ווארפט	ו ו א ר פ ט
ווארפן	ו ו א ר פ ן
ווארצלען	ו ו א ר צ ל ע ן
ווארשאווסקי	ו ו א ר ש א ו ו ס ק י
ווארשאווסקין	ו ו א ר ש א ו ו ס ק י ן
ווארשאווסקיס	ו ו א ר ש א ו ו ס ק י ס
ווארשע	ו ו א ר ש ע
וואש	ו ו א ש
וואשט	ו ו א ש ט
וואשי	ו ו א ש י
וואשן	ו ו א ש ן
ווו	ו ו ו
וווהין	ו ו ו ה י ן
ווויל	ו ו ו י ל
וווילטאן	ו ו ו י ל ט א ן
וווילע	ו ו ו י ל ע
וווינט	ו ו ו י נ ט
וווינען	ו ו ו י נ ע ן
ווונד	ו ו ו נ ד
ווונדער	ו ו ו נ ד ע ר
ווונדער־שיין	ו ו ו נ ד ע ר ־ ש י י ן
ווונדערבארן	ו ו ו נ ד ע ר ב א ר ן
ווונדערלעכע	ו ו ו נ ד ע ר ל ע כ ע
ווונק	ו ו ו נ ק
וווקס	ו ו ו ק ס
ווי	ו ו י
וויג	ו ו י ג
וויגט	ו ו י ג ט
וויגל	ו ו י ג ל
וויגן	ו ו י ג ן
וויגקינד	ו ו י ג ק י נ ד
ווידער	ו ו י ד ע ר
ווידעראנאנד	ו ו י ד ע ר א נ א נ ד
ווידערווילן	ו ו י ד ע ר ו ו י ל ן
וויזיט	ו ו י ז י ט
וויטע	ו ו י ט ע
וויי	ו ו י י
ווייב	ו ו י י ב
ווייבל	ו ו י י ב ל
ווייבער	ו ו י י ב ע ר
ווייבעריש	ו ו י י ב ע ר י ש
ווייבערישע	ו ו י י ב ע ר י ש ע
ווייבערישער	ו ו י י ב ע ר י ש ע ר
ווייבערשול	ו ו י י ב ע ר ש ו ל
ווייבערשע	ו ו י י ב ע ר ש ע
וויידל	ו ו י י ד ל
וויידלען	ו ו י י ד ל ע ן
ווייז	ו ו י י ז
ווייזט	ו ו י י ז ט
ווייזט־אן	ו ו י י ז ט ־ א ן
ווייזן	ו ו י י ז ן
ווייזערס	ו ו י י ז ע ר ס
ווייט	ו ו י י ט
ווייט־געעפנטע	ו ו י י ט ־ ג ע ע פ נ ט ע
ווייטיק	ו ו י י ט י ק
ווייטנס	ו ו י י ט נ ס
ווייטע	ו ו י י ט ע
ווייטער	ו ו י י ט ע ר
ווייך	ו ו י י ך
ווייכע	ו ו י י כ ע
ווייכער	ו ו י י כ ע ר
ווייל	ו ו י י ל
וויילע	ו ו י י ל ע
וויין	ו ו י י ן
וויינגארטן	ו ו י י נ ג א ר ט ן
וויינט	ו ו י י נ ט
ווייניק	ו ו י י נ י ק
ווייניקער	ו ו י י נ י ק ע ר
וויינען	ו ו י י נ ע ן
וויינענדיקע	ו ו י י נ ע נ ד י ק ע
ווייס	ו ו י י ס
ווייסט	ו ו י י ס ט
ווייסטו	ו ו י י ס ט ו
ווייסל	ו ו י י ס ל
ווייסלעכער	ו ו י י ס ל ע כ ע ר
ווייסן	ו ו י י ס ן
ווייסע	ו ו י י ס ע
ווייסע־חברה'ניקעס	ו ו י י ס ע ־ ח ב ר ה ' נ י ק ע ס
ווייסע־חברהניקעס	ו ו י י ס ע ־ ח ב ר ה נ י ק ע ס
ווייסער	ו ו י י ס ע ר
ווייץ	ו ו י י ץ
וויכטיק	ו ו י כ ט י ק
וויכטיקן	ו ו י כ ט י ק ן
וויכטיקס	ו ו י כ ט י ק ס
וויל	ו ו י ל
ווילד	ו ו י ל ד
ווילט	ו ו י ל ט
ווילן	ו ו י ל ן
ווילנדיק	ו ו י ל נ ד י ק
ווילנער	ו ו י ל נ ע ר
ווילסט	ו ו י ל ס ט
ווילסטו	ו ו י ל ס ט ו
ווילעדזש	ו ו י ל ע ד ז ש
ווילעדזש־יידן	ו ו י ל ע ד ז ש ־ י י ד ן
ווימאראזיג	ו ו י מ א ר א ז י ג
ווין	ו ו י ן
ווינד	ו ו י נ ד
ווינט	ו ו י נ ט
ווינטמיל	ו ו י נ ט מ י ל
ווינטן	ו ו י נ ט ן
ווינטער	ו ו י נ ט ע ר
ווינטערדיקע	ו ו י נ ט ע ר ד י ק ע
ווינטש	ו ו י נ ט ש
ווינטשט	ו ו י נ ט ש ט
ווינטשן	ו ו י נ ט ש ן
ווינטשנדיק	ו ו י נ ט ש נ ד י ק
ווינציקער	ו ו י נ צ י ק ע ר
ווינקט	ו ו י נ ק ט
ווינקל	ו ו י נ ק ל
ווינקלען	ו ו י נ ק ל ע ן
ווינקען	ו ו י נ ק ע ן
וויסאצקין	ו ו י ס א צ ק י ן
וויסט	ו ו י ס ט
וויסטע	ו ו י ס ט ע
וויסן	ו ו י ס ן
וויסנדיק	ו ו י ס נ ד י ק
וויפל	ו ו י פ ל
וויץ	ו ו י ץ
וויציק	ו ו י צ י ק
ווירובאווא	ו ו י ר ו ב א ו ו א
ווירקלעך	ו ו י ר ק ל ע ך
ווישט	ו ו י ש ט
ווישניצער	ו ו י ש נ י צ ע ר
ווישניק	ו ו י ש נ י ק
וועג	ו ו ע ג
וועגן	ו ו ע ג ן
וועגס	ו ו ע ג ס
וועגעלע	ו ו ע ג ע ל ע
וועדליק	ו ו ע ד ל י ק
וועט	ו ו ע ט
וועטעניש	ו ו ע ט ע נ י ש
וועטשערע	ו ו ע ט ש ע ר ע
וועכטער	ו ו ע כ ט ע ר
וועל	ו ו ע ל
וועלדל	ו ו ע ל ד ל
וועלדער	ו ו ע ל ד ע ר
וועלוועלער	ו ו ע ל ו ו ע ל ע ר
וועלט	ו ו ע ל ט
וועלטזאכן	ו ו ע ל ט ז א כ ן
וועלטן	ו ו ע ל ט ן
וועלכן	ו ו ע ל כ ן
וועלכע	ו ו ע ל כ ע
וועלכער	ו ו ע ל כ ע ר
וועלן	ו ו ע ל ן
וועלעדער	ו ו ע ל ע ד ע ר
וועלף	ו ו ע ל ף
וועם	ו ו ע ם
וועמען	ו ו ע מ ע ן
ווען	ו ו ע ן
ווענדט	ו ו ע נ ד ט
ווענדן	ו ו ע נ ד ן
ווענט	ו ו ע נ ט
וועסט	ו ו ע ס ט
וועסטו	ו ו ע ס ט ו
וועקט	ו ו ע ק ט
וועקן	ו ו ע ק ן
וועקסל	ו ו ע ק ס ל
וועקסן	ו ו ע ק ס ן
ווער	ו ו ע ר
ווערט	ו ו ע ר ט
ווערטל	ו ו ע ר ט ל
ווערטלזאגער	ו ו ע ר ט ל ז א ג ע ר
ווערטעלע	ו ו ע ר ט ע ל ע
ווערטער	ו ו ע ר ט ע ר
ווערי	ו ו ע ר י
ווערים	ו ו ע ר י ם
ווערן	ו ו ע ר ן
ווערסט	ו ו ע ר ס ט
ווערק	ו ו ע ר ק
ווערקע	ו ו ע ר ק ע
וועש	ו ו ע ש
וחשבון	ו ח ש ב ו ן
וידוי	ו י ד ו י
ויהי	ו י ה י
ויהמו	ו י ה מ ו
ויחיו	ו י ח י ו
ויטבו	ו י ט ב ו
וילנע	ו י ל נ ע
ויסע	ו י ס ע
ויעשו	ו י ע ש ו
ויתן	ו י ת ן
וכך	ו כ ך
וכמה	ו כ מ ה
ולא	ו ל א
ולכן	ו ל כ ן
ומי	ו מ י
ומציל	ו מ צ י ל
ונשתומם	ו נ ש ת ו מ ם
ועיר	ו ע י ר
ועל	ו ע ל
וקדלת	ו ק ד ל ת
וקדשת	ו ק ד ש ת
וקדשתען	ו ק ד ש ת ע ן
וראנה	ו ר א נ ה
ושלוה	ו ש ל ו ה
ושלום	ו ש ל ו ם
ושמחה	ו ש מ ח ה
זאג	ז א ג
זאגט	ז א ג ט
זאגט־זשע	ז א ג ט ־ ז ש ע
זאגן	ז א ג ן
זאגנדיק	ז א ג נ ד י ק
זאגסט	ז א ג ס ט
זאגסטו	ז א ג ס ט ו
זאגען	ז א ג ע ן
זאט	ז א ט
זאטשעפען	ז א ט ש ע פ ע ן
זאך	ז א ך
זאכן	ז א כ ן
זאל	ז א ל
זאלב	ז א ל ב
זאלט	ז א ל ט
זאלן	ז א ל ן
זאלסט	ז א ל ס ט
זאלסטו	ז א ל ס ט ו
זאלען	ז א ל ע ן
זאמאסטש	ז א מ א ס ט ש
זאמאשטש	ז א מ א ש ט ש
זאמד	ז א מ ד
זאמלט	ז א מ ל ט
זאמלען	ז א מ ל ע ן
זאנע	ז א נ ע
זאפאני־בראטא	ז א פ א נ י ־ ב ר א ט א
זאפט	ז א פ ט
זאפראן	ז א פ ר א ן
זאפרעשטשאנע	ז א פ ר ע ש ט ש א נ ע
זאץ	ז א ץ
זאק	ז א ק
זאקן	ז א ק ן
זאקן־פאבריקאנט	ז א ק ן ־ פ א ב ר י ק א נ ט
זאקנאדל	ז א ק נ א ד ל
זארג	ז א ר ג
זארגט	ז א ר ג ט
זארגן	ז א ר ג ן
זהב	ז ה ב
זווג	ז ו ו ג
זוילן	ז ו י ל ן
זוימט	ז ו י מ ט
זוימען־שטויב	ז ו י מ ע ן ־ ש ט ו י ב
זויערלעך	ז ו י ע ר ל ע ך
זויערע	ז ו י ע ר ע
זויפל	ז ו י פ ל
זוך	ז ו ך
זוכה	ז ו כ ה
זוכט	ז ו כ ט
זוכן	ז ו כ ן
זול	ז ו ל
זולצערס	ז ו ל צ ע ר ס
זומער	ז ו מ ע ר
זומער־נאכט	ז ו מ ע ר ־ נ א כ ט
זומער־צייט	ז ו מ ע ר ־ צ י י ט
זומערדיק־הייסער	ז ו מ ע ר ד י ק ־ ה י י ס ע ר
זומערווינט	ז ו מ ע ר ו ו י נ ט
זומערווינטן	ז ו מ ע ר ו ו י נ ט ן
זומערנאכט	ז ו מ ע ר נ א כ ט
זומערשטאף	ז ו מ ע ר ש ט א ף
זומערשפרענקעלעך	ז ו מ ע ר ש פ ר ע נ ק ע ל ע ך
זומפ	ז ו מ פ
זומפן	ז ו מ פ ן
זון	ז ו ן
זונגאלד	ז ו נ ג א ל ד
זונטיק	ז ו נ ט י ק
זונס	ז ו נ ס
זוסמאנס	ז ו ס מ א נ ס
זופ	ז ו פ
זי	ז י
זיבן	ז י ב ן
זיבעטער	ז י ב ע ט ע ר
זיבענע	ז י ב ע נ ע
זיבעצן	ז י ב ע צ ן
זידל־נאמען	ז י ד ל ־ נ א מ ע ן
זידלט	ז י ד ל ט
זידלען	ז י ד ל ע ן
זיווג	ז י ו ו ג
זיווג־תחינה	ז י ו ו ג ־ ת ח י נ ה
זיי	ז י י
זייגער	ז י י ג ע ר
זייגערנע	ז י י ג ע ר נ ע
זייד	ז י י ד
זיידל	ז י י ד ל
זיידלען	ז י י ד ל ע ן
זיידן	ז י י ד ן
זיידנס	ז י י ד נ ס
זיידע	ז י י ד ע
זייט	ז י י ט
זייטיק	ז י י ט י ק
זייטיקע	ז י י ט י ק ע
זייטן	ז י י ט ן
זיין	ז י י ן
זיינוולס	ז י י נ ו ו ל ס
זייניקע	ז י י נ י ק ע
זיינס	ז י י נ ס
זיינע	ז י י נ ע
זיינעט	ז י י נ ע ט
זיינעם	ז י י נ ע ם
זיינען	ז י י נ ע ן
זיינער	ז י י נ ע ר
זייען	ז י י ע ן
זייענדיק	ז י י ע נ ד י ק
זייער	ז י י ע ר
זייער־זייער	ז י י ע ר ־ ז י י ע ר
זייערטוועגן	ז י י ע ר ט ו ו ע ג ן
זייערע	ז י י ע ר ע
זייערער	ז י י ע ר ע ר
זיך	ז י ך
זיכער	ז י כ ע ר
זיכערן	ז י כ ע ר ן
זילבער	ז י ל ב ע ר
זילבערנע	ז י ל ב ע ר נ ע
זין	ז י ן
זינג	ז י נ ג
זינגט	ז י נ ג ט
זינגען	ז י נ ג ע ן
זינגענדיק־יאמערדיקן	ז י נ ג ע נ ד י ק ־ י א מ ע ר ד י ק ן
זינגפויגל	ז י נ ג פ ו י ג ל
זינד	ז י נ ד
זינדיק	ז י נ ד י ק
זינדיקסט	ז י נ ד י ק ס ט
זינט	ז י נ ט
זינען	ז י נ ע ן
זיס	ז י ס
זיס־וויינענדיק	ז י ס ־ ו ו י י נ ע נ ד י ק
זיסל	ז י ס ל
זיסלען	ז י ס ל ע ן
זיסן	ז י ס ן
זיסע	ז י ס ע
זיסערע	ז י ס ע ר ע
זיפצט	ז י פ צ ט
זיץ	ז י ץ
זיצט	ז י צ ט
זיצן	ז י צ ן
זיצנדיק	ז י צ נ ד י ק
זכות	ז כ ו ת
זכיה	ז כ י ה
זכר	ז כ ר
זכרון	ז כ ר ו ן
זלאדי	ז ל א ד י
זלאדיעווקע	ז ל א ד י ע ו ו ק ע
זלמן	ז ל מ ן
זמירות	ז מ י ר ו ת
זמן	ז מ ן
זע	ז ע
זעהר	ז ע ה ר
זעונג	ז ע ו נ ג
זעט	ז ע ט
זעכצן	ז ע כ צ ן
זעלביקע	ז ע ל ב י ק ע
זעלבן	ז ע ל ב ן
זעלבע	ז ע ל ב ע
זעלבער	ז ע ל ב ע ר
זעלטן	ז ע ל ט ן
זעליג	ז ע ל י ג
זעליגל	ז ע ל י ג ל
זען	ז ע ן
זענט	ז ע נ ט
זענען	ז ע נ ע ן
זעסט	ז ע ס ט
זעסטו	ז ע ס ט ו
זעען	ז ע ע ן
זעענדיק	ז ע ע נ ד י ק
זעץ	ז ע ץ
זעצט	ז ע צ ט
זעצן	ז ע צ ן
זעק	ז ע ק
זעקל	ז ע ק ל
זעקס	ז ע ק ס
זעקסטן	ז ע ק ס ט ן
זעקסער	ז ע ק ס ע ר
זעקעלע	ז ע ק ע ל ע
זעקעלען	ז ע ק ע ל ע ן
זערנעס	ז ע ר נ ע ס
זשאנדארן	ז ש א נ ד א ר ן
זשארגאן	ז ש א ר ג א ן
זשארגאניסטן	ז ש א ר ג א נ י ס ט ן
זשופיצע	ז ש ו פ י צ ע
זשידי	ז ש י ד י
זשידיווסקא	ז ש י ד י ו ו ס ק א
זשיפע	ז ש י פ ע
זשליאק	ז ש ל י א ק
זשע	ז ש ע
זשעדנע	ז ש ע ד נ ע
חאבן	ח א ב ן
חאט	ח א ט
חבה	ח ב ה
חבר	ח ב ר
חברה	ח ב ר ה
חברה־מאן	ח ב ר ה ־ מ א ן
חברה־משניות	ח ב ר ה ־ מ ש נ י ו ת
חברות	ח ב ר ו ת
חברן	ח ב ר ן
חדושים	ח ד ו ש י ם
חדר	ח ד ר
חדר־געלט	ח ד ר ־ ג ע ל ט
חדר־יונגלעך	ח ד ר ־ י ו נ ג ל ע ך
חדר־יינגל	ח ד ר ־ י י נ ג ל
חדר־יינגלעך	ח ד ר ־ י י נ ג ל ע ך
חדרים	ח ד ר י ם
חודש	ח ו ד ש
חוזק־לאטע	ח ו ז ק ־ ל א ט ע
חול־המועד	ח ו ל ־ ה מ ו ע ד
חולה	ח ו ל ה
חולים	ח ו ל י ם
חולין	ח ו ל י ן
חוסן	ח ו ס ן
חופה	ח ו פ ה
חוץ	ח ו ץ
חוצפה	ח ו צ פ ה
חוקר	ח ו ק ר
חורבן	ח ו ר ב ן
חוש	ח ו ש
חושך	ח ו ש ך
חזיר	ח ז י ר
חזן	ח ז ן
חזנס	ח ז נ ס
חזר	ח ז ר
חי־וקיים	ח י ־ ו ק י י ם
חידוש	ח י ד ו ש
חידושים	ח י ד ו ש י ם
חיות	ח י ו ת
חיי	ח י י
חיים	ח י י ם
חיימניק	ח י י מ נ י ק
חיל	ח י ל
חילול־השם	ח י ל ו ל ־ ה ש ם
חילוף	ח י ל ו ף
חילופט	ח י ל ו פ ט
חילוק	ח י ל ו ק
חכם	ח כ ם
חכמה	ח כ מ ה
חכמים	ח כ מ י ם
חכמת	ח כ מ ת
חלאתן	ח ל א ת ן
חלב	ח ל ב
חלה	ח ל ה
חלום	ח ל ו ם
חלומות	ח ל ו מ ו ת
חלילה	ח ל י ל ה
חליצה־שיך	ח ל י צ ה ־ ש י ך
חלף	ח ל ף
חלק	ח ל ק
חלשות	ח ל ש ו ת
חלשט	ח ל ש ט
חלשן	ח ל ש ן
חן	ח ן
חנא	ח נ א
חנה	ח נ ה
חנוכה	ח נ ו כ ה
חנוכה־ליכטלעך	ח נ ו כ ה ־ ל י כ ט ל ע ך
חנוכה־לעמפלעך	ח נ ו כ ה ־ ל ע מ פ ל ע ך
חניפה	ח נ י פ ה
חניפהלעך	ח נ י פ ה ל ע ך
חס	ח ס
חס־ושלום	ח ס ־ ו ש ל ו ם
חסיד	ח ס י ד
חסידות	ח ס י ד ו ת
חסידים	ח ס י ד י ם
חסר־דעה	ח ס ר ־ ד ע ה
חסרון	ח ס ר ו ן
חסרונות	ח ס ר ו נ ו ת
חפצים	ח פ צ י ם
חצות	ח צ ו ת
חצי	ח צ י
חקירה־ספרים	ח ק י ר ה ־ ס פ ר י ם
חקרן	ח ק ר ן
חרוב	ח ר ו ב
חרותינו	ח ר ו ת י נ ו
חרטה	ח ר ט ה
חריפות	ח ר י פ ו ת
חרם	ח ר ם
חרפה	ח ר פ ה
חשבון	ח ש ב ו ן
חשבונות	ח ש ב ו נ ו ת
חשבונען	ח ש ב ו נ ע ן
חשוב	ח ש ו ב
חשובן	ח ש ו ב ן
חשוך־בנים	ח ש ו ך ־ ב נ י ם
חשק	ח ש ק
חתונה	ח ת ו נ ה
חתונות	ח ת ו נ ו ת
חתימה	ח ת י מ ה
חתמענען	ח ת מ ע נ ע ן
חתן	ח ת ן
חתן־כלה	ח ת ן ־ כ ל ה
ט	ט
ט'אסטו	ט ' א ס ט ו
טא	ט א
טאבאק־פושקע	ט א ב א ק ־ פ ו ש ק ע
טאבליצע	ט א ב ל י צ ע
טאג	ט א ג
טאג־און־נאכט	ט א ג ־ א ו ן ־ נ א כ ט
טאגלי	ט א ג ל י
טאדיען	ט א ד י ע ן
טאטן	ט א ט ן
טאטנס	ט א ט נ ס
טאטע	ט א ט ע
טאטע־מאמע	ט א ט ע ־ מ א מ ע
טאטעס	ט א ט ע ס
טאטער	ט א ט ע ר
טאטשעט	ט א ט ש ע ט
טאכטער	ט א כ ט ע ר
טאכטערל	ט א כ ט ע ר ל
טאכטערס	ט א כ ט ע ר ס
טאלאטשינאווס	ט א ל א ט ש י נ א ו ו ס
טאלסטוי	ט א ל ס ט ו י
טאלער	ט א ל ע ר
טאמער	ט א מ ע ר
טאן	ט א ן
טאנצן	ט א נ צ ן
טאפ	ט א פ
טאפאליעס	ט א פ א ל י ע ס
טאפט	ט א פ ט
טאפלט	ט א פ ל ט
טאפלי	ט א פ ל י
טאפן	ט א פ ן
טאפעלער	ט א פ ע ל ע ר
טאקי	ט א ק י
טאקסע	ט א ק ס ע
טאקע	ט א ק ע
טאר	ט א ר
טאראראם	ט א ר א ר א ם
טארגעס	ט א ר ג ע ס
טארן	ט א ר ן
טבלע	ט ב ל ע
טבלען	ט ב ל ע ן
טבע	ט ב ע
טהור	ט ה ו ר
טו	ט ו
טוב	ט ו ב
טובה	ט ו ב ה
טוביה	ט ו ב י ה
טוביהן	ט ו ב י ה ן
טובים	ט ו ב י ם
טובימס	ט ו ב י מ ס
טוואן	ט ו ו א ן
טוט	ט ו ט
טוי	ט ו י
טוי־באדעקטן	ט ו י ־ ב א ד ע ק ט ן
טויב	ט ו י ב
טויבלעך	ט ו י ב ל ע ך
טויג	ט ו י ג
טויגן	ט ו י ג ן
טויזנט	ט ו י ז נ ט
טויזנטער	ט ו י ז נ ט ע ר
טויט	ט ו י ט
טויט־שיכור	ט ו י ט ־ ש י כ ו ר
טויטן	ט ו י ט ן
טויטן־שטיבל	ט ו י ט ן ־ ש ט י ב ל
טויטע	ט ו י ט ע
טויער	ט ו י ע ר
טוישן	ט ו י ש ן
טומטום	ט ו מ ט ו ם
טומל	ט ו מ ל
טון	ט ו ן
טונקט	ט ו נ ק ט
טונקלהייט	ט ו נ ק ל ה י י ט
טונקעלן	ט ו נ ק ע ל ן
טונקעלע	ט ו נ ק ע ל ע
טונקעלער	ט ו נ ק ע ל ע ר
טועם	ט ו ע ם
טוען	ט ו ע ן
טוענדיק	ט ו ע נ ד י ק
טוץ	ט ו ץ
טורבין	ט ו ר ב י ן
טורמע	ט ו ר מ ע
טיי	ט י י
טייגן	ט י י ג ן
טייטלט	ט י י ט ל ט
טייך	ט י י ך
טייל	ט י י ל
טייער	ט י י ע ר
טייערסטע	ט י י ע ר ס ט ע
טייערע	ט י י ע ר ע
טייערער	ט י י ע ר ע ר
טינט	ט י נ ט
טינטער	ט י נ ט ע ר
טיף	ט י ף
טיפן	ט י פ ן
טיפער	ט י פ ע ר
טיר	ט י ר
טירווענטל	ט י ר ו ו ע נ ט ל
טירן	ט י ר ן
טיש	ט י ש
טישטשע	ט י ש ט ש ע
טלומיק	ט ל ו מ י ק
טלית	ט ל י ת
טלית־און־תפילין	ט ל י ת ־ א ו ן ־ ת פ י ל י ן
טליתים	ט ל י ת י ם
טעאדאר	ט ע א ד א ר
טעאטער	ט ע א ט ע ר
טעאטער־דירעקטאר	ט ע א ט ע ר ־ ד י ר ע ק ט א ר
טעאטער־שטיק	ט ע א ט ע ר ־ ש ט י ק
טעג	ט ע ג
טעוועלע	ט ע ו ו ע ל ע
טעות	ט ע ו ת
טעכטער	ט ע כ ט ע ר
טעכטערל	ט ע כ ט ע ר ל
טעלער	ט ע ל ע ר
טעם	ט ע ם
טעמים	ט ע מ י ם
טעמפל	ט ע מ פ ל
טעמפעלע	ט ע מ פ ע ל ע
טענה	ט ע נ ה
טענהט	ט ע נ ה ט
טענהען	ט ע נ ה ע ן
טענות	ט ע נ ו ת
טענטלען	ט ע נ ט ל ע ן
טענער	ט ע נ ע ר
טענצל	ט ע נ צ ל
טעפלעך	ט ע פ ל ע ך
טעצל	ט ע צ ל
טעקסט	ט ע ק ס ט
טערק	ט ע ר ק
טערקיי	ט ע ר ק י י
טערקישע	ט ע ר ק י ש ע
טערקישער	ט ע ר ק י ש ע ר
טפו	ט פ ו
טפחים	ט פ ח י ם
טפש	ט פ ש
טראג	ט ר א ג
טראגט	ט ר א ג ט
טראגן	ט ר א ג ן
טראגסט	ט ר א ג ס ט
טראגעדיע	ט ר א ג ע ד י ע
טראטוארן	ט ר א ט ו א ר ן
טראכט	ט ר א כ ט
טראכטן	ט ר א כ ט ן
טראכטנדיק	ט ר א כ ט נ ד י ק
טראמוויי	ט ר א מ ו ו י י
טראמווייס	ט ר א מ ו ו י י ס
טראף	ט ר א ף
טראפן	ט ר א פ ן
טראץ	ט ר א ץ
טרובאטש	ט ר ו ב א ט ש
טרוים־פירנדיקער	ט ר ו י ם ־ פ י ר נ ד י ק ע ר
טרויער	ט ר ו י ע ר
טרויערט	ט ר ו י ע ר ט
טרויעריק	ט ר ו י ע ר י ק
טרויעריקן	ט ר ו י ע ר י ק ן
טרויעריקע	ט ר ו י ע ר י ק ע
טרונק	ט ר ו נ ק
טרופע	ט ר ו פ ע
טרוקן	ט ר ו ק ן
טרוקענע	ט ר ו ק ע נ ע
טרוקענער	ט ר ו ק ע נ ע ר
טרחה	ט ר ח ה
טריב	ט ר י ב
טריט	ט ר י ט
טריי	ט ר י י
טרייבט	ט ר י י ב ט
טרייסט	ט ר י י ס ט
טרייסלט	ט ר י י ס ל ט
טרייסלען	ט ר י י ס ל ע ן
טרייף	ט ר י י ף
טרינקאען	ט ר י נ ק א ע ן
טרינקט	ט ר י נ ק ט
טרינקן	ט ר י נ ק ן
טרינקען	ט ר י נ ק ע ן
טרעגער	ט ר ע ג ע ר
טרעגערס	ט ר ע ג ע ר ס
טרעט	ט ר ע ט
טרעף	ט ר ע ף
טרעפ	ט ר ע פ
טרעפט	ט ר ע פ ט
טרעפן	ט ר ע פ ן
טרערן	ט ר ע ר ן
טשווישן	ט ש ו ו י ש ן
טשוירטש	ט ש ו י ר ט ש
טשולאנטשיק	ט ש ו ל א נ ט ש י ק
טשייניקל	ט ש י י נ י ק ל
טשיקאווע	ט ש י ק א ו ו ע
טשעבילסקיס	ט ש ע ב י ל ס ק י ס
טשעמאדאנטשיק	ט ש ע מ א ד א נ ט ש י ק
טשעקאווע	ט ש ע ק א ו ו ע
יא	י א
יאבדו	י א ב ד ו
יאגט	י א ג ט
יאגן	י א ג ן
יאגנדיק	י א ג נ ד י ק
יאדרא	י א ד ר א
יאכנוק	י א כ נ ו ק
יאלד	י א ל ד
יאמער	י א מ ע ר
יאמערלעך	י א מ ע ר ל ע ך
יאנדעס	י א נ ד ע ס
יאנעוו	י א נ ע ו ו
יאנקל	י א נ ק ל
יאסמין	י א ס מ י ן
יאסעלע	י א ס ע ל ע
יאר	י א ר
יארמולקע	י א ר מ ו ל ק ע
יארן	י א ר ן
יארעמע	י א ר ע מ ע
יאשעק	י א ש ע ק
יאשעקן	י א ש ע ק ן
יהונתן	י ה ו נ ת ן
יהונתנען	י ה ו נ ת נ ע ן
יהושע־העשל	י ה ו ש ע ־ ה ע ש ל
יהושע־העשלס	י ה ו ש ע ־ ה ע ש ל ס
יובל	י ו ב ל
יוגנט	י ו ג נ ט
יודאפאב	י ו ד א פ א ב
יודישען	י ו ד י ש ע ן
יודע	י ו ד ע
יודעלע	י ו ד ע ל ע
יוונישע	י ו ו נ י ש ע
יוזיפיל	י ו ז י פ י ל
יויך	י ו י ך
יוכע	י ו כ ע
יום	י ו ם
יום־	י ו ם ־
יום־טוב	י ו ם ־ ט ו ב
יום־טובדיק	י ו ם ־ ט ו ב ד י ק
יום־טובדיקן	י ו ם ־ ט ו ב ד י ק ן
יום־טובדיקער	י ו ם ־ ט ו ב ד י ק ע ר
יום־כיפור	י ו ם ־ כ י פ ו ר
יום־כפור	י ו ם ־ כ פ ו ר
יומא	י ו מ א
יונג	י ו נ ג
יונגווארג	י ו נ ג ו ו א ר ג
יונגע	י ו נ ג ע
יונגע־לייט	י ו נ ג ע ־ ל י י ט
יונגעטשקער	י ו נ ג ע ט ש ק ע ר
יונגען	י ו נ ג ע ן
יונגענמאן	י ו נ ג ע נ מ א ן
יונגער	י ו נ ג ע ר
יונגער־מאן	י ו נ ג ע ר ־ מ א ן
יונגערמאן	י ו נ ג ע ר מ א ן
יוניש	י ו נ י ש
יוסטן	י ו ס ט ן
יוסטע	י ו ס ט ע
יוסלען	י ו ס ל ע ן
יופיצע	י ו פ י צ ע
יופע	י ו פ ע
יוצא	י ו צ א
יוראפ	י ו ר א פ
יורד	י ו ר ד
יושבים	י ו ש ב י ם
יושר	י ו ש ר
יחוס	י ח ו ס
יחות	י ח ו ת
יי	י י
ייד	י י ד
יידינע	י י ד י נ ע
יידיש	י י ד י ש
יידישיסטן	י י ד י ש י ס ט ן
יידישן	י י ד י ש ן
יידישע	י י ד י ש ע
יידישער	י י ד י ש ע ר
יידישקייט	י י ד י ש ק י י ט
יידל	י י ד ל
יידן	י י ד ן
יידעלע	י י ד ע ל ע
יידעלעך	י י ד ע ל ע ך
יידענע	י י ד ע נ ע
יידענעס	י י ד ע נ ע ס
יינגל	י י נ ג ל
יינגלעך	י י נ ג ל ע ך
יינגסטן	י י נ ג ס ט ן
יינגערע	י י נ ג ע ר ע
יישוב־הדעת	י י ש ו ב ־ ה ד ע ת
ים	י ם
ים־סוף	י ם ־ ס ו ף
ימח	י מ ח
ימי	י מ י
ימים	י מ י ם
ימים־טובים	י מ י ם ־ ט ו ב י ם
ימים־נוראים	י מ י ם ־ נ ו ר א י ם
ימים־נוראימדיקער	י מ י ם ־ נ ו ר א י מ ד י ק ע ר
יסורים	י ס ו ר י ם
יעדן	י ע ד ן
יעדע	י ע ד ע
יעדעס	י ע ד ע ס
יעדער	י ע ד ע ר
יעדערן	י ע ד ע ר ן
יעלה	י ע ל ה
יעלות	י ע ל ו ת
יענע	י ע נ ע
יענעם	י ע נ ע ם
יענעמס	י ע נ ע מ ס
יענעס	י ע נ ע ס
יענער	י ע נ ע ר
יענץ	י ע נ ץ
יענקיס	י ע נ ק י ס
יעצו	י ע צ ו
יעצט	י ע צ ט
יעקב	י ע ק ב
יצאה	י צ א ה
יצחק	י צ ח ק
יצר־הרע	י צ ר ־ ה ר ע
יצר־הרע־בלעטערלעך	י צ ר ־ ה ר ע ־ ב ל ע ט ע ר ל ע ך
יקום־	י ק ו ם ־
ירא־אלוהים	י ר א ־ א ל ו ה י ם
ירא־שמים	י ר א ־ ש מ י ם
יראת־שמיים־פענעמל	י ר א ת ־ ש מ י י ם ־ פ ע נ ע מ ל
ירדן	י ר ד ן
ירוחם	י ר ו ח ם
ירוחם־גרונים	י ר ו ח ם ־ ג ר ו נ י ם
ירושה	י ר ו ש ה
יריד	י ר י ד
יריחו	י ר י ח ו
ירצה	י ר צ ה
יש	י ש
ישיבה־בחורים	י ש י ב ה ־ ב ח ו ר י ם
ישראל	י ש ר א ל
ישראליק	י ש ר א ל י ק
יתברך	י ת ב ר ך
יתום	י ת ו ם
יתומות	י ת ו מ ו ת
יתומים	י ת ו מ י ם
יתומישע	י ת ו מ י ש ע
יתומס	י ת ו מ ס
כ'בין	כ ' ב י ן
כ'גיי	כ ' ג י י
כ'האב	כ ' ה א ב
כ'וואלט	כ ' ו ו א ל ט
כ'ווייס	כ ' ו ו י י ס
כ'וויל	כ ' ו ו י ל
כ'זאג	כ ' ז א ג
כ'טו	כ ' ט ו
כ'לעבן	כ ' ל ע ב ן
כ'מיין	כ ' מ י י ן
כ'נעם	כ ' נ ע ם
כ'פארשטיי	כ ' פ א ר ש ט י י
כ'קום	כ ' ק ו ם
כא	כ א
כא־כא־כא־כא־כא	כ א ־ כ א ־ כ א ־ כ א ־ כ א
כאטש	כ א ט ש
כאליאסטרע	כ א ל י א ס ט ר ע
כאליערע	כ א ל י ע ר ע
כאלערע	כ א ל ע ר ע
כאמולע	כ א מ ו ל ע
כאפ	כ א פ
כאפ־אונטער	כ א פ ־ א ו נ ט ע ר
כאפט	כ א פ ט
כאפן	כ א פ ן
כאפעניש	כ א פ ע נ י ש
כאראקטארן	כ א ר א ק ט א ר ן
כאראקטער־ראליסט	כ א ר א ק ט ע ר ־ ר א ל י ס ט
כארכלעניש	כ א ר כ ל ע נ י ש
כאשר	כ א ש ר
כבוא	כ ב ו א
כבוד	כ ב ו ד
כביכול	כ ב י כ ו ל
כדאי	כ ד א י
כדי	כ ד י
כדין	כ ד י ן
כוואליעס	כ ו ו א ל י ע ס
כוונה	כ ו ו נ ה
כוח	כ ו ח
כוחות	כ ו ח ו ת
כוסות	כ ו ס ו ת
כורעים	כ ו ר ע י ם
כח	כ ח
כיד־המלך	כ י ד ־ ה מ ל ך
כיכיקעט	כ י כ י ק ע ט
כיכעניש	כ י כ ע נ י ש
כירורג	כ י ר ו ר ג
כישוף	כ י ש ו ף
כישוף־מאכער	כ י ש ו ף ־ מ א כ ע ר
כישוף־מעשהלע	כ י ש ו ף ־ מ ע ש ה ל ע
כך	כ ך
כל	כ ל
כל־זמן	כ ל ־ ז מ ן
כל־נדרי	כ ל ־ נ ד ר י
כלאמידע	כ ל א מ י ד ע
כלה	כ ל ה
כלה־מיידלעך	כ ל ה ־ מ י י ד ל ע ך
כלהס	כ ל ה ס
כלום	כ ל ו ם
כלומרשט	כ ל ו מ ר ש ט
כלי־בית	כ ל י ־ ב י ת
כלי־זמר	כ ל י ־ ז מ ר
כלים	כ ל י ם
כלל	כ ל ל
כמה	כ מ ה
כמו	כ מ ו
כמעט	כ מ ע ט
כן	כ ן
כסדר	כ ס ד ר
כסרילעווקע	כ ס ר י ל ע ו ו ק ע
כעלם	כ ע ל ם
כעלמער	כ ע ל מ ע ר
כעני	כ ע נ י
כעס	כ ע ס
כעסן	כ ע ס ן
כף	כ ף
כף־הקל	כ ף ־ ה ק ל
כפור	כ פ ו ר
כפרה	כ פ ר ה
כפרות	כ פ ר ו ת
כפתור־ופרח	כ פ ת ו ר ־ ו פ ר ח
כריין	כ ר י י ן
כרעמזלעך	כ ר ע מ ז ל ע ך
כשר	כ ש ר
כשרה	כ ש ר ה
כשרן	כ ש ר ן
כשרע	כ ש ר ע
כשרער	כ ש ר ע ר
כתב	כ ת ב
כתב־רבא	כ ת ב ־ ר ב א
כתבים	כ ת ב י ם
כתובה	כ ת ו ב ה
כתרילעווקע	כ ת ר י ל ע ו ו ק ע
כתרילעווקער	כ ת ר י ל ע ו ו ק ע ר
ל	ל
לא	ל א
לאבל	ל א ב ל
לאבן	ל א ב ן
לאגיש	ל א ג י ש
לאדזש	ל א ד ז ש
לאדן	ל א ד ן
לאדנטיש	ל א ד נ ט י ש
לאה	ל א ה
לאז	ל א ז
לאזט	ל א ז ט
לאזן	ל א ז ן
לאזסטו	ל א ז ס ט ו
לאחדימניצעס	ל א ח ד י מ נ י צ ע ס
לאטע	ל א ט ע
לאטקע	ל א ט ק ע
לאך	ל א ך
לאכט	ל א כ ט
לאכן	ל א כ ן
לאכסט	ל א כ ס ט
לאכען	ל א כ ע ן
לאם	ל א ם
לאמבארי	ל א מ ב א ר י
לאמיך	ל א מ י ך
לאמיר	ל א מ י ר
לאנג	ל א נ ג
לאנגווייליק	ל א נ ג ו ו י י ל י ק
לאנגלעכע	ל א נ ג ל ע כ ע
לאנגן	ל א נ ג ן
לאנגע	ל א נ ג ע
לאנגען	ל א נ ג ע ן
לאנגער	ל א נ ג ע ר
לאנדאן	ל א נ ד א ן
לאסט	ל א ס ט
לאקשן	ל א ק ש ן
לארד	ל א ר ד
לאשעק	ל א ש ע ק
לבטלה	ל ב ט ל ה
לביתו	ל ב י ת ו
לבנה	ל ב נ ה
לדוגמא	ל ד ו ג מ א
לה	ל ה
להבדיל	ל ה ב ד י ל
להבה	ל ה ב ה
להוט	ל ה ו ט
להחתן	ל ה ח ת ן
להכעיס	ל ה כ ע י ס
להם	ל ה ם
לובלין	ל ו ב ל י ן
לובלינערס	ל ו ב ל י נ ע ר ס
לוויה	ל ו ו י ה
לוויה־גייערקע	ל ו ו י ה ־ ג י י ע ר ק ע
לוי	ל ו י
לוי־יצחק	ל ו י ־ י צ ח ק
לויב	ל ו י ב
לויבן	ל ו י ב ן
לויט	ל ו י ט
לוין	ל ו י ן
לוינט	ל ו י נ ט
לויף	ל ו י ף
לויפט	ל ו י פ ט
לויפן	ל ו י פ ן
לויפסט	ל ו י פ ס ט
לויפערס	ל ו י פ ע ר ס
לויתן	ל ו י ת ן
לומדות	ל ו מ ד ו ת
לומדים	ל ו מ ד י ם
לונג־און־לעבערס	ל ו נ ג ־ א ו ן ־ ל ע ב ע ר ס
לונגלעך	ל ו נ ג ל ע ך
לונגען	ל ו נ ג ע ן
לוסטיקער	ל ו ס ט י ק ע ר
לועג	ל ו ע ג
לופט	ל ו פ ט
לופטן	ל ו פ ט ן
לחיים	ל ח י י ם
לחכמים	ל ח כ מ י ם
לחלוטין	ל ח ל ו ט י ן
לחם	ל ח ם
לחתום	ל ח ת ו ם
ליאדע	ל י א ד ע
ליאפעס	ל י א פ ע ס
ליארעם	ל י א ר ע ם
ליב	ל י ב
ליבן	ל י ב ן
ליבע	ל י ב ע
ליבער	ל י ב ע ר
ליבערשט	ל י ב ע ר ש ט
ליבשאפט	ל י ב ש א פ ט
ליגט	ל י ג ט
ליגן	ל י ג ן
ליגנער	ל י ג נ ע ר
ליגנערס	ל י ג נ ע ר ס
ליד	ל י ד
לידל	ל י ד ל
לידלעך	ל י ד ל ע ך
לידער	ל י ד ע ר
ליהודעם	ל י ה ו ד ע ם
ליולקע	ל י ו ל ק ע
ליטוואק	ל י ט ו ו א ק
ליטוואקעס	ל י ט ו ו א ק ע ס
ליטע	ל י ט ע
לייב	ל י י ב
לייבוש	ל י י ב ו ש
לייבל	ל י י ב ל
לייבן	ל י י ב ן
לייג	ל י י ג
לייגט	ל י י ג ט
לייגן	ל י י ג ן
לייגסט	ל י י ג ס ט
ליידט	ל י י ד ט
ליידיק	ל י י ד י ק
ליידן	ל י י ד ן
לייוונטענע	ל י י ו ו נ ט ע נ ע
לייזונג	ל י י ז ו נ ג
לייזער	ל י י ז ע ר
לייזער־יוסל	ל י י ז ע ר ־ י ו ס ל
לייזער־יוסלן	ל י י ז ע ר ־ י ו ס ל ן
לייזער־יוסלען	ל י י ז ע ר ־ י ו ס ל ע ן
לייט	ל י י ט
לייטזעליקייט	ל י י ט ז ע ל י ק י י ט
לייטזעליקע	ל י י ט ז ע ל י ק ע
לייטישן	ל י י ט י ש ן
לייטישע	ל י י ט י ש ע
לייטישער	ל י י ט י ש ע ר
לייטן	ל י י ט ן
לייטס	ל י י ט ס
לייכט	ל י י כ ט
לייכטער	ל י י כ ט ע ר
ליימען	ל י י מ ע ן
לייענט	ל י י ע נ ט
לייענען	ל י י ע נ ע ן
לייפציג	ל י י פ צ י ג
לייקענען	ל י י ק ע נ ע ן
ליכט	ל י כ ט
ליכטיק	ל י כ ט י ק
ליכטיקייט	ל י כ ט י ק י י ט
ליכטיקן	ל י כ ט י ק ן
ליכטיקער	ל י כ ט י ק ע ר
לינדע	ל י נ ד ע
לינקס	ל י נ ק ס
לינקע	ל י נ ק ע
לינקער	ל י נ ק ע ר
ליסט	ל י ס ט
ליפן	ל י פ ן
ליפעס	ל י פ ע ס
ליציטירט	ל י צ י ט י ר ט
לכבוד	ל כ ב ו ד
לכל	ל כ ל
למאי	ל מ א י
למדן	ל מ ד ן
למוד	ל מ ו ד
למות	ל מ ו ת
למען	ל מ ע ן
למעריב	ל מ ע ר י ב
לנו	ל נ ו
לסוף	ל ס ו ף
לעב	ל ע ב
לעבט	ל ע ב ט
לעבן	ל ע ב ן
לעבסט	ל ע ב ס ט
לעבעדיק	ל ע ב ע ד י ק
לעבעדיקע	ל ע ב ע ד י ק ע
לעבעדיקער	ל ע ב ע ד י ק ע ר
לעבעדיקערהייט	ל ע ב ע ד י ק ע ר ה י י ט
לעגאליזירט	ל ע ג א ל י ז י ר ט
לעדערנעם	ל ע ד ע ר נ ע ם
לעולם	ל ע ו ל ם
לעטשלעך	ל ע ט ש ל ע ך
לעיר	ל ע י ר
לעכל	ל ע כ ל
לעכלעך	ל ע כ ל ע ך
לעכערדיקן	ל ע כ ע ר ד י ק ן
לעמבערג	ל ע מ ב ע ר ג
לעמבעריק	ל ע מ ב ע ר י ק
לעמל	ל ע מ ל
לענג	ל ע נ ג
לענגער	ל ע נ ג ע ר
לענגערע	ל ע נ ג ע ר ע
לענדן	ל ע נ ד ן
לענדער	ל ע נ ד ע ר
לענט	ל ע נ ט
לעסינג	ל ע ס י נ ג
לעפצן	ל ע פ צ ן
לעצטן	ל ע צ ט ן
לעצטנס	ל ע צ ט נ ס
לעצטע	ל ע צ ט ע
לעצטער	ל ע צ ט ע ר
לעק	ל ע ק
לעקיש	ל ע ק י ש
לעקישבערן	ל ע ק י ש ב ע ר ן
לעקעך	ל ע ק ע ך
לער	ל ע ר
לערן	ל ע ר ן
לערנט	ל ע ר נ ט
לערניינגל	ל ע ר נ י י נ ג ל
לערנען	ל ע ר נ ע ן
לערער	ל ע ר ע ר
לעשן	ל ע ש ן
לץ	ל ץ
לצים	ל צ י ם
לצלן	ל צ ל ן
לצנות	ל צ נ ו ת
לקדושת	ל ק ד ו ש ת
לרוב	ל ר ו ב
לרש	ל ר ש
לשבת	ל ש ב ת
לשון	ל ש ו ן
לשון־קודש	ל ש ו ן ־ ק ו ד ש
לשון־קודש־ווארט	ל ש ו ן ־ ק ו ד ש ־ ו ו א ר ט
לשון־קודשיסטן	ל ש ו ן ־ ק ו ד ש י ס ט ן
לשלום	ל ש ל ו ם
מ'איז	מ ' א י ז
מ'בלייבט	מ ' ב ל י י ב ט
מ'גייט	מ ' ג י י ט
מ'האט	מ ' ה א ט
מ'וועט	מ ' ו ו ע ט
מ'זאל	מ ' ז א ל
מ'זעט	מ ' ז ע ט
מ'לייענט	מ ' ל י י ע נ ט
מ'לערנט	מ ' ל ע ר נ ט
מ'מאכט	מ ' מ א כ ט
מ'מיינט	מ ' מ י י נ ט
מ'פארגעסט	מ ' פ א ר ג ע ס ט
מ'קאן	מ ' ק א ן
מ'קען	מ ' ק ע ן
מ'רופט	מ ' ר ו פ ט
מ'שלעפט	מ ' ש ל ע פ ט
מ'שמעקט	מ ' ש מ ע ק ט
מ־ל־ך	מ ־ ל ־ ך
מאגן	מ א ג ן
מאגן־שטערונג	מ א ג ן ־ ש ט ע ר ו נ ג
מאגער	מ א ג ע ר
מאדנע	מ א ד נ ע
מאדנעם	מ א ד נ ע ם
מאדנער	מ א ד נ ע ר
מאדע	מ א ד ע
מאה	מ א ה
מאושטשינע	מ א ו ש ט ש י נ ע
מאטיוון	מ א ט י ו ו ן
מאטערניש	מ א ט ע ר נ י ש
מאיר	מ א י ר
מאך	מ א ך
מאכארקע	מ א כ א ר ק ע
מאכט	מ א כ ט
מאכל	מ א כ ל
מאכן	מ א כ ן
מאל	מ א ל
מאלארוסיש	מ א ל א ר ו ס י ש
מאלט	מ א ל ט
מאלן	מ א ל ן
מאלע	מ א ל ע
מאמע	מ א מ ע
מאמע־לשון	מ א מ ע ־ ל ש ו ן
מאמען	מ א מ ע ן
מאמעס	מ א מ ע ס
מאמרים	מ א מ ר י ם
מאן	מ א ן
מאנאלאג	מ א נ א ל א ג
מאנוסקריפט	מ א נ ו ס ק ר י פ ט
מאנופאקטור־סוחר	מ א נ ו פ א ק ט ו ר ־ ס ו ח ר
מאנט	מ א נ ט
מאנטיק	מ א נ ט י ק
מאניפארגע	מ א נ י פ א ר ג ע
מאנס	מ א נ ס
מאנסביל	מ א נ ס ב י ל
מאנסלייט	מ א נ ס ל י י ט
מאנעוורעס	מ א נ ע ו ו ר ע ס
מאנען	מ א נ ע ן
מאנענדיק	מ א נ ע נ ד י ק
מאס	מ א ס
מאסאזש	מ א ס א ז ש
מאסף	מ א ס ף
מאסקוויטעריש	מ א ס ק ו ו י ט ע ר י ש
מאסקווע	מ א ס ק ו ו ע
מאראל	מ א ר א ל
מארגן	מ א ר ג ן
מארגנס	מ א ר ג נ ס
מארגנשטערן	מ א ר ג נ ש ט ע ר ן
מארדע	מ א ר ד ע
מארך־ביין	מ א ר ך ־ ב י י ן
מארצעפאנעס	מ א ר צ ע פ א נ ע ס
מארק	מ א ר ק
מארקאוויטש	מ א ר ק א ו ו י ט ש
מארקאוויטשן	מ א ר ק א ו ו י ט ש ן
מארשירט	מ א ר ש י ר ט
מאשין	מ א ש י ן
מאשינעס	מ א ש י נ ע ס
מבולבלער	מ ב ו ל ב ל ע ר
מבטיח	מ ב ט י ח
מבינות	מ ב י נ ו ת
מבינים	מ ב י נ י ם
מג'	מ ג '
מגולגל	מ ג ו ל ג ל
מגיד	מ ג י ד
מגן־דודל	מ ג ן ־ ד ו ד ל
מגפה	מ ג פ ה
מגרש	מ ג ר ש
מדבריות	מ ד ב ר י ו ת
מדינה	מ ד י נ ה
מדינות	מ ד י נ ו ת
מדרגה	מ ד ר ג ה
מדרש	מ ד ר ש
מה־יעשהניק	מ ה ־ י ע ש ה נ י ק
מה־יפית	מ ה ־ י פ י ת
מהדר	מ ה ד ר
מהומה	מ ה ו מ ה
מהכתיתי	מ ה כ ת י ת י
מהלך	מ ה ל ך
מודה	מ ו ד ה
מוהל	מ ו ה ל
מוז	מ ו ז
מוזט	מ ו ז ט
מוזינקע	מ ו ז י נ ק ע
מוזיק	מ ו ז י ק
מוזן	מ ו ז ן
מוח	מ ו ח
מוחות	מ ו ח ו ת
מוחל	מ ו ח ל
מוטער	מ ו ט ע ר
מוטערס	מ ו ט ע ר ס
מוטשעט	מ ו ט ש ע ט
מויד	מ ו י ד
מוידן	מ ו י ד ן
מויל	מ ו י ל
מויער	מ ו י ע ר
מויערל	מ ו י ע ר ל
מויערן	מ ו י ע ר ן
מוכיח	מ ו כ י ח
מוכר־ספרים	מ ו כ ר ־ ס פ ר י ם
מוכר־ספרימניק	מ ו כ ר ־ ס פ ר י מ נ י ק
מולטערס	מ ו ל ט ע ר ס
מומע	מ ו מ ע
מוסף	מ ו ס ף
מוסר	מ ו ס ר
מוסר־ספרים	מ ו ס ר ־ ס פ ר י ם
מוסרט	מ ו ס ר ט
מופט	מ ו פ ט
מוקצה	מ ו ק צ ה
מורא	מ ו ר א
מוראדיק	מ ו ר א ד י ק
מוראדיקער	מ ו ר א ד י ק ע ר
מורה־הוראה	מ ו ר ה ־ ה ו ר א ה
מורמל	מ ו ר מ ל
מורמלט	מ ו ר מ ל ט
מזג־טוב	מ ז ג ־ ט ו ב
מזוזה	מ ז ו ז ה
מזומנים	מ ז ו מ נ י ם
מזל	מ ז ל
מזל־טוב	מ ז ל ־ ט ו ב
מזלדיק	מ ז ל ד י ק
מזלדיקע	מ ז ל ד י ק ע
מזלדיקער	מ ז ל ד י ק ע ר
מזרח־וואנט	מ ז ר ח ־ ו ו א נ ט
מחבר	מ ח ב ר
מחדש	מ ח ד ש
מחויב	מ ח ו י ב
מחותן	מ ח ו ת ן
מחותנים	מ ח ו ת נ י ם
מחיה	מ ח י ה
מחיהדיקער	מ ח י ה ד י ק ע ר
מחילה	מ ח י ל ה
מחמת	מ ח מ ת
מחנה	מ ח נ ה
מחנות	מ ח נ ו ת
מחשבות	מ ח ש ב ו ת
מטבע	מ ט ב ע
מטופל	מ ט ו פ ל
מטמון	מ ט מ ו ן
מטריח	מ ט ר י ח
מי	מ י
מי־יודע	מ י ־ י ו ד ע
מיאוס	מ י א ו ס
מיאוסן	מ י א ו ס ן
מיאוסע	מ י א ו ס ע
מיאוסער	מ י א ו ס ע ר
מיאש	מ י א ש
מיד	מ י ד
מידה	מ י ד ה
מידע	מ י ד ע
מידער	מ י ד ע ר
מיוחס	מ י ו ח ס
מיוחסים	מ י ו ח ס י ם
מיזרח	מ י ז ר ח
מיט	מ י ט
מיטאג	מ י ט א ג
מיטגעגעבן	מ י ט ג ע ג ע ב ן
מיטגעלאכט	מ י ט ג ע ל א כ ט
מיטגענומען	מ י ט ג ע נ ו מ ע ן
מיטגעפאסט	מ י ט ג ע פ א ס ט
מיטה	מ י ט ה
מיטינג	מ י ט י נ ג
מיטל־וווקסיק	מ י ט ל ־ ו ו ו ק ס י ק
מיטל־יאריקער	מ י ט ל ־ י א ר י ק ע ר
מיטלסטן	מ י ט ל ס ט ן
מיטן	מ י ט ן
מיטנעמען	מ י ט נ ע מ ע ן
מיטצוגעבן	מ י ט צ ו ג ע ב ן
מיטשווייגן	מ י ט ש ו ו י י ג ן
מיידל	מ י י ד ל
מיידלס	מ י י ד ל ס
מיידלעך	מ י י ד ל ע ך
מיידן	מ י י ד ן
מיידעלע	מ י י ד ע ל ע
מייז	מ י י ז
מייטשיק	מ י י ט ש י ק
מייל	מ י י ל
מיילן	מ י י ל ן
מיילער	מ י י ל ע ר
מיין	מ י י ן
מיינונג	מ י י נ ו נ ג
מיינט	מ י י נ ט
מיינס	מ י י נ ס
מיינסט	מ י י נ ס ט
מיינע	מ י י נ ע
מיינעם	מ י י נ ע ם
מיינען	מ י י נ ע ן
מיינער	מ י י נ ע ר
מייסטערס	מ י י ס ט ע ר ס
מייעץ	מ י י ע ץ
מייק	מ י י ק
מיישב	מ י י ש ב
מיך	מ י ך
מיל	מ י ל
מילא	מ י ל א
מיליאן	מ י ל י א ן
מיליאנען	מ י ל י א נ ע ן
מילך	מ י ל ך
מילכיקס	מ י ל כ י ק ס
מילן	מ י ל ן
מילנער	מ י ל נ ע ר
מים	מ י ם
מין	מ י ן
מינוט	מ י נ ו ט
מינחה	מ י נ ח ה
מינטערט	מ י נ ט ע ר ט
מינע	מ י נ ע
מיסחר	מ י ס ח ר
מיסחרים	מ י ס ח ר י ם
מיצווה	מ י צ ו ו ה
מיצווה־טענצל	מ י צ ו ו ה ־ ט ע נ צ ל
מיצקע	מ י צ ק ע
מיקוואות	מ י ק ו ו א ו ת
מיר	מ י ר
מיר'ן	מ י ר ' ן
מירן	מ י ר ן
מישב	מ י ש ב
מישט	מ י ש ט
מישטיינס	מ י ש ט י י נ ס
מישן	מ י ש ן
מישענינע	מ י ש ע נ י נ ע
מישפט	מ י ש פ ט
מישפטן	מ י ש פ ט ן
מיתה	מ י ת ה
מיתה־משונה	מ י ת ה ־ מ ש ו נ ה
מכבד	מ כ ב ד
מכה	מ כ ה
מכות	מ כ ו ת
מכח	מ כ ח
מכשפה	מ כ ש פ ה
מכתב	מ כ ת ב
מל	מ ל
מלא	מ ל א
מלא־טעם	מ ל א ־ ט ע ם
מלאך	מ ל א ך
מלאך־מליץ	מ ל א ך ־ מ ל י ץ
מלאכה	מ ל א כ ה
מלאכות	מ ל א כ ו ת
מלאכים	מ ל א כ י ם
מלאכימלעך	מ ל א כ י מ ל ע ך
מלאכימס	מ ל א כ י מ ס
מלבוש	מ ל ב ו ש
מלבושים	מ ל ב ו ש י ם
מלוכה	מ ל ו כ ה
מלחמה	מ ל ח מ ה
מלחמות	מ ל ח מ ו ת
מליץ	מ ל י ץ
מליץ־יושר	מ ל י ץ ־ י ו ש ר
מלך	מ ל ך
מלכה	מ ל כ ה
מלמד	מ ל מ ד
מלמדות	מ ל מ ד ו ת
מלמדים	מ ל מ ד י ם
מלקות	מ ל ק ו ת
ממה	מ מ ה
ממזריש	מ מ ז ר י ש
ממלא־מקומו	מ מ ל א ־ מ ק ו מ ו
ממש	מ מ ש
ממשות	מ מ ש ו ת
ממשלה	מ מ ש ל ה
מן	מ ן
מן־הסתם	מ ן ־ ה ס ת ם
מנהג־ישראל	מ נ ה ג ־ י ש ר א ל
מנורה	מ נ ו ר ה
מנחה	מ נ ח ה
מנחה'לע	מ נ ח ה ' ל ע
מנחת	מ נ ח ת
מנין	מ נ י ן
מנינים	מ נ י נ י ם
מניעה	מ נ י ע ה
מניעות	מ נ י ע ו ת
מסוגל	מ ס ו ג ל
מסופק	מ ס ו פ ק
מסחר	מ ס ח ר
מסחרים	מ ס ח ר י ם
מסירהלע	מ ס י ר ה ל ע
מסירות־נפש	מ ס י ר ו ת ־ נ פ ש
מסכים	מ ס כ י ם
מסכתא	מ ס כ ת א
מסלק	מ ס ל ק
מספיד	מ ס פ י ד
מסרט	מ ס ר ט
מסתמא	מ ס ת מ א
מסתמה	מ ס ת מ ה
מע	מ ע
מעביר	מ ע ב י ר
מעבר	מ ע ב ר
מעג	מ ע ג
מעגט	מ ע ג ט
מעגלעך	מ ע ג ל ע ך
מעגלעכקייט	מ ע ג ל ע כ ק י י ט
מעגן	מ ע ג ן
מעדיצין	מ ע ד י צ י ן
מעטאל	מ ע ט א ל
מעיו	מ ע י ו
מעיר	מ ע י ר
מעכטיקע	מ ע כ ט י ק ע
מעל	מ ע ל
מעל־געשעפט	מ ע ל ־ ג ע ש ע פ ט
מעלה	מ ע ל ה
מעלה־גירהן	מ ע ל ה ־ ג י ר ה ן
מעלות	מ ע ל ו ת
מען	מ ע ן
מענדל	מ ע נ ד ל
מענדעלע	מ ע נ ד ע ל ע
מענדעלען	מ ע נ ד ע ל ע ן
מענטש	מ ע נ ט ש
מענטשל	מ ע נ ט ש ל
מענטשלעך	מ ע נ ט ש ל ע ך
מענטשלעכער	מ ע נ ט ש ל ע כ ע ר
מענטשן	מ ע נ ט ש ן
מעסט	מ ע ס ט
מעסער	מ ע ס ע ר
מעקלער	מ ע ק ל ע ר
מעקסיקע	מ ע ק ס י ק ע
מער	מ ע ר
מערב־וואנט	מ ע ר ב ־ ו ו א נ ט
מעריב	מ ע ר י ב
מערן	מ ע ר ן
מערסטן	מ ע ר ס ט ן
מערצעשעם	מ ע ר צ ע ש ע ם
מערקט	מ ע ר ק ט
מעש	מ ע ש
מעשה	מ ע ש ה
מעשה־ביכל	מ ע ש ה ־ ב י כ ל
מעשה־ביכלעך	מ ע ש ה ־ ב י כ ל ע ך
מעשה־דאקטאר	מ ע ש ה ־ ד א ק ט א ר
מעשה־חוזק	מ ע ש ה ־ ח ו ז ק
מעשה־שרייבער	מ ע ש ה ־ ש ר י י ב ע ר
מעשהלעך	מ ע ש ה ל ע ך
מעשיות	מ ע ש י ו ת
מעשים	מ ע ש י ם
מעשענע	מ ע ש ע נ ע
מעת־לעת	מ ע ת ־ ל ע ת
מפטיר	מ פ ט י ר
מפי	מ פ י
מפלה	מ פ ל ה
מפני	מ פ נ י
מפקיר	מ פ ק י ר
מפרשים	מ פ ר ש י ם
מצבה	מ צ ב ה
מצה־וואסער	מ צ ה ־ ו ו א ס ע ר
מצה־שמורה	מ צ ה ־ ש מ ו ר ה
מצוה	מ צ ו ה
מצווה	מ צ ו ו ה
מציאה	מ צ י א ה
מציאות	מ צ י א ו ת
מציל	מ צ י ל
מצרים	מ צ ר י ם
מקבל	מ ק ב ל
מקובל	מ ק ו ב ל
מקום	מ ק ו ם
מקום־מנוחה	מ ק ו ם ־ מ נ ו ח ה
מקום־קדוש	מ ק ו ם ־ ק ד ו ש
מקיים	מ ק י י ם
מקנא	מ ק נ א
מרבין	מ ר ב י ן
מרה־שחורה	מ ר ה ־ ש ח ו ר ה
מרושע	מ ר ו ש ע
מרחם	מ ר ח ם
מרחץ	מ ר ח ץ
מרשעת	מ ר ש ע ת
משא	מ ש א
משבת	מ ש ב ת
משגיח	מ ש ג י ח
משה	מ ש ה
משה־וועלוול	מ ש ה ־ ו ו ע ל ו ו ל
משה־וועלוולען	מ ש ה ־ ו ו ע ל ו ו ל ע ן
משוגע	מ ש ו ג ע
משוגעים	מ ש ו ג ע י ם
משוגענע	מ ש ו ג ע נ ע
משוגענער	מ ש ו ג ע נ ע ר
משוגעת	מ ש ו ג ע ת
משוגעתן	מ ש ו ג ע ת ן
משולח	מ ש ו ל ח
משומד	מ ש ו מ ד
משונה	מ ש ו נ ה
משונהדיקער	מ ש ו נ ה ד י ק ע ר
משוררים	מ ש ו ר ר י ם
משטיינס	מ ש ט י י נ ס
משיח	מ ש י ח
משיחו	מ ש י ח ו
משיחן	מ ש י ח ן
משל	מ ש ל
משלים	מ ש ל י ם
משלים־שרייבערס	מ ש ל י ם ־ ש ר י י ב ע ר ס
משמח	מ ש מ ח
משמש	מ ש מ ש
משניות	מ ש נ י ו ת
משפחה	מ ש פ ח ה
משפט	מ ש פ ט
משקה	מ ש ק ה
משרת	מ ש ר ת
מששת	מ ש ש ת
מת	מ ת
מתוקן	מ ת ו ק ן
מתיקות	מ ת י ק ו ת
מתנגד	מ ת נ ג ד
מתנגדים	מ ת נ ג ד י ם
מתנגדישע	מ ת נ ג ד י ש ע
מתנה	מ ת נ ה
מתנות	מ ת נ ו ת
מתעסק	מ ת ע ס ק
מתפלל	מ ת פ ל ל
ן	ן
נ־א־מ־ן	נ ־ א ־ מ ־ ן
נא	נ א
נאגנדיק	נ א ג נ ד י ק
נאדל	נ א ד ל
נאדל־פאדים	נ א ד ל ־ פ א ד י ם
נאדלען	נ א ד ל ע ן
נאווינע	נ א ו ו י נ ע
נאז	נ א ז
נאט	נ א ט
נאטור	נ א ט ו ר
נאטיץ־ביכל	נ א ט י ץ ־ ב י כ ל
נאטע	נ א ט ע
נאטעס	נ א ט ע ס
נאיס	נ א י ס
נאך	נ א ך
נאכגעבן	נ א כ ג ע ב ן
נאכגעגעבן	נ א כ ג ע ג ע ב ן
נאכגעזאגט	נ א כ ג ע ז א ג ט
נאכגעטראכט	נ א כ ג ע ט ר א כ ט
נאכגעלאפן	נ א כ ג ע ל א פ ן
נאכגעקוקט	נ א כ ג ע ק ו ק ט
נאכט	נ א כ ט
נאכטאן	נ א כ ט א ן
נאכטייד	נ א כ ט י י ד
נאכטיידן	נ א כ ט י י ד ן
נאכלויפן	נ א כ ל ו י פ ן
נאכמיטאג	נ א כ מ י ט א ג
נאכן	נ א כ ן
נאמור	נ א מ ו ר
נאמן	נ א מ ן
נאמען	נ א מ ע ן
נאס	נ א ס
נאסיק	נ א ס י ק
נאסער	נ א ס ע ר
נאענטע	נ א ע נ ט ע
נאענסטע	נ א ע נ ס ט ע
נאפטלעמפל	נ א פ ט ל ע מ פ ל
נאציאן	נ א צ י א ן
נאקידקע	נ א ק י ד ק ע
נאקעט	נ א ק ע ט
נאקעטן	נ א ק ע ט ן
נאר	נ א ר
נאר־וואס	נ א ר ־ ו ו א ס
נאראנים	נ א ר א נ י ם
נארישע	נ א ר י ש ע
נארישער	נ א ר י ש ע ר
נארישקייט	נ א ר י ש ק י י ט
נארישקייטן	נ א ר י ש ק י י ט ן
נבלה	נ ב ל ה
נגיד	נ ג י ד
נגידים	נ ג י ד י ם
נגידס	נ ג י ד ס
נדבה	נ ד ב ה
נדבות	נ ד ב ו ת
נדן	נ ד ן
נדרים	נ ד ר י ם
נו	נ ו
נודנע	נ ו ד נ ע
נודעט	נ ו ד ע ט
נוהג	נ ו ה ג
נויט	נ ו י ט
נויטיקן	נ ו י ט י ק ן
נויטיקע	נ ו י ט י ק ע
נויטן	נ ו י ט ן
נון	נ ו ן
נוצלעכקייט	נ ו צ ל ע כ ק י י ט
נור	נ ו ר
נוראים	נ ו ר א י ם
נח	נ ח
נחת	נ ח ת
ניבהל	נ י ב ה ל
ניגון	נ י ג ו ן
ניגונים	נ י ג ו נ י ם
נידער	נ י ד ע ר
ניונקעלע	נ י ו נ ק ע ל ע
ניט	נ י ט
ניט־פאר	נ י ט ־ פ א ר
ניטא	נ י ט א
ניי	נ י י
ניי־געבוירענעם	נ י י ־ ג ע ב ו י ר ע נ ע ם
נייגעריק	נ י י ג ע ר י ק
נייט	נ י י ט
נייטארין	נ י י ט א ר י ן
נייטיק	נ י י ט י ק
נייטיקע	נ י י ט י ק ע
נייטיקערע	נ י י ט י ק ע ר ע
ניין	נ י י ן
נייס	נ י י ס
נייע	נ י י ע
נייעם	נ י י ע ם
נייען	נ י י ע ן
נייער	נ י י ע ר
נייערט	נ י י ע ר ט
ניכטער	נ י כ ט ע ר
נימאנד	נ י מ א נ ד
ניס	נ י ס
ניסן	נ י ס ן
ניסתר	נ י ס ת ר
ניפטר	נ י פ ט ר
ניקאלייעווסקער	נ י ק א ל י י ע ו ו ס ק ע ר
ניקעלסבורג	נ י ק ע ל ס ב ו ר ג
ניקעלסבורגער	נ י ק ע ל ס ב ו ר ג ע ר
ניר	נ י ר
נישט	נ י ש ט
נישט־גוטע	נ י ש ט ־ ג ו ט ע
נישט־גוטער	נ י ש ט ־ ג ו ט ע ר
נישט־געשטויגענע	נ י ש ט ־ ג ע ש ט ו י ג ע נ ע
נישט־טויט	נ י ש ט ־ ט ו י ט
נישט־לעבעדיק	נ י ש ט ־ ל ע ב ע ד י ק
נישט־פארגינערס	נ י ש ט ־ פ א ר ג י נ ע ר ס
נישטא	נ י ש ט א
נישמער	נ י ש מ ע ר
נישקשה	נ י ש ק ש ה
נישקשהדיק	נ י ש ק ש ה ד י ק
נישקשהדיקע	נ י ש ק ש ה ד י ק ע
נכבדים	נ כ ב ד י ם
נמלט	נ מ ל ט
ננתקה	נ נ ת ק ה
נס	נ ס
נסים	נ ס י ם
נסיעה	נ ס י ע ה
נע	נ ע
נע־ונד	נ ע ־ ו נ ד
נעבן	נ ע ב ן
נעבעך	נ ע ב ע ך
נעגל	נ ע ג ל
נעגל־	נ ע ג ל ־
נעגעלעך	נ ע ג ע ל ע ך
נעדאיעד	נ ע ד א י ע ד
נעז	נ ע ז
נעילה	נ ע י ל ה
נעכט	נ ע כ ט
נעכטיקן	נ ע כ ט י ק ן
נעכטיקער	נ ע כ ט י ק ע ר
נעכטן	נ ע כ ט ן
נעכע	נ ע כ ע
נעלם	נ ע ל ם
נעלסאן	נ ע ל ס א ן
נעם	נ ע ם
נעמט	נ ע מ ט
נעמיראווער	נ ע מ י ר א ו ו ע ר
נעמסט	נ ע מ ס ט
נעמען	נ ע מ ע ן
נענטער	נ ע נ ט ע ר
נעץ	נ ע ץ
נעקסטן	נ ע ק ס ט ן
נערוון	נ ע ר ו ו ן
נערווען	נ ע ר ו ו ע ן
נפלאה	נ פ ל א ה
נפש	נ פ ש
נפשות	נ פ ש ו ת
נפשך	נ פ ש ך
נצחון	נ צ ח ו ן
נקבה	נ ק ב ה
נקמה	נ ק מ ה
נשמה	נ ש מ ה
נשמתו	נ ש מ ת ו
נתבקש	נ ת ב ק ש
ס	ס
ס'א	ס ' א
ס'איז	ס ' א י ז
ס'אייגענע	ס ' א י י ג ע נ ע
ס'ארא	ס ' א ר א
ס'ארט	ס ' א ר ט
ס'גאנצע	ס ' ג א נ צ ע
ס'גייט	ס ' ג י י ט
ס'געלינגט	ס ' ג ע ל י נ ג ט
ס'דארף	ס ' ד א ר ף
ס'האבן	ס ' ה א ב ן
ס'האט	ס ' ה א ט
ס'האלט	ס ' ה א ל ט
ס'הויז	ס ' ה ו י ז
ס'וואלט	ס ' ו ו א ל ט
ס'ווארט	ס ' ו ו א ר ט
ס'וווינט	ס ' ו ו ו י נ ט
ס'וועט	ס ' ו ו ע ט
ס'ווערט	ס ' ו ו ע ר ט
ס'זאל	ס ' ז א ל
ס'זענען	ס ' ז ע נ ע ן
ס'טאגט	ס ' ט א ג ט
ס'טוט	ס ' ט ו ט
ס'טראגט	ס ' ט ר א ג ט
ס'טרעפט	ס ' ט ר ע פ ט
ס'ליגט	ס ' ל י ג ט
ס'מאכן	ס ' מ א כ ן
ס'מוזן	ס ' מ ו ז ן
ס'פאמעשאף	ס ' פ א מ ע ש א ף
ס'פלעגט	ס ' פ ל ע ג ט
ס'פנים	ס ' פ נ י ם
ס'קאן	ס ' ק א ן
ס'קאצל	ס ' ק א צ ל
ס'קומט	ס ' ק ו מ ט
ס'קינד	ס ' ק י נ ד
ס'קלינגט	ס ' ק ל י נ ג ט
ס'קלעמט	ס ' ק ל ע מ ט
ס'רופט	ס ' ר ו פ ט
ס'רעקל	ס ' ר ע ק ל
ס'שאדט	ס ' ש א ד ט
ס'שטייט	ס ' ש ט י י ט
ס'שטעכט	ס ' ש ט ע כ ט
סאבראניע	ס א ב ר א נ י ע
סאבראניעס	ס א ב ר א נ י ע ס
סאלאווייטשיק	ס א ל א ו ו י י ט ש י ק
סאלאן	ס א ל א ן
סאלדאט	ס א ל ד א ט
סאלדאטן	ס א ל ד א ט ן
סאלדאטסקע	ס א ל ד א ט ס ק ע
סאליע	ס א ל י ע
סאמאוואר	ס א מ א ו ו א ר
סאמע	ס א מ ע
סאמעט	ס א מ ע ט
סאמעטענעם	ס א מ ע ט ע נ ע ם
סאמעראדנער	ס א מ ע ר א ד נ ע ר
סאנדאלן	ס א נ ד א ל ן
סארא	ס א ר א
סארט	ס א ר ט
סארטירט	ס א ר ט י ר ט
סארטן	ס א ר ט ן
סביבה	ס ב י ב ה
סברא	ס ב ר א
סברה	ס ב ר ה
סדום	ס ד ו ם
סדור	ס ד ו ר
סדר	ס ד ר
סדר־העולם	ס ד ר ־ ה ע ו ל ם
סדרה	ס ד ר ה
סוד	ס ו ד
סוחר	ס ו ח ר
סוחרטע	ס ו ח ר ט ע
סוחרטעס	ס ו ח ר ט ע ס
סוחרים	ס ו ח ר י ם
סוין	ס ו י ן
סוכות	ס ו כ ו ת
סומע	ס ו מ ע
סוסים	ס ו ס י ם
סוף	ס ו ף
סחורה	ס ח ו ר ה
סחורות	ס ח ו ר ו ת
סחירות	ס ח י ר ו ת
סטאדאלע	ס ט א ד א ל ע
סטאך	ס ט א ך
סטאמבול	ס ט א מ ב ו ל
סטאנציע	ס ט א נ צ י ע
סטאר	ס ט א ר
סטיישאנערי	ס ט י י ש א נ ע ר י
סטיל	ס ט י ל
סטענגעס	ס ט ע נ ג ע ס
סטרא־אחרא	ס ט ר א ־ א ח ר א
סטראזש	ס ט ר א ז ש
סטראשידלעס	ס ט ר א ש י ד ל ע ס
סטראשן	ס ט ר א ש ן
סטרונע	ס ט ר ו נ ע
סיבה	ס י ב ה
סידור	ס י ד ו ר
סיז	ס י ז
סיי	ס י י
סיידן	ס י י ד ן
סילוק	ס י ל ו ק
סילוקן	ס י ל ו ק ן
סימביר	ס י מ ב י ר
סימן	ס י מ ן
סימנים	ס י מ נ י ם
סימע	ס י מ ע
סימעס	ס י מ ע ס
סינאגאגע	ס י נ א ג א ג ע
סיני	ס י נ י
סיערמענגע	ס י ע ר מ ע נ ג ע
סירחה	ס י ר ח ה
סך	ס ך
סך־הכל	ס ך ־ ה כ ל
סכך	ס כ ך
סכנה	ס כ נ ה
סכנת־נפשות	ס כ נ ת ־ נ פ ש ו ת
סכסוך	ס כ ס ו ך
סלה	ס ל ה
סליחות	ס ל י ח ו ת
סליחות־צייט	ס ל י ח ו ת ־ צ י י ט
סלעדאוואטל	ס ל ע ד א ו ו א ט ל
סם	ס ם
סמאלע	ס מ א ל ע
סמיכות	ס מ י כ ו ת
סמעטענע	ס מ ע ט ע נ ע
סנאסט	ס נ א ס ט
סע	ס ע
סעדעכע	ס ע ד ע כ ע
סעודה	ס ע ו ד ה
סעמעטערי	ס ע מ ע ט ע ר י
סענאט	ס ע נ א ט
סענאטארן	ס ע נ א ט א ר ן
סערל	ס ע ר ל
סערקעלע	ס ע ר ק ע ל ע
ספאדיק־דרייער	ס פ א ד י ק ־ ד ר י י ע ר
ספעציאליסט	ס פ ע צ י א ל י ס ט
ספעציאלנאסט	ס פ ע צ י א ל נ א ס ט
ספר	ס פ ר
ספרדישע	ס פ ר ד י ש ע
ספרים	ס פ ר י ם
ספרים־שאנק	ס פ ר י ם ־ ש א נ ק
ספרימלעך	ס פ ר י מ ל ע ך
סצענע	ס צ ע נ ע
סקיצן	ס ק י צ ן
סקנער	ס ק נ ע ר
סקעפטיציזם	ס ק ע פ ט י צ י ז ם
סקעפטיקערין	ס ק ע פ ט י ק ע ר י ן
סקריפען	ס ק ר י פ ע ן
סתם	ס ת ם
ס׳איז	ס ׳ א י ז
ס׳וועט	ס ׳ ו ו ע ט
ע	ע
עבודה	ע ב ו ד ה
עבירה	ע ב י ר ה
עבירות	ע ב י ר ו ת
עבר	ע ב ר
עברי	ע ב ר י
עברי־טייטש	ע ב ר י ־ ט י י ט ש
עגונה	ע ג ו נ ה
עגלה	ע ג ל ה
עגמת־נפש	ע ג מ ת ־ נ פ ש
עד	ע ד
עד־היום	ע ד ־ ה י ו ם
עדה	ע ד ה
עדות	ע ד ו ת
עוולה	ע ו ו ל ה
עול	ע ו ל
עולם	ע ו ל ם
עולם־האמת	ע ו ל ם ־ ה א מ ת
עולם־הבא	ע ו ל ם ־ ה ב א
עולם־הזה	ע ו ל ם ־ ה ז ה
עולם־השקר	ע ו ל ם ־ ה ש ק ר
עוף	ע ו ף
עופות	ע ו פ ו ת
עוקר	ע ו ק ר
עושר	ע ו ש ר
עז	ע ז
עזות	ע ז ו ת
עזות־פנים	ע ז ו ת ־ פ נ י ם
עזות־פנימער	ע ז ו ת ־ פ נ י מ ע ר
עט	ע ט
עטינגער	ע ט י נ ג ע ר
עטינגערס	ע ט י נ ג ע ר ס
עטלעכן	ע ט ל ע כ ן
עטלעכע	ע ט ל ע כ ע
עטרות	ע ט ר ו ת
עין־הרע	ע י ן ־ ה ר ע
עיקר	ע י ק ר
עיר	ע י ר
עך	ע ך
על	ע ל
על־חטא	ע ל ־ ח ט א
על־פי	ע ל ־ פ י
עלטסטן	ע ל ט ס ט ן
עלטער	ע ל ט ע ר
עלטער־עלטער־זיידעס	ע ל ט ע ר ־ ע ל ט ע ר ־ ז י י ד ע ס
עלטערזיידן	ע ל ט ע ר ז י י ד ן
עלטערזיידנס	ע ל ט ע ר ז י י ד נ ס
עלטערזיידע	ע ל ט ע ר ז י י ד ע
עלטערן	ע ל ט ע ר ן
עלטערע	ע ל ט ע ר ע
עלטערער	ע ל ט ע ר ע ר
עליה	ע ל י ה
עליהם	ע ל י ה ם
עליכם	ע ל י כ ם
עלנבויגנס	ע ל נ ב ו י ג נ ס
עלנט	ע ל נ ט
עלנטע	ע ל נ ט ע
עלנטער	ע ל נ ט ע ר
עלעהיי	ע ל ע ה י י
עלף	ע ל ף
עם	ע ם
עם־הארץ	ע ם ־ ה א ר ץ
עמבלעם	ע מ ב ל ע ם
עמוד	ע מ ו ד
עמיל	ע מ י ל
עמיץ	ע מ י ץ
עמיצן	ע מ י צ ן
עמיצער	ע מ י צ ע ר
עמעץ	ע מ ע ץ
עמעצן	ע מ ע צ ן
עמעצער	ע מ ע צ ע ר
עמער	ע מ ע ר
ענג	ע נ ג
ענגלישן	ע נ ג ל י ש ן
ענגלען	ע נ ג ל ע ן
ענגלענדער	ע נ ג ל ע נ ד ע ר
ענדיק	ע נ ד י ק
ענדיקט	ע נ ד י ק ט
ענדיקן	ע נ ד י ק ן
ענדלעך	ע נ ד ל ע ך
ענדערונג	ע נ ד ע ר ו נ ג
ענדערונגען	ע נ ד ע ר ו נ ג ע ן
ענדערט	ע נ ד ע ר ט
ענטפער	ע נ ט פ ע ר
ענטפערט	ע נ ט פ ע ר ט
ענטפערן	ע נ ט פ ע ר ן
עני	ע נ י
עניו	ע נ י ו
ענין	ע נ י ן
ענלעכער	ע נ ל ע כ ע ר
עס	ע ס
עסט	ע ס ט
עסן	ע ס ן
עסק	ע ס ק
עסקים	ע ס ק י ם
עפיגראמען	ע פ י ג ר א מ ע ן
עפל	ע פ ל
עפן	ע פ ן
עפן־אויס	ע פ ן ־ א ו י ס
עפנט	ע פ נ ט
עפענען	ע פ ע נ ע ן
עפעס	ע פ ע ס
עץ	ע ץ
עצבות	ע צ ב ו ת
עצה	ע צ ה
עצות	ע צ ו ת
עק	ע ק
עקדעשן	ע ק ד ע ש ן
עקזאמענס	ע ק ז א מ ע נ ס
עקזיסטירסט	ע ק ז י ס ט י ר ס ט
עקל	ע ק ל
עקן	ע ק ן
עקרות	ע ק ר ו ת
עקשן	ע ק ש ן
עקשנות	ע ק ש נ ו ת
עקשנען	ע ק ש נ ע ן
ער	ע ר
ער'ט	ע ר ' ט
ערב	ע ר ב
ערב־פסח	ע ר ב ־ פ ס ח
ערגעץ	ע ר ג ע ץ
ערגעץ־ווו	ע ר ג ע ץ ־ ו ו ו
ערגער	ע ר ג ע ר
ערגערע	ע ר ג ע ר ע
ערד	ע ר ד
ערופה	ע ר ו פ ה
ערטעלע	ע ר ט ע ל ע
ערטער	ע ר ט ע ר
ערך	ע ר ך
ערל	ע ר ל
ערלעך	ע ר ל ע ך
ערלעכע	ע ר ל ע כ ע
ערלעכער	ע ר ל ע כ ע ר
ערנסט	ע ר נ ס ט
ערשט	ע ר ש ט
ערשטן	ע ר ש ט ן
ערשטנס	ע ר ש ט נ ס
ערשטע	ע ר ש ט ע
ערשטער	ע ר ש ט ע ר
עשירות	ע ש י ר ו ת
עתיק	ע ת י ק
פ	פ
פאבריק	פ א ב ר י ק
פאבריקאנט	פ א ב ר י ק א נ ט
פאבריקע	פ א ב ר י ק ע
פאגראם	פ א ג ר א ם
פאדלאגע	פ א ד ל א ג ע
פאדעם	פ א ד ע ם
פאדערשטוב	פ א ד ע ר ש ט ו ב
פאדקאוועס	פ א ד ק א ו ו ע ס
פאדראטשיק	פ א ד ר א ט ש י ק
פאה	פ א ה
פאווע	פ א ו ו ע
פאות	פ א ו ת
פאזע	פ א ז ע
פאטער	פ א ט ע ר
פאטערס	פ א ט ע ר ס
פאטערשטול	פ א ט ע ר ש ט ו ל
פאטשיילע	פ א ט ש י י ל ע
פאטשיילעס	פ א ט ש י י ל ע ס
פאטשן	פ א ט ש ן
פאכט	פ א כ ט
פאכן	פ א כ ן
פאל	פ א ל
פאלאץ	פ א ל א ץ
פאלג	פ א ל ג
פאלגט	פ א ל ג ט
פאלגן	פ א ל ג ן
פאלט	פ א ל ט
פאלט־צו	פ א ל ט ־ צ ו
פאלטן	פ א ל ט ן
פאליטיקע	פ א ל י ט י ק ע
פאליציי	פ א ל י צ י י
פאלן	פ א ל ן
פאלע	פ א ל ע
פאלעס	פ א ל ע ס
פאלק	פ א ל ק
פאלק־ישראל	פ א ל ק ־ י ש ר א ל
פאלקס	פ א ל ק ס
פאלקסליד	פ א ל ק ס ל י ד
פאלקסליד־נוסח	פ א ל ק ס ל י ד ־ נ ו ס ח
פאלקסלידער	פ א ל ק ס ל י ד ע ר
פאלש	פ א ל ש
פאלשס	פ א ל ש ס
פאלשע	פ א ל ש ע
פאמיליע־לעבן	פ א מ י ל י ע ־ ל ע ב ן
פאמיליעס	פ א מ י ל י ע ס
פאמעלעך	פ א מ ע ל ע ך
פאמעלעך־פאמעלעך	פ א מ ע ל ע ך ־ פ א מ ע ל ע ך
פאמעלעכן	פ א מ ע ל ע כ ן
פאמעלעכע	פ א מ ע ל ע כ ע
פאן	פ א ן
פאנאנדערפאלן	פ א נ א נ ד ע ר פ א ל ן
פאנאראמע	פ א נ א ר א מ ע
פאנטאסטיק	פ א נ ט א ס ט י ק
פאנטאפל־העלד	פ א נ ט א פ ל ־ ה ע ל ד
פאנטאפלעך	פ א נ ט א פ ל ע ך
פאנטאפעלעך	פ א נ ט א פ ע ל ע ך
פאניע	פ א נ י ע
פאניען	פ א נ י ע ן
פאנקעלע	פ א נ ק ע ל ע
פאס	פ א ס
פאסט	פ א ס ט
פאסטוך	פ א ס ט ו ך
פאסטמייסטער	פ א ס ט מ י י ס ט ע ר
פאסטן	פ א ס ט ן
פאסיק	פ א ס י ק
פאסיקע	פ א ס י ק ע
פאסירונג	פ א ס י ר ו נ ג
פאסירט	פ א ס י ר ט
פאסן	פ א ס ן
פאסעליוושייסיא	פ א ס ע ל י ו ו ש י י ס י א
פאסעס	פ א ס ע ס
פאסעסער	פ א ס ע ס ע ר
פאסקודנע	פ א ס ק ו ד נ ע
פאעמע	פ א ע מ ע
פאפיר	פ א פ י ר
פאפיראסל	פ א פ י ר א ס ל
פאפיראסן	פ א פ י ר א ס ן
פאפירילע	פ א פ י ר י ל ע
פאפירן	פ א פ י ר ן
פאפערילע	פ א פ ע ר י ל ע
פאציענטן	פ א צ י ע נ ט ן
פאקוס	פ א ק ו ס
פאקט	פ א ק ט
פאקטן	פ א ק ט ן
פאקן	פ א ק ן
פאקן־טרעגער	פ א ק ן ־ ט ר ע ג ע ר
פאקנטרעגער	פ א ק נ ט ר ע ג ע ר
פאר	פ א ר
פאר'ן	פ א ר ' ן
פאר־פסח	פ א ר ־ פ ס ח
פארא	פ א ר א
פאראבקעס	פ א ר א ב ק ע ס
פאראדקעס	פ א ר א ד ק ע ס
פאראומערט	פ א ר א ו מ ע ר ט
פאראיבל	פ א ר א י ב ל
פאראיין	פ א ר א י י ן
פאראייניקונג	פ א ר א י י נ י ק ו נ ג
פאראינטערעסירט	פ א ר א י נ ט ע ר ע ס י ר ט
פאראן	פ א ר א ן
פארב	פ א ר ב
פארבאנד	פ א ר ב א נ ד
פארבארגענע	פ א ר ב א ר ג ע נ ע
פארבארגענער	פ א ר ב א ר ג ע נ ע ר
פארבונדען	פ א ר ב ו נ ד ע ן
פארבייגעגאנגען	פ א ר ב י י ג ע ג א נ ג ע ן
פארבלאנדזשעט	פ א ר ב ל א נ ד ז ש ע ט
פארבלוטיקט	פ א ר ב ל ו ט י ק ט
פארבלענדט	פ א ר ב ל ע נ ד ט
פארבעטן	פ א ר ב ע ט ן
פארבעטענע	פ א ר ב ע ט ע נ ע
פארבענקט	פ א ר ב ע נ ק ט
פארבראכט	פ א ר ב ר א כ ט
פארבראכן	פ א ר ב ר א כ ן
פארברענגען	פ א ר ב ר ע נ ג ע ן
פארברענט	פ א ר ב ר ע נ ט
פארברענטע	פ א ר ב ר ע נ ט ע
פארברענען	פ א ר ב ר ע נ ע ן
פארגאנגען	פ א ר ג א נ ג ע ן
פארגאפט	פ א ר ג א פ ט
פארגיין	פ א ר ג י י ן
פארגינען	פ א ר ג י נ ע ן
פארגליווערטע	פ א ר ג ל י ו ו ע ר ט ע
פארגעטערט	פ א ר ג ע ט ע ר ט
פארגעניגנס	פ א ר ג ע נ י ג נ ס
פארגעסט	פ א ר ג ע ס ט
פארגעסן	פ א ר ג ע ס ן
פארגעסנדיק	פ א ר ג ע ס נ ד י ק
פארדאנקען	פ א ר ד א נ ק ע ן
פארדינט	פ א ר ד י נ ט
פארדינסט	פ א ר ד י נ ס ט
פארדינען	פ א ר ד י נ ע ן
פארדינערין	פ א ר ד י נ ע ר י ן
פארדרייט	פ א ר ד ר י י ט
פארדרייען	פ א ר ד ר י י ע ן
פארדריפעטע	פ א ר ד ר י פ ע ט ע
פארהאלטן	פ א ר ה א ל ט ן
פארהארעוועטע	פ א ר ה א ר ע ו ו ע ט ע
פארהונגערט	פ א ר ה ו נ ג ע ר ט
פארהוסט	פ א ר ה ו ס ט
פארהערן	פ א ר ה ע ר ן
פארוואס	פ א ר ו ו א ס
פארוואקסענע	פ א ר ו ו א ק ס ע נ ע
פארווארפן	פ א ר ו ו א ר פ ן
פארווונדערט	פ א ר ו ו ו נ ד ע ר ט
פארווונדערטער	פ א ר ו ו ו נ ד ע ר ט ע ר
פארוויגט	פ א ר ו ו י ג ט
פארווילט	פ א ר ו ו י ל ט
פארוויסט	פ א ר ו ו י ס ט
פארוויקלט	פ א ר ו ו י ק ל ט
פארויס	פ א ר ו י ס
פארומערן	פ א ר ו מ ע ר ן
פארוסינע	פ א ר ו ס י נ ע
פארזאגן	פ א ר ז א ג ן
פארזארגט	פ א ר ז א ר ג ט
פארזארגן	פ א ר ז א ר ג ן
פארזארגער	פ א ר ז א ר ג ע ר
פארזוכט	פ א ר ז ו כ ט
פארזוכן	פ א ר ז ו כ ן
פארזונקען	פ א ר ז ו נ ק ע ן
פארזיכטיק	פ א ר ז י כ ט י ק
פארזינדיקן	פ א ר ז י נ ד י ק ן
פארזען	פ א ר ז ע ן
פארזעצט	פ א ר ז ע צ ט
פארזעצן	פ א ר ז ע צ ן
פארחאטיע	פ א ר ח א ט י ע
פארחידושט	פ א ר ח י ד ו ש ט
פארחלומט	פ א ר ח ל ו מ ט
פארחתמטן	פ א ר ח ת מ ט ן
פארט	פ א ר ט
פארטאראראמט	פ א ר ט א ר א ר א מ ט
פארטומלטער	פ א ר ט ו מ ל ט ע ר
פארטיק	פ א ר ט י ק
פארטעכער	פ א ר ט ע כ ע ר
פארטעפיאן	פ א ר ט ע פ י א ן
פארטראכט	פ א ר ט ר א כ ט
פארטרויט	פ א ר ט ר ו י ט
פארטריבן	פ א ר ט ר י ב ן
פארטרייב	פ א ר ט ר י י ב
פארטרינקען	פ א ר ט ר י נ ק ע ן
פארטשעפען	פ א ר ט ש ע פ ע ן
פאריאגט	פ א ר י א ג ט
פאריאדאק	פ א ר י א ד א ק
פאריבל	פ א ר י ב ל
פאריז	פ א ר י ז
פאריטש	פ א ר י ט ש
פארכאפט	פ א ר כ א פ ט
פארכישופטן	פ א ר כ י ש ו פ ט ן
פארכליניעט	פ א ר כ ל י נ י ע ט
פארל	פ א ר ל
פארלאג	פ א ר ל א ג
פארלאזט	פ א ר ל א ז ט
פארלאזן	פ א ר ל א ז ן
פארלאנגט	פ א ר ל א נ ג ט
פארלאנגען	פ א ר ל א נ ג ע ן
פארלאפן	פ א ר ל א פ ן
פארלוירן	פ א ר ל ו י ר ן
פארליבעניש	פ א ר ל י ב ע נ י ש
פארלייגט	פ א ר ל י י ג ט
פארלייגטע	פ א ר ל י י ג ט ע
פארלירט	פ א ר ל י ר ט
פארלעגער	פ א ר ל ע ג ע ר
פארלער	פ א ר ל ע ר
פארלעשן	פ א ר ל ע ש ן
פארמאג	פ א ר מ א ג
פארמאגט	פ א ר מ א ג ט
פארמאכט	פ א ר מ א כ ט
פארמאכן	פ א ר מ א כ ן
פארמעג	פ א ר מ ע ג
פארמעגן	פ א ר מ ע ג ן
פארמען	פ א ר מ ע ן
פארמשפט	פ א ר מ ש פ ט
פארן	פ א ר ן
פארנאכט	פ א ר נ א כ ט
פארנדיק	פ א ר נ ד י ק
פארנודעטן	פ א ר נ ו ד ע ט ן
פארנודעטער	פ א ר נ ו ד ע ט ע ר
פארנומען	פ א ר נ ו מ ע ן
פארנעפלטע	פ א ר נ ע פ ל ט ע
פארסט	פ א ר ס ט
פארסמאלעוועטע	פ א ר ס מ א ל ע ו ו ע ט ע
פארע	פ א ר ע
פארענדיקט	פ א ר ע נ ד י ק ט
פארענטפערן	פ א ר ע נ ט פ ע ר ן
פארפאלן	פ א ר פ א ל ן
פארפאלק	פ א ר פ א ל ק
פארפאסן	פ א ר פ א ס ן
פארפאסער	פ א ר פ א ס ע ר
פארפארן	פ א ר פ א ר ן
פארפונדעוועט	פ א ר פ ו נ ד ע ו ו ע ט
פארפינצטערט	פ א ר פ י נ צ ט ע ר ט
פארפירט	פ א ר פ י ר ט
פארפלאנצט	פ א ר פ ל א נ צ ט
פארפלוכט	פ א ר פ ל ו כ ט
פארפלייצט	פ א ר פ ל י י צ ט
פארפעלט	פ א ר פ ע ל ט
פארצווייפלטן	פ א ר צ ו ו י י פ ל ט ן
פארצווייפלטע	פ א ר צ ו ו י י פ ל ט ע
פארצוקערט	פ א ר צ ו ק ע ר ט
פארצייטנס	פ א ר צ י י ט נ ס
פארצייכנטער	פ א ר צ י י כ נ ט ע ר
פארציילט	פ א ר צ י י ל ט
פארציילן	פ א ר צ י י ל ן
פארצרהט	פ א ר צ ר ה ט
פארקאכט	פ א ר ק א כ ט
פארקויפט	פ א ר ק ו י פ ט
פארקויפן	פ א ר ק ו י פ ן
פארקומען	פ א ר ק ו מ ע ן
פארקוקט	פ א ר ק ו ק ט
פארקייטלען	פ א ר ק י י ט ל ע ן
פארקילונג	פ א ר ק י ל ו נ ג
פארקלאגט	פ א ר ק ל א ג ט
פארקניפן	פ א ר ק נ י פ ן
פארקנסן	פ א ר ק נ ס ן
פארקנעפלט	פ א ר ק נ ע פ ל ט
פארקעמט	פ א ר ק ע מ ט
פארקערעוועט	פ א ר ק ע ר ע ו ו ע ט
פארקראכן	פ א ר ק ר א כ ן
פארקרומט	פ א ר ק ר ו מ ט
פארשארצט	פ א ר ש א ר צ ט
פארשארצטע	פ א ר ש א ר צ ט ע
פארשווארצט	פ א ר ש ו ו א ר צ ט
פארשווונדן	פ א ר ש ו ו ו נ ד ן
פארשווינדט	פ א ר ש ו ו י נ ד ט
פארשווינדן	פ א ר ש ו ו י נ ד ן
פארשווינט	פ א ר ש ו ו י נ ט
פארשוויצטע	פ א ר ש ו ו י צ ט ע
פארשוין	פ א ר ש ו י ן
פארשוינען	פ א ר ש ו י נ ע ן
פארשטאנד	פ א ר ש ט א נ ד
פארשטאנען	פ א ר ש ט א נ ע ן
פארשטאפן	פ א ר ש ט א פ ן
פארשטארט	פ א ר ש ט א ר ט
פארשטויבט	פ א ר ש ט ו י ב ט
פארשטיי	פ א ר ש ט י י
פארשטייט	פ א ר ש ט י י ט
פארשטיין	פ א ר ש ט י י ן
פארשטייען	פ א ר ש ט י י ע ן
פארשטיקט	פ א ר ש ט י ק ט
פארשטעלט	פ א ר ש ט ע ל ט
פארשטעלטער	פ א ר ש ט ע ל ט ע ר
פארשטעלן	פ א ר ש ט ע ל ן
פארשטעק	פ א ר ש ט ע ק
פארשטערט	פ א ר ש ט ע ר ט
פארשטערטן	פ א ר ש ט ע ר ט ן
פארשטערטע	פ א ר ש ט ע ר ט ע
פארשידענע	פ א ר ש י ד ע נ ע
פארשיט	פ א ר ש י ט
פארשיידענע	פ א ר ש י י ד ע נ ע
פארשימלט	פ א ר ש י מ ל ט
פארשיקט	פ א ר ש י ק ט
פארשלאגן	פ א ר ש ל א ג ן
פארשלאסן	פ א ר ש ל א ס ן
פארשלאפן	פ א ר ש ל א פ ן
פארשלאפענעם	פ א ר ש ל א פ ע נ ע ם
פארשליסט	פ א ר ש ל י ס ט
פארשלעפטע	פ א ר ש ל ע פ ט ע
פארשנאשקעט	פ א ר ש נ א ש ק ע ט
פארשנייטע	פ א ר ש נ י י ט ע
פארשעמט	פ א ר ש ע מ ט
פארשפארט	פ א ר ש פ א ר ט
פארשפעטיקן	פ א ר ש פ ע ט י ק ן
פארשריבן	פ א ר ש ר י ב ן
פארשרייבט	פ א ר ש ר י י ב ט
פארשרייבן	פ א ר ש ר י י ב ן
פארשרייטס	פ א ר ש ר י י ט ס
פאשעט	פ א ש ע ט
פגימה	פ ג י מ ה
פגרען	פ ג ר ע ן
פדיון־הבן	פ ד י ו ן ־ ה ב ן
פדיון־הבנס	פ ד י ו ן ־ ה ב נ ס
פוד	פ ו ד
פוטער	פ ו ט ע ר
פוטערן	פ ו ט ע ר ן
פויגל	פ ו י ג ל
פויל	פ ו י ל
פויליש	פ ו י ל י ש
פוילן	פ ו י ל ן
פויער	פ ו י ע ר
פויערטעס	פ ו י ע ר ט ע ס
פויעריש	פ ו י ע ר י ש
פויערישן	פ ו י ע ר י ש ן
פויקט	פ ו י ק ט
פוכענע	פ ו כ ע נ ע
פול	פ ו ל
פולן	פ ו ל ן
פולע	פ ו ל ע
פולער	פ ו ל ע ר
פולקע	פ ו ל ק ע
פולקעס	פ ו ל ק ע ס
פון	פ ו ן
פונאנדערגעגאנגען	פ ו נ א נ ד ע ר ג ע ג א נ ג ע ן
פונאנדערגעפארן	פ ו נ א נ ד ע ר ג ע פ א ר ן
פונאנדערגערעדט	פ ו נ א נ ד ע ר ג ע ר ע ד ט
פונדעסטוועגן	פ ו נ ד ע ס ט ו ו ע ג ן
פונט	פ ו נ ט
פונעם	פ ו נ ע ם
פונקט	פ ו נ ק ט
פונקען	פ ו נ ק ע ן
פוס	פ ו ס
פוסט	פ ו ס ט
פועל	פ ו ע ל
פועלן	פ ו ע ל ן
פופציק	פ ו פ צ י ק
פופצן	פ ו פ צ ן
פוקסענעם	פ ו ק ס ע נ ע ם
פור	פ ו ר
פורים	פ ו ר י ם
פורים־קוילעטש	פ ו ר י ם ־ ק ו י ל ע ט ש
פורים־שפילער	פ ו ר י ם ־ ש פ י ל ע ר
פוריק	פ ו ר י ק
פורמאנישן	פ ו ר מ א נ י ש ן
פושע־ישראל	פ ו ש ע ־ י ש ר א ל
פושער	פ ו ש ע ר
פושקעלעך	פ ו ש ק ע ל ע ך
פחד	פ ח ד
פטום	פ ט ו ם
פטור	פ ט ו ר
פיאנע	פ י א נ ע
פיזם	פ י ז ם
פיזמון	פ י ז מ ו ן
פייג	פ י י ג
פייגל	פ י י ג ל
פייגעלע	פ י י ג ע ל ע
פייכט	פ י י כ ט
פייכטע	פ י י כ ט ע
פייל	פ י י ל
פיין	פ י י ן
פיינדע	פ י י נ ד ע
פיינט	פ י י נ ט
פיינסטע	פ י י נ ס ט ע
פיינע	פ י י נ ע
פיינפינקלקרויט	פ י י נ פ י נ ק ל ק ר ו י ט
פייער	פ י י ע ר
פייער־לעשערס	פ י י ע ר ־ ל ע ש ע ר ס
פייערדיקע	פ י י ע ר ד י ק ע
פייערל	פ י י ע ר ל
פייערן	פ י י ע ר ן
פייף	פ י י ף
פייפט	פ י י פ ט
פייפן	פ י י פ ן
פייפער	פ י י פ ע ר
פיל	פ י ל
פילט	פ י ל ט
פיליער	פ י ל י ע ר
פילן	פ י ל ן
פינאנץ־מיניסטער	פ י נ א נ ץ ־ מ י נ י ס ט ע ר
פינגער	פ י נ ג ע ר
פינגערלעך	פ י נ ג ע ר ל ע ך
פינכאסיק	פ י נ כ א ס י ק
פינסטער	פ י נ ס ט ע ר
פינף	פ י נ ף
פינף־זעקס	פ י נ ף ־ ז ע ק ס
פינצטער	פ י נ צ ט ע ר
פינצטערן	פ י נ צ ט ע ר ן
פינצטערער	פ י נ צ ט ע ר ע ר
פינקלט	פ י נ ק ל ט
פיס	פ י ס
פיסלעך	פ י ס ל ע ך
פיסק	פ י ס ק
פיעסנעס	פ י ע ס נ ע ס
פיעסע	פ י ע ס ע
פיפערנאטער	פ י פ ע ר נ א ט ע ר
פיפקע	פ י פ ק ע
פיפקעט	פ י פ ק ע ט
פיצל	פ י צ ל
פיצלעך	פ י צ ל ע ך
פיק	פ י ק
פיקאנטע	פ י ק א נ ט ע
פיקהאלץ	פ י ק ה א ל ץ
פיקט	פ י ק ט
פיקטשורס	פ י ק ט ש ו ר ס
פיקן	פ י ק ן
פיר	פ י ר
פירוש	פ י ר ו ש
פירט	פ י ר ט
פירמע	פ י ר מ ע
פירן	פ י ר ן
פיש	פ י ש
פישטשען	פ י ש ט ש ע ן
פלאטער	פ ל א ט ע ר
פלאטשיקער	פ ל א ט ש י ק ע ר
פלאי־פלאים	פ ל א י ־ פ ל א י ם
פלאכטע	פ ל א כ ט ע
פלאם	פ ל א ם
פלאמט	פ ל א מ ט
פלאן	פ ל א ן
פלאץ	פ ל א ץ
פלאקס	פ ל א ק ס
פלאקערט	פ ל א ק ע ר ט
פלודערן	פ ל ו ד ע ר ן
פלויט	פ ל ו י ט
פלוימען	פ ל ו י מ ע ן
פלוימען־צימעס	פ ל ו י מ ע ן ־ צ י מ ע ס
פלומפל	פ ל ו מ פ ל
פלוניתטע	פ ל ו נ י ת ט ע
פלוס	פ ל ו ס
פלוצים	פ ל ו צ י ם
פלוצלונג	פ ל ו צ ל ו נ ג
פלוצלינג	פ ל ו צ ל י נ ג
פלוצעם	פ ל ו צ ע ם
פלי	פ ל י
פליאות	פ ל י א ו ת
פליגל	פ ל י ג ל
פליושקען	פ ל י ו ש ק ע ן
פליט	פ ל י ט
פליטערלעך	פ ל י ט ע ר ל ע ך
פלייצע	פ ל י י צ ע
פלייצעס	פ ל י י צ ע ס
פלייש	פ ל י י ש
פליסט	פ ל י ס ט
פליסנדיקן	פ ל י ס נ ד י ק ן
פליען	פ ל י ע ן
פלעג	פ ל ע ג
פלעגט	פ ל ע ג ט
פלעגן	פ ל ע ג ן
פלעווע	פ ל ע ו ו ע
פלעם	פ ל ע ם
פלעשל	פ ל ע ש ל
פנים	פ נ י ם
פנימל	פ נ י מ ל
פנימער	פ נ י מ ע ר
פנקס	פ נ ק ס
פסולע	פ ס ו ל ע
פסוק	פ ס ו ק
פסוקים	פ ס ו ק י ם
פסח	פ ס ח
פסחדיקער	פ ס ח ד י ק ע ר
פסיכאלאגישע	פ ס י כ א ל א ג י ש ע
פסק	פ ס ק
פסקענען	פ ס ק ע נ ע ן
פעדעם	פ ע ד ע ם
פעדער	פ ע ד ע ר
פעדערן	פ ע ד ע ר ן
פעטע	פ ע ט ע
פעטער	פ ע ט ע ר
פעטש	פ ע ט ש
פעך	פ ע ך
פעך־שווארצע	פ ע ך ־ ש ו ו א ר צ ע
פעכן	פ ע כ ן
פעל	פ ע ל
פעלד	פ ע ל ד
פעלד־בלומעלעך	פ ע ל ד ־ ב ל ו מ ע ל ע ך
פעלדער	פ ע ל ד ע ר
פעלדשער	פ ע ל ד ש ע ר
פעלז	פ ע ל ז
פעלט	פ ע ל ט
פעלן	פ ע ל ן
פעלעכלעך	פ ע ל ע כ ל ע ך
פעלערינע	פ ע ל ע ר י נ ע
פעלשן	פ ע ל ש ן
פען	פ ע ן
פענסטער	פ ע נ ס ט ע ר
פענע	פ ע נ ע
פענצטער	פ ע נ צ ט ע ר
פענצטערל	פ ע נ צ ט ע ר ל
פענצערל	פ ע נ צ ע ר ל
פעסט	פ ע ס ט
פעסטגעשטעלט	פ ע ס ט ג ע ש ט ע ל ט
פעסטן	פ ע ס ט ן
פעסל	פ ע ס ל
פעקל	פ ע ק ל
פעקלעך	פ ע ק ל ע ך
פערד	פ ע ר ד
פערדל	פ ע ר ד ל
פערדלס	פ ע ר ד ל ס
פערדס	פ ע ר ד ס
פערדעלע	פ ע ר ד ע ל ע
פערזאנען	פ ע ר ז א נ ע ן
פערטל	פ ע ר ט ל
פערטער	פ ע ר ט ע ר
פערל	פ ע ר ל
פערעלע	פ ע ר ע ל ע
פערעלעך	פ ע ר ע ל ע ך
פערציק	פ ע ר צ י ק
פקדון	פ ק ד ו ן
פראבן	פ ר א ב ן
פראגראמען	פ ר א ג ר א מ ע ן
פראוויאנט	פ ר א ו ו י א נ ט
פראוועט	פ ר א ו ו ע ט
פראטעסט	פ ר א ט ע ס ט
פראנצויזיש	פ ר א נ צ ו י ז י ש
פראנקרייך	פ ר א נ ק ר י י ך
פראסט	פ ר א ס ט
פראסטאק	פ ר א ס ט א ק
פראסטן	פ ר א ס ט ן
פראסטע	פ ר א ס ט ע
פראסטער	פ ר א ס ט ע ר
פראסק	פ ר א ס ק
פראפעסער	פ ר א פ ע ס ע ר
פראצענט	פ ר א צ ע נ ט
פראצענטניק	פ ר א צ ע נ ט נ י ק
פראצעס	פ ר א צ ע ס
פראקטיקע	פ ר א ק ט י ק ע
פראשעק	פ ר א ש ע ק
פראשקעס	פ ר א ש ק ע ס
פרוווט	פ ר ו ו ו ט
פרוטה	פ ר ו ט ה
פרוי	פ ר ו י
פרוכת	פ ר ו כ ת
פרום	פ ר ו ם
פרומע	פ ר ו מ ע
פרומער	פ ר ו מ ע ר
פרומקייט	פ ר ו מ ק י י ט
פרטים	פ ר ט י ם
פרי	פ ר י
פריזבע	פ ר י ז ב ע
פריזיוו	פ ר י ז י ו ו
פריטשמעליעט	פ ר י ט ש מ ע ל י ע ט
פריי	פ ר י י
פרייד	פ ר י י ד
פריידע־גיטל	פ ר י י ד ע ־ ג י ט ל
פרייט	פ ר י י ט
פרייטיק	פ ר י י ט י ק
פריילעך	פ ר י י ל ע ך
פריילעכן	פ ר י י ל ע כ ן
פריילעכסטער	פ ר י י ל ע כ ס ט ע ר
פריילעכע	פ ר י י ל ע כ ע
פריילעכער	פ ר י י ל ע כ ע ר
פריינד	פ ר י י נ ד
פריינדלעכע	פ ר י י נ ד ל ע כ ע
פריינט	פ ר י י נ ט
פרייע	פ ר י י ע
פרייען	פ ר י י ע ן
פרילינג־נאכט	פ ר י ל י נ ג ־ נ א כ ט
פרימארגן	פ ר י מ א ר ג ן
פרימע	פ ר י מ ע
פרימער	פ ר י מ ע ר
פרינציפיעלער	פ ר י נ צ י פ י ע ל ע ר
פריען	פ ר י ע ן
פריער	פ ר י ע ר
פריערדיקן	פ ר י ע ר ד י ק ן
פריפעטשיק	פ ר י פ ע ט ש י ק
פריץ	פ ר י ץ
פריצים	פ ר י צ י ם
פריצס	פ ר י צ ס
פריקאזטשיק	פ ר י ק א ז ט ש י ק
פריש	פ ר י ש
פרישטשיקלעך	פ ר י ש ט ש י ק ל ע ך
פרישע	פ ר י ש ע
פרישער	פ ר י ש ע ר
פרנסה	פ ר נ ס ה
פרנסים	פ ר נ ס י ם
פרעג	פ ר ע ג
פרעג־געטאן	פ ר ע ג ־ ג ע ט א ן
פרעגט	פ ר ע ג ט
פרעגן	פ ר ע ג ן
פרעגסט	פ ר ע ג ס ט
פרעזידענט	פ ר ע ז י ד ע נ ט
פרעזעס	פ ר ע ז ע ס
פרעטענזיע	פ ר ע ט ע נ ז י ע
פרעמד	פ ר ע מ ד
פרעמדע	פ ר ע מ ד ע
פרעמדער	פ ר ע מ ד ע ר
פרעמיערע	פ ר ע מ י ע ר ע
פרעסט	פ ר ע ס ט
פרעק	פ ר ע ק
פרעש	פ ר ע ש
פרק	פ ר ק
פשוט	פ ש ו ט
פשוטן	פ ש ו ט ן
פשוטע	פ ש ו ט ע
פשוטער	פ ש ו ט ע ר
פשט	פ ש ט
ץ	ץ
צאינה	צ א י נ ה
צאלט	צ א ל ט
צאלן	צ א ל ן
צאן	צ א ן
צאן־קדשים	צ א ן ־ ק ד ש י ם
צאנדאקטארקע	צ א נ ד א ק ט א ר ק ע
צאנקט	צ א נ ק ט
צאנקען	צ א נ ק ע ן
צאפט	צ א פ ט
צאצקע	צ א צ ק ע
צאצקעלע	צ א צ ק ע ל ע
צארט	צ א ר ט
צארן	צ א ר ן
צד	צ ד
צדוק	צ ד ו ק
צדוקס	צ ד ו ק ס
צדיק	צ ד י ק
צדיקים	צ ד י ק י ם
צדקה־טעלער	צ ד ק ה ־ ט ע ל ע ר
צהלה	צ ה ל ה
צו	צ ו
צו־להכעסניק	צ ו ־ ל ה כ ע ס נ י ק
צוביסלעך	צ ו ב י ס ל ע ך
צוג	צ ו ג
צוגאב	צ ו ג א ב
צוגיין	צ ו ג י י ן
צוגייענדיק	צ ו ג י י ע נ ד י ק
צוגעבויגן	צ ו ג ע ב ו י ג ן
צוגעבן	צ ו ג ע ב ן
צוגעגאנגען	צ ו ג ע ג א נ ג ע ן
צוגעגעבן	צ ו ג ע ג ע ב ן
צוגעהאלטן	צ ו ג ע ה א ל ט ן
צוגעהאלפן	צ ו ג ע ה א ל פ ן
צוגעהערט	צ ו ג ע ה ע ר ט
צוגעזאגט	צ ו ג ע ז א ג ט
צוגעזאגטע	צ ו ג ע ז א ג ט ע
צוגעזעצט	צ ו ג ע ז ע צ ט
צוגעטראגן	צ ו ג ע ט ר א ג ן
צוגעטראכט	צ ו ג ע ט ר א כ ט
צוגעלאזט	צ ו ג ע ל א ז ט
צוגעלאפן	צ ו ג ע ל א פ ן
צוגעלייגט	צ ו ג ע ל י י ג ט
צוגעלעגערט	צ ו ג ע ל ע ג ע ר ט
צוגעמאכטע	צ ו ג ע מ א כ ט ע
צוגענומען	צ ו ג ע נ ו מ ע ן
צוגעקומען	צ ו ג ע ק ו מ ע ן
צוגעקראגן	צ ו ג ע ק ר א ג ן
צוגעקראכן	צ ו ג ע ק ר א כ ן
צוגערירט	צ ו ג ע ר י ר ט
צוגעשאקלט	צ ו ג ע ש א ק ל ט
צוגעשטעלט	צ ו ג ע ש ט ע ל ט
צוגעשיקט	צ ו ג ע ש י ק ט
צוגעשלאסן	צ ו ג ע ש ל א ס ן
צוגעשמייכלט	צ ו ג ע ש מ י י כ ל ט
צוגעשניטן	צ ו ג ע ש נ י ט ן
צוגרייטן	צ ו ג ר י י ט ן
צוואנציק	צ ו ו א נ צ י ק
צוווארעמט	צ ו ו ו א ר ע מ ט
צוווארפן	צ ו ו ו א ר פ ן
צווויגן	צ ו ו ו י ג ן
צוויי	צ ו ו י י
צווייט	צ ו ו י י ט
צווייטן	צ ו ו י י ט ן
צווייטנס	צ ו ו י י ט נ ס
צווייטע	צ ו ו י י ט ע
צווייטער	צ ו ו י י ט ע ר
צווישן	צ ו ו י ש ן
צוועלף	צ ו ו ע ל ף
צוזאג	צ ו ז א ג
צוזאמען	צ ו ז א מ ע ן
צוזאמענגעדריקט	צ ו ז א מ ע נ ג ע ד ר י ק ט
צוזאמענלויפן	צ ו ז א מ ע נ ל ו י פ ן
צוזעצן	צ ו ז ע צ ן
צולאג	צ ו ל א ג
צולאזן	צ ו ל א ז ן
צולהכעיס	צ ו ל ה כ ע י ס
צוליב	צ ו ל י ב
צולייגן	צ ו ל י י ג ן
צום	צ ו ם
צומאכן	צ ו מ א כ ן
צון	צ ו ן
צונאמען	צ ו נ א מ ע ן
צונג	צ ו נ ג
צונויף	צ ו נ ו י ף
צונויפגעלאפן	צ ו נ ו י פ ג ע ל א פ ן
צונויפגעמישט	צ ו נ ו י פ ג ע מ י ש ט
צונויפגענומען	צ ו נ ו י פ ג ע נ ו מ ע ן
צונויפנעמען	צ ו נ ו י פ נ ע מ ע ן
צונוץ	צ ו נ ו ץ
צונעמען	צ ו נ ע מ ע ן
צופארדינט	צ ו פ א ר ד י נ ט
צופארן	צ ו פ א ר ן
צופירן	צ ו פ י ר ן
צופליען	צ ו פ ל י ע ן
צופעליק	צ ו פ ע ל י ק
צופרידן	צ ו פ ר י ד ן
צופרידנקייט	צ ו פ ר י ד נ ק י י ט
צופרידענער	צ ו פ ר י ד ע נ ע ר
צוצוהערן	צ ו צ ו ה ע ר ן
צוצומאכן	צ ו צ ו מ א כ ן
צוקאפנס	צ ו ק א פ נ ס
צוקומען	צ ו ק ו מ ע ן
צוקער	צ ו ק ע ר
צוקערזיס	צ ו ק ע ר ז י ס
צורוקן	צ ו ר ו ק ן
צוריק	צ ו ר י ק
צוריקגיין	צ ו ר י ק ג י י ן
צוריקגעבן	צ ו ר י ק ג ע ב ן
צוריקגעגעבן	צ ו ר י ק ג ע ג ע ב ן
צוריקגעקומען	צ ו ר י ק ג ע ק ו מ ע ן
צוריקגעשמועסט	צ ו ר י ק ג ע ש מ ו ע ס ט
צוריקפארנדיק	צ ו ר י ק פ א ר נ ד י ק
צוריקצוקומען	צ ו ר י ק צ ו ק ו מ ע ן
צוריקקומענדיק	צ ו ר י ק ק ו מ ע נ ד י ק
צורעכט	צ ו ר ע כ ט
צורעכטגעמאכט	צ ו ר ע כ ט ג ע מ א כ ט
צורעכטצומאכן	צ ו ר ע כ ט צ ו מ א כ ן
צורת־אות	צ ו ר ת ־ א ו ת
צושטאנדקומען	צ ו ש ט א נ ד ק ו מ ע ן
צושטימונג	צ ו ש ט י מ ו נ ג
צושטעלן	צ ו ש ט ע ל ן
צושיקן	צ ו ש י ק ן
צי	צ י
ציבעלע	צ י ב ע ל ע
ציגאנעשט	צ י ג א נ ע ש ט
ציגאר	צ י ג א ר
ציגארן	צ י ג א ר ן
ציגל	צ י ג ל
ציגעלע	צ י ג ע ל ע
ציוניסט	צ י ו נ י ס ט
ציט	צ י ט
ציטערט	צ י ט ע ר ט
ציטערן	צ י ט ע ר ן
ציי	צ י י
צייג	צ י י ג
צייגענעם	צ י י ג ע נ ע ם
צייט	צ י י ט
צייטונגען	צ י י ט ו נ ג ע ן
צייטיק	צ י י ט י ק
צייטן	צ י י ט ן
צייטנס	צ י י ט נ ס
צייכן	צ י י כ ן
צייכנס	צ י י כ נ ס
ציין	צ י י ן
ציין־דאקטער	צ י י ן ־ ד א ק ט ע ר
ציינדאקטארקע	צ י י נ ד א ק ט א ר ק ע
צימבל	צ י מ ב ל
צימוקים־וויין	צ י מ ו ק י ם ־ ו ו י י ן
צימער	צ י מ ע ר
צינגער	צ י נ ג ע ר
צינד	צ י נ ד
צינדט	צ י נ ד ט
ציציליסט	צ י צ י ל י ס ט
ציצענעם	צ י צ ע נ ע ם
ציקלט	צ י ק ל ט
צירונג	צ י ר ו נ ג
צנועה	צ נ ו ע ה
צעאמפערט	צ ע א מ פ ע ר ט
צעבושעוועט	צ ע ב ו ש ע ו ו ע ט
צעבראכענע	צ ע ב ר א כ ע נ ע
צעבריקעט	צ ע ב ר י ק ע ט
צעגאנגען	צ ע ג א נ ג ע ן
צעגארטלט	צ ע ג א ר ט ל ט
צעגייט	צ ע ג י י ט
צעגיין	צ ע ג י י ן
צעגייען	צ ע ג י י ע ן
צעדרייט	צ ע ד ר י י ט
צעוויינט	צ ע ו ו י י נ ט
צעזונגען	צ ע ז ו נ ג ע ן
צעטומלט	צ ע ט ו מ ל ט
צעטיילט	צ ע ט י י ל ט
צעטיילן	צ ע ט י י ל ן
צעטרייסלט	צ ע ט ר י י ס ל ט
צעלאזט	צ ע ל א ז ט
צעלאכט	צ ע ל א כ ט
צעלאכן	צ ע ל א כ ן
צעלייגט	צ ע ל י י ג ט
צעלניק	צ ע ל נ י ק
צעמישט	צ ע מ י ש ט
צעמישן	צ ע מ י ש ן
צען	צ ע ן
צענדליק	צ ע נ ד ל י ק
צענויף	צ ע נ ו י ף
צענויפגעלייגט	צ ע נ ו י פ ג ע ל י י ג ט
צענומען	צ ע נ ו מ ע ן
צענטן	צ ע נ ט ן
צעפיקעניש	צ ע פ י ק ע נ י ש
צעפלאמט	צ ע פ ל א מ ט
צעפלאמטן	צ ע פ ל א מ ט ן
צעפלאשעטע	צ ע פ ל א ש ע ט ע
צעפלעצטע	צ ע פ ל ע צ ט ע
צעקריגט	צ ע ק ר י ג ט
צעקרייעט	צ ע ק ר י י ע ט
צער	צ ע ר
צער־בעלי־חיימניקעס	צ ע ר ־ ב ע ל י ־ ח י י מ נ י ק ע ס
צער־גדול־בנים	צ ע ר ־ ג ד ו ל ־ ב נ י ם
צעראטע	צ ע ר א ט ע
צערבעלי	צ ע ר ב ע ל י
צערודערט	צ ע ר ו ד ע ר ט
צערודערן	צ ע ר ו ד ע ר ן
צערונען	צ ע ר ו נ ע ן
צערייס	צ ע ר י י ס
צערייסן	צ ע ר י י ס ן
צעריסן	צ ע ר י ס ן
צעריסן־צעפיצלט	צ ע ר י ס ן ־ צ ע פ י צ ל ט
צעריסענע	צ ע ר י ס ע נ ע
צעשויבערט	צ ע ש ו י ב ע ר ט
צעשויבערטע	צ ע ש ו י ב ע ר ט ע
צעשייט	צ ע ש י י ט
צעשלאגענע	צ ע ש ל א ג ע נ ע
צעשמייכלט	צ ע ש מ י י כ ל ט
צעשפאלטענעם	צ ע ש פ א ל ט ע נ ע ם
צעשפילן	צ ע ש פ י ל ן
צעשפרייט	צ ע ש פ ר י י ט
צעשריגן	צ ע ש ר י ג ן
צפירה	צ פ י ר ה
צרה	צ ר ה
צרות	צ ר ו ת
ק־ד־ל־ת	ק ־ ד ־ ל ־ ת
ק־ד־ש־ת	ק ־ ד ־ ש ־ ת
קא'	ק א '
קאבינעט	ק א ב י נ ע ט
קאבצאנסק	ק א ב צ א נ ס ק
קאדיק	ק א ד י ק
קאהאל	ק א ה א ל
קאווע	ק א ו ו ע
קאזאק	ק א ז א ק
קאזשעניצער	ק א ז ש ע נ י צ ע ר
קאטאוועסל	ק א ט א ו ו ע ס ל
קאטאוועסלעך	ק א ט א ו ו ע ס ל ע ך
קאטאיען	ק א ט א י ע ן
קאטארי	ק א ט א ר י
קאטער	ק א ט ע ר
קאטש	ק א ט ש
קאטשערע	ק א ט ש ע ר ע
קאטשקי	ק א ט ש ק י
קאכט	ק א כ ט
קאכעניש	ק א כ ע נ י ש
קאלב	ק א ל ב
קאלוזשעס	ק א ל ו ז ש ע ס
קאלושקער	ק א ל ו ש ק ע ר
קאלושקערס	ק א ל ו ש ק ע ר ס
קאלט	ק א ל ט
קאלטונעוואטער	ק א ל ט ו נ ע ו ו א ט ע ר
קאלטן	ק א ל ט ן
קאלטע	ק א ל ט ע
קאלטער	ק א ל ט ע ר
קאליע	ק א ל י ע
קאליקע	ק א ל י ק ע
קאליקעס	ק א ל י ק ע ס
קאלנער	ק א ל נ ע ר
קאמא	ק א מ א
קאמינסקי	ק א מ י נ ס ק י
קאמינסקיס	ק א מ י נ ס ק י ס
קאמיסיאנער	ק א מ י ס י א נ ע ר
קאמעדיע	ק א מ ע ד י ע
קאמעניץ	ק א מ ע נ י ץ
קאמעניצער	ק א מ ע נ י צ ע ר
קאמער	ק א מ ע ר
קאמעראד	ק א מ ע ר א ד
קאמף	ק א מ ף
קאמפלימענטן	ק א מ פ ל י מ ע נ ט ן
קאמפליצירטער	ק א מ פ ל י צ י ר ט ע ר
קאמפראמיס	ק א מ פ ר א מ י ס
קאן	ק א ן
קאנאפע	ק א נ א פ ע
קאנגרעס־לייט	ק א נ ג ר ע ס ־ ל י י ט
קאנווע	ק א נ ו ו ע
קאנווערט	ק א נ ו ו ע ר ט
קאנט	ק א נ ט
קאנטאר	ק א נ ט א ר
קאנטן	ק א נ ט ן
קאנטראקט	ק א נ ט ר א ק ט
קאנטשיק	ק א נ ט ש י ק
קאנסט	ק א נ ס ט
קאנסטיטוציע	ק א נ ס ט י ט ו צ י ע
קאנען	ק א נ ע ן
קאנפערענץ	ק א נ פ ע ר ע נ ץ
קאסט	ק א ס ט
קאסטן	ק א ס ט ן
קאסירער	ק א ס י ר ע ר
קאסריליווקער	ק א ס ר י ל י ו ו ק ע ר
קאסרילעווקע	ק א ס ר י ל ע ו ו ק ע
קאסרילעווקער	ק א ס ר י ל ע ו ו ק ע ר
קאסרילעקעס	ק א ס ר י ל ע ק ע ס
קאפ	ק א פ
קאפ־דרייעניש	ק א פ ־ ד ר י י ע נ י ש
קאפאטע	ק א פ א ט ע
קאפאטקעלע	ק א פ א ט ק ע ל ע
קאפווייטיק	ק א פ ו ו י י ט י ק
קאפויער	ק א פ ו י ע ר
קאפויר	ק א פ ו י ר
קאפטיכל	ק א פ ט י כ ל
קאפטיכלעך	ק א פ ט י כ ל ע ך
קאפטעל	ק א פ ט ע ל
קאפיטאל	ק א פ י ט א ל
קאפיטאן	ק א פ י ט א ן
קאפיטל	ק א פ י ט ל
קאפיקעס	ק א פ י ק ע ס
קאפל	ק א פ ל
קאפלעך	ק א פ ל ע ך
קאפן	ק א פ ן
קאפנס	ק א פ נ ס
קאפעלושל	ק א פ ע ל ו ש ל
קאפעקעס	ק א פ ע ק ע ס
קאפריז	ק א פ ר י ז
קאץ	ק א ץ
קאצק	ק א צ ק
קאר	ק א ר
קאראסיק	ק א ר א ס י ק
קארב	ק א ר ב
קארבן	ק א ר ב ן
קארבען	ק א ר ב ע ן
קארג	ק א ר ג
קארגן	ק א ר ג ן
קארט	ק א ר ט
קארטאפל	ק א ר ט א פ ל
קארטאפליעס	ק א ר ט א פ ל י ע ס
קארטן	ק א ר ט ן
קאריק	ק א ר י ק
קארע	ק א ר ע
קארעטן	ק א ר ע ט ן
קארעטע	ק א ר ע ט ע
קארשן	ק א ר ש ן
קארשנבוים	ק א ר ש נ ב ו י ם
קארשנסאד	ק א ר ש נ ס א ד
קאשע	ק א ש ע
קבורה	ק ב ו ר ה
קבלת	ק ב ל ת
קבלת־פנים	ק ב ל ת ־ פ נ י ם
קבצן	ק ב צ ן
קבצנים	ק ב צ נ י ם
קבר	ק ב ר
קברים	ק ב ר י ם
קברן	ק ב ר ן
קדוש	ק ד ו ש
קדושת	ק ד ו ש ת
קדחת	ק ד ח ת
קדיש	ק ד י ש
קדלת	ק ד ל ת
קדשת	ק ד ש ת
קהילה	ק ה י ל ה
קהל	ק ה ל
קהלישן	ק ה ל י ש ן
קהלס	ק ה ל ס
קוגל	ק ו ג ל
קודם	ק ו ד ם
קודש	ק ו ד ש
קווארט	ק ו ו א ר ט
קווארס	ק ו ו א ר ס
קוויטש	ק ו ו י ט ש
קוויטשעט	ק ו ו י ט ש ע ט
קווינט	ק ו ו י נ ט
קוויקן	ק ו ו י ק ן
קוועטשט	ק ו ו ע ט ש ט
קוועטשן	ק ו ו ע ט ש ן
קוועטשקען	ק ו ו ע ט ש ק ע ן
קוטשער	ק ו ט ש ע ר
קויבער	ק ו י ב ע ר
קויל	ק ו י ל
קוילן	ק ו י ל ן
קוילן־ברענער	ק ו י ל ן ־ ב ר ע נ ע ר
קוילעטש	ק ו י ל ע ט ש
קוילען	ק ו י ל ע ן
קוים	ק ו י ם
קוים־קוים	ק ו י ם ־ ק ו י ם
קוימען	ק ו י מ ע ן
קויפט	ק ו י פ ט
קויפן	ק ו י פ ן
קול	ק ו ל
קולות	ק ו ל ו ת
קולי־קולות	ק ו ל י ־ ק ו ל ו ת
קוליע	ק ו ל י ע
קולכל	ק ו ל כ ל
קולעכל	ק ו ל ע כ ל
קום	ק ו ם
קומט	ק ו מ ט
קומסט	ק ו מ ס ט
קומען	ק ו מ ע ן
קונדסים	ק ו נ ד ס י ם
קונה	ק ו נ ה
קונהטעס	ק ו נ ה ט ע ס
קונים	ק ו נ י ם
קונסט	ק ו נ ס ט
קונסט־טעמפל	ק ו נ ס ט ־ ט ע מ פ ל
קונציק	ק ו נ צ י ק
קופאנעס	ק ו פ א נ ע ס
קוק	ק ו ק
קוק־טון	ק ו ק ־ ט ו ן
קוקט	ק ו ק ט
קוקן	ק ו ק ן
קוקנדיק	ק ו ק נ ד י ק
קוקסטו	ק ו ק ס ט ו
קורירן	ק ו ר י ר ן
קורץ	ק ו ר ץ
קורצזיכטיקע	ק ו ר צ ז י כ ט י ק ע
קורצע	ק ו ר צ ע
קוש	ק ו ש
קושן	ק ו ש ן
קושעטקע	ק ו ש ע ט ק ע
קטיגור	ק ט י ג ו ר
קידוש	ק י ד ו ש
קיטיי	ק י ט י י
קיטל	ק י ט ל
קיטשן	ק י ט ש ן
קיי	ק י י
קייבערל	ק י י ב ע ר ל
קייט	ק י י ט
קיימא־לן	ק י י מ א ־ ל ן
קיין	ק י י ן
קיינמאל	ק י י נ מ א ל
קיינעם	ק י י נ ע ם
קיינער	ק י י נ ע ר
קיך	ק י ך
קיכטיש	ק י כ ט י ש
קיכל	ק י כ ל
קיכן	ק י כ ן
קימפעט	ק י מ פ ע ט
קין	ק י ן
קינאה	ק י נ א ה
קינד	ק י נ ד
קינדווייז	ק י נ ד ו ו י י ז
קינדל	ק י נ ד ל
קינדלט	ק י נ ד ל ט
קינדלען	ק י נ ד ל ע ן
קינדעלעך	ק י נ ד ע ל ע ך
קינדער	ק י נ ד ע ר
קינדערלעך	ק י נ ד ע ר ל ע ך
קינדערס	ק י נ ד ע ר ס
קינדערסוועגן	ק י נ ד ע ר ס ו ו ע ג ן
קינדערשע	ק י נ ד ע ר ש ע
קינות	ק י נ ו ת
קינסטלעריש	ק י נ ס ט ל ע ר י ש
קינסטלערישן	ק י נ ס ט ל ע ר י ש ן
קיעוו	ק י ע ו ו
קיעווער	ק י ע ו ו ע ר
קירך	ק י ר ך
קישנס	ק י ש נ ס
קל	ק ל
קלאג	ק ל א ג
קלאגן	ק ל א ג ן
קלאווישן	ק ל א ו ו י ש ן
קלאנג	ק ל א נ ג
קלאסן	ק ל א ס ן
קלאפ	ק ל א פ
קלאפ־קלאפ	ק ל א פ ־ ק ל א פ
קלאפט	ק ל א פ ט
קלאפט־אן	ק ל א פ ט ־ א ן
קלאפן	ק ל א פ ן
קלאפסט	ק ל א פ ס ט
קלאץ	ק ל א ץ
קלאר	ק ל א ר
קלארע	ק ל א ר ע
קלארער	ק ל א ר ע ר
קלוג	ק ל ו ג
קלוגן	ק ל ו ג ן
קלוגע	ק ל ו ג ע
קלויבט	ק ל ו י ב ט
קלויז	ק ל ו י ז
קלויסטער	ק ל ו י ס ט ע ר
קליגער	ק ל י ג ע ר
קלייב	ק ל י י ב
קלייבט	ק ל י י ב ט
קלייבן	ק ל י י ב ן
קלייד	ק ל י י ד
קליידער	ק ל י י ד ע ר
קליידער־אלמער	ק ל י י ד ע ר ־ א ל מ ע ר
קלייט	ק ל י י ט
קלייטן	ק ל י י ט ן
קליין	ק ל י י ן
קליינווארג	ק ל י י נ ו ו א ר ג
קלייניקייט	ק ל י י נ י ק י י ט
קליינע	ק ל י י נ ע
קליינעם	ק ל י י נ ע ם
קליינער	ק ל י י נ ע ר
קלינגט	ק ל י נ ג ט
קלינגענדיקע	ק ל י נ ג ע נ ד י ק ע
קליענט	ק ל י ע נ ט
קליענטן	ק ל י ע נ ט ן
קליענטען	ק ל י ע נ ט ע ן
קללה	ק ל ל ה
קללות	ק ל ל ו ת
קלענסטן	ק ל ע נ ס ט ן
קלענערן	ק ל ע נ ע ר ן
קלעפ	ק ל ע פ
קלעפן	ק ל ע פ ן
קלעצלעך	ק ל ע צ ל ע ך
קלעצער	ק ל ע צ ע ר
קלערט	ק ל ע ר ט
קלערן	ק ל ע ר ן
קלערנדיק	ק ל ע ר נ ד י ק
קמץ	ק מ ץ
קנאבל	ק נ א ב ל
קנאפלען	ק נ א פ ל ע ן
קנאקט	ק נ א ק ט
קנאקן	ק נ א ק ן
קנאקניסל	ק נ א ק נ י ס ל
קנה	ק נ ה
קנויל	ק נ ו י ל
קנופ	ק נ ו פ
קניידלעך	ק נ י י ד ל ע ך
קנייע	ק נ י י ע
קנייפט	ק נ י י פ ט
קנייפן	ק נ י י פ ן
קניפ	ק נ י פ
קניפל	ק נ י פ ל
קנעט	ק נ ע ט
קנעטן	ק נ ע ט ן
קנעכל	ק נ ע כ ל
קנעפל	ק נ ע פ ל
קעגן	ק ע ג ן
קעגנאיבער	ק ע ג נ א י ב ע ר
קעגניבער	ק ע ג נ י ב ע ר
קעז	ק ע ז
קעכין	ק ע כ י ן
קעכינס	ק ע כ י נ ס
קעכלען	ק ע כ ל ע ן
קעכנע	ק ע כ נ ע
קעלבל	ק ע ל ב ל
קעלבערנע	ק ע ל ב ע ר נ ע
קעלט	ק ע ל ט
קעלער	ק ע ל ע ר
קעלערס	ק ע ל ע ר ס
קען	ק ע ן
קענט	ק ע נ ט
קענטלעכער	ק ע נ ט ל ע כ ע ר
קענטשאפט	ק ע נ ט ש א פ ט
קענסט	ק ע נ ס ט
קענען	ק ע נ ע ן
קענער	ק ע נ ע ר
קענערס	ק ע נ ע ר ס
קעסל	ק ע ס ל
קעפ	ק ע פ
קעפל	ק ע פ ל
קעפלעך	ק ע פ ל ע ך
קער	ק ע ר
קערבל	ק ע ר ב ל
קערבלעך	ק ע ר ב ל ע ך
קערט	ק ע ר ט
קערלעך	ק ע ר ל ע ך
קערמעשלעך	ק ע ר מ ע ש ל ע ך
קערן	ק ע ר ן
קערנדל	ק ע ר נ ד ל
קערנער	ק ע ר נ ע ר
קערנערס	ק ע ר נ ע ר ס
קעשענע	ק ע ש ע נ ע
קעשענעווער	ק ע ש ע נ ע ו ו ע ר
קעשענעס	ק ע ש ע נ ע ס
קצבה	ק צ ב ה
קצין	ק צ י ן
קראם	ק ר א ם
קראנץ	ק ר א נ ץ
קראנק	ק ר א נ ק
קראנקן	ק ר א נ ק ן
קראנקע	ק ר א נ ק ע
קראנקער	ק ר א נ ק ע ר
קראסניסטאוו	ק ר א ס נ י ס ט א ו ו
קראצט	ק ר א צ ט
קראצמיך	ק ר א צ מ י ך
קראצן	ק ר א צ ן
קראקע	ק ר א ק ע
קרוב	ק ר ו ב
קרובים	ק ר ו ב י ם
קרוטין	ק ר ו ט י ן
קרוין	ק ר ו י ן
קרוינען	ק ר ו י נ ע ן
קרום	ק ר ו ם
קרומע	ק ר ו מ ע
קרומער	ק ר ו מ ע ר
קריאת	ק ר י א ת
קריאת־שמע	ק ר י א ת ־ ש מ ע
קריג	ק ר י ג
קריגט	ק ר י ג ט
קריגן	ק ר י ג ן
קריי	ק ר י י
קרייד	ק ר י י ד
קרייזלען	ק ר י י ז ל ע ן
קרייטעכצער	ק ר י י ט ע כ צ ע ר
קרייטער	ק ר י י ט ע ר
קרייען	ק ר י י ע ן
קריך	ק ר י ך
קריכט	ק ר י כ ט
קריכט־אריין	ק ר י כ ט ־ א ר י י ן
קריכן	ק ר י כ ן
קרימעטארטע	ק ר י מ ע ט א ר ט ע
קריסטלעכער	ק ר י ס ט ל ע כ ע ר
קריצן	ק ר י צ ן
קרן	ק ר ן
קרעדיט	ק ר ע ד י ט
קרעטשמע	ק ר ע ט ש מ ע
קרעכץ	ק ר ע כ ץ
קרעכצט	ק ר ע כ צ ט
קרעכצן	ק ר ע כ צ ן
קרעמער	ק ר ע מ ע ר
קרענק	ק ר ע נ ק
קרענקט	ק ר ע נ ק ט
קרענקען	ק ר ע נ ק ע ן
קשיא	ק ש י א
קשיה	ק ש י ה
ר	ר
ר'	ר '
ר'האט	ר ' ה א ט
ראבינאוויטש	ר א ב י נ א ו ו י ט ש
ראגזשע	ר א ג ז ש ע
ראד	ר א ד
ראדאמישל	ר א ד א מ י ש ל
ראדאשיץ	ר א ד א ש י ץ
ראוז	ר א ו ז
ראזשינקעס	ר א ז ש י נ ק ע ס
ראזשינקעס־וויין	ר א ז ש י נ ק ע ס ־ ו ו י י ן
ראט	ר א ט
ראטע	ר א ט ע
ראטעווען	ר א ט ע ו ו ע ן
ראיה	ר א י ה
ראיות	ר א י ו ת
ראיעל	ר א י ע ל
ראכמיסטריווקע	ר א כ מ י ס ט ר י ו ו ק ע
ראלע	ר א ל ע
ראמאנען	ר א מ א נ ע ן
ראמס	ר א מ ס
ראנגלט	ר א נ ג ל ט
ראספוטין	ר א ס פ ו ט י ן
ראפטים	ר א פ ט י ם
ראציאנאליסט	ר א צ י א נ א ל י ס ט
ראש	ר א ש
ראש־השנה	ר א ש ־ ה ש נ ה
ראש־חודש	ר א ש ־ ח ו ד ש
רב	ר ב
רבונו	ר ב ו נ ו
רבונו־של־עולם	ר ב ו נ ו ־ ש ל ־ ע ו ל ם
רבי	ר ב י
רבין	ר ב י ן
רבינו	ר ב י נ ו
רבינס	ר ב י נ ס
רביצין	ר ב י צ י ן
רבנו	ר ב נ ו
רבנים	ר ב נ י ם
רבס	ר ב ס
רגע	ר ג ע
רו	ר ו
רוב	ר ו ב
רובל	ר ו ב ל
רוגזה	ר ו ג ז ה
רודער	ר ו ד ע ר
רוח	ר ו ח
רוחות	ר ו ח ו ת
רוחניות	ר ו ח נ י ו ת
רוט	ר ו ט
רויזע	ר ו י ז ע
רויזעס	ר ו י ז ע ס
רויט	ר ו י ט
רויטבאקיקן	ר ו י ט ב א ק י ק ן
רויטבאקיקער	ר ו י ט ב א ק י ק ע ר
רויטלען	ר ו י ט ל ע ן
רויטן	ר ו י ט ן
רויטע	ר ו י ט ע
רויטער	ר ו י ט ע ר
רויטשילד	ר ו י ט ש י ל ד
רויטשילדס	ר ו י ט ש י ל ד ס
רויך	ר ו י ך
רויכערט	ר ו י כ ע ר ט
רויכערן	ר ו י כ ע ר ן
רוימט	ר ו י מ ט
רוישט	ר ו י ש ט
רוסיש	ר ו ס י ש
רועט	ר ו ע ט
רוען	ר ו ע ן
רוף	ר ו ף
רופא	ר ו פ א
רופט	ר ו פ ט
רופן	ר ו פ ן
רוקט	ר ו ק ט
רוקן	ר ו ק ן
רחבותדיק	ר ח ב ו ת ד י ק
רחל	ר ח ל
רחמים	ר ח מ י ם
רחמנא	ר ח מ נ א
רחמנות	ר ח מ נ ו ת
ריזיק	ר י ז י ק
ריזן־קאפ	ר י ז ן ־ ק א פ
ריטם	ר י ט ם
ריטער	ר י ט ע ר
ריי	ר י י
רייד	ר י י ד
רייך	ר י י ך
רייכן	ר י י כ ן
רייכע	ר י י כ ע
רייכערן	ר י י כ ע ר ן
ריין	ר י י ן
ריין־קינדעריש־בלויע	ר י י ן ־ ק י נ ד ע ר י ש ־ ב ל ו י ע
רייניקייט	ר י י נ י ק י י ט
ריינע	ר י י נ ע
רייסט	ר י י ס ט
רייסן	ר י י ס ן
רייסעניש	ר י י ס ע נ י ש
רייצע	ר י י צ ע
ריכטיק	ר י כ ט י ק
ריכטער	ר י כ ט ע ר
רימען	ר י מ ע ן
רינד	ר י נ ד
רינט	ר י נ ט
ריפ	ר י פ
ריר	ר י ר
רירט	ר י ר ט
רירן	ר י ר ן
רמה	ר מ ה
רעאביליטירן	ר ע א ב י ל י ט י ר ן
רעאליזם	ר ע א ל י ז ם
רעגן	ר ע ג ן
רעגנטרערן	ר ע ג נ ט ר ע ר ן
רעגענען	ר ע ג ע נ ע ן
רעדט	ר ע ד ט
רעדי	ר ע ד י
רעדל	ר ע ד ל
רעדלט	ר ע ד ל ט
רעדלעך	ר ע ד ל ע ך
רעדן	ר ע ד ן
רעדעלעך	ר ע ד ע ל ע ך
רעדער	ר ע ד ע ר
רעוואלוציע	ר ע ו ו א ל ו צ י ע
רעוואלוציעס	ר ע ו ו א ל ו צ י ע ס
רעזשיסאר	ר ע ז ש י ס א ר
רעטאריק	ר ע ט א ר י ק
רעכט	ר ע כ ט
רעכטן	ר ע כ ט ן
רעכטער	ר ע כ ט ע ר
רעכן	ר ע כ ן
רעכנט	ר ע כ נ ט
רעכץ	ר ע כ ץ
רעפובליקאנישע	ר ע פ ו ב ל י ק א נ י ש ע
רעפערענדום	ר ע פ ע ר ע נ ד ו ם
רעפריין	ר ע פ ר י י ן
רעצעפט	ר ע צ ע פ ט
רערל	ר ע ר ל
רעש	ר ע ש
רעשט	ר ע ש ט
רעשטל	ר ע ש ט ל
רפאל	ר פ א ל
רפואה	ר פ ו א ה
רפואות	ר פ ו א ו ת
רפעדט	ר פ ע ד ט
רציחה	ר צ י ח ה
רק	ר ק
רשות	ר ש ו ת
רשע	ר ש ע
רשעים	ר ש ע י ם
שא	ש א
שאד	ש א ד
שאדן	ש א ד ן
שאול	ש א ו ל
שאט	ש א ט
שאטן	ש א ט ן
שאך	ש א ך
שאכטל	ש א כ ט ל
שאכטלעך	ש א כ ט ל ע ך
שאכערמאכערי	ש א כ ע ר מ א כ ע ר י
שאל	ש א ל
שאלה	ש א ל ה
שאלות	ש א ל ו ת
שאלקע	ש א ל ק ע
שאלת־נשים	ש א ל ת ־ נ ש י ם
שאנד	ש א נ ד
שאס	ש א ס
שאפ	ש א פ
שאפונגען	ש א פ ו נ ג ע ן
שאפט	ש א פ ט
שאפן	ש א פ ן
שאקלט	ש א ק ל ט
שאקלען	ש א ק ל ע ן
שארט	ש א ר ט
שארן	ש א ר ן
שארף	ש א ר ף
שארפן	ש א ר פ ן
שארפע	ש א ר פ ע
שארפער	ש א ר פ ע ר
שבבלאטע	ש ב ב ל א ט ע
שבועה	ש ב ו ע ה
שבועות	ש ב ו ע ו ת
שבח	ש ב ח
שבחים	ש ב ח י ם
שבט	ש ב ט
שבת	ש ב ת
שבת־הגדול	ש ב ת ־ ה ג ד ו ל
שדוך	ש ד ו ך
שדים	ש ד י ם
שדכן	ש ד כ ן
שדכנות־געלט	ש ד כ נ ו ת ־ ג ע ל ט
שדכנים	ש ד כ נ י ם
שדכנען	ש ד כ נ ע ן
שהיה	ש ה י ה
שהיות	ש ה י ו ת
שובע	ש ו ב ע
שוואגער	ש ו ו א ג ע ר
שוואגערס	ש ו ו א ג ע ר ס
שוואך	ש ו ו א ך
שוואכע	ש ו ו א כ ע
שוואכער	ש ו ו א כ ע ר
שוואם	ש ו ו א ם
שווארץ	ש ו ו א ר ץ
שווארצלעך	ש ו ו א ר צ ל ע ך
שווארצן	ש ו ו א ר צ ן
שווארצע	ש ו ו א ר צ ע
שווארצער	ש ו ו א ר צ ע ר
שווארצקייט	ש ו ו א ר צ ק י י ט
שווייג	ש ו ו י י ג
שווייגט	ש ו ו י י ג ט
שווייגן	ש ו ו י י ג ן
שווייגער	ש ו ו י י ג ע ר
שווייגערין	ש ו ו י י ג ע ר י ן
שווייגערנס	ש ו ו י י ג ע ר נ ס
שווייס	ש ו ו י י ס
שווימט	ש ו ו י מ ט
שווימען	ש ו ו י מ ע ן
שווינדלט	ש ו ו י נ ד ל ט
שווינדלענדיקער	ש ו ו י נ ד ל ע נ ד י ק ע ר
שווינדלער	ש ו ו י נ ד ל ע ר
שוויצט	ש ו ו י צ ט
שוויצן	ש ו ו י צ ן
שוועב	ש ו ו ע ב
שוועבל	ש ו ו ע ב ל
שוועבעלעך	ש ו ו ע ב ע ל ע ך
שוועגערין	ש ו ו ע ג ע ר י ן
שוועל	ש ו ו ע ל
שוועסטער	ש ו ו ע ס ט ע ר
שוועסטערלעך	ש ו ו ע ס ט ע ר ל ע ך
שווער	ש ו ו ע ר
שווערלעך	ש ו ו ע ר ל ע ך
שווערן	ש ו ו ע ר ן
שווערס	ש ו ו ע ר ס
שווערסטע	ש ו ו ע ר ס ט ע
שווערסטער	ש ו ו ע ר ס ט ע ר
שווערע	ש ו ו ע ר ע
שווערער	ש ו ו ע ר ע ר
שוטה	ש ו ט ה
שויב	ש ו י ב
שוים	ש ו י ם
שוין	ש ו י ן
שול	ש ו ל
שולגעסל	ש ו ל ג ע ס ל
שולד	ש ו ל ד
שולדיק	ש ו ל ד י ק
שולדיקן	ש ו ל ד י ק ן
שולהויף	ש ו ל ה ו י ף
שולחן	ש ו ל ח ן
שולן	ש ו ל ן
שום	ש ו ם
שומר	ש ו מ ר
שונא	ש ו נ א
שונאים	ש ו נ א י ם
שונה־ישראל	ש ו נ ה ־ י ש ר א ל
שוסטער	ש ו ס ט ע ר
שופלאד	ש ו פ ל א ד
שורהבר	ש ו ר ה ב ר
שורש	ש ו ר ש
שושן־הבירה	ש ו ש ן ־ ה ב י ר ה
שושנת	ש ו ש נ ת
שושקעריי	ש ו ש ק ע ר י י
שותף	ש ו ת ף
שטאט	ש ט א ט
שטאט־רב	ש ט א ט ־ ר ב
שטאט־שקצים	ש ט א ט ־ ש ק צ י ם
שטאטישע	ש ט א ט י ש ע
שטאך	ש ט א ך
שטאלץ	ש ט א ל ץ
שטאמט	ש ט א מ ט
שטאמען	ש ט א מ ע ן
שטאפן	ש ט א פ ן
שטאק	ש ט א ק
שטארבט	ש ט א ר ב ט
שטארבן	ש ט א ר ב ן
שטארט	ש ט א ר ט
שטארק	ש ט א ר ק
שטארקן	ש ט א ר ק ן
שטארקער	ש ט א ר ק ע ר
שטארקערער	ש ט א ר ק ע ר ע ר
שטוב	ש ט ו ב
שטוב־זיצערין	ש ט ו ב ־ ז י צ ע ר י ן
שטובמענטשן	ש ט ו ב מ ע נ ט ש ן
שטודירט	ש ט ו ד י ר ט
שטודירן	ש ט ו ד י ר ן
שטויביקער	ש ט ו י ב י ק ע ר
שטויבעלע	ש ט ו י ב ע ל ע
שטויס	ש ט ו י ס
שטויסן	ש ט ו י ס ן
שטול	ש ט ו ל
שטום	ש ט ו ם
שטומע	ש ט ו מ ע
שטומען	ש ט ו מ ע ן
שטומפיק	ש ט ו מ פ י ק
שטונדע	ש ט ו נ ד ע
שטופט	ש ט ו פ ט
שטופן	ש ט ו פ ן
שטופען	ש ט ו פ ע ן
שטורקאצן	ש ט ו ר ק א צ ן
שטיבל	ש ט י ב ל
שטיבעלע	ש ט י ב ע ל ע
שטיוול	ש ט י ו ו ל
שטיוולעטן	ש ט י ו ו ל ע ט ן
שטיוועלעך	ש ט י ו ו ע ל ע ך
שטיי	ש ט י י
שטייגער	ש ט י י ג ע ר
שטייגערס	ש ט י י ג ע ר ס
שטייט	ש ט י י ט
שטייט־אויף	ש ט י י ט ־ א ו י ף
שטיין	ש ט י י ן
שטיינער	ש ט י י נ ע ר
שטייען	ש ט י י ע ן
שטייענדיק	ש ט י י ע נ ד י ק
שטייענדיקע	ש ט י י ע נ ד י ק ע
שטיל	ש ט י ל
שטילע	ש ט י ל ע
שטילער	ש ט י ל ע ר
שטילערהייט	ש ט י ל ע ר ה י י ט
שטים	ש ט י ם
שטימונג	ש ט י מ ו נ ג
שטימען	ש ט י מ ע ן
שטיפמאמע	ש ט י פ מ א מ ע
שטיפמאמען	ש ט י פ מ א מ ע ן
שטיפער	ש ט י פ ע ר
שטיק	ש ט י ק
שטיקט	ש ט י ק ט
שטיקל	ש ט י ק ל
שטיקלעך	ש ט י ק ל ע ך
שטיקעלע	ש ט י ק ע ל ע
שטיקען	ש ט י ק ע ן
שטן	ש ט ן
שטעגן	ש ט ע ג ן
שטעט	ש ט ע ט
שטעטל	ש ט ע ט ל
שטעטלעך	ש ט ע ט ל ע ך
שטעכווערטלעך	ש ט ע כ ו ו ע ר ט ל ע ך
שטעכיק	ש ט ע כ י ק
שטעכן	ש ט ע כ ן
שטעל	ש ט ע ל
שטעלט	ש ט ע ל ט
שטעלן	ש ט ע ל ן
שטענדיק	ש ט ע נ ד י ק
שטענדער	ש ט ע נ ד ע ר
שטענדערל	ש ט ע נ ד ע ר ל
שטעקט	ש ט ע ק ט
שטעקן	ש ט ע ק ן
שטעקען	ש ט ע ק ע ן
שטערן	ש ט ע ר ן
שטערננעכט	ש ט ע ר נ נ ע כ ט
שטערנפיקער	ש ט ע ר נ פ י ק ע ר
שטראלט	ש ט ר א ל ט
שטראלן	ש ט ר א ל ן
שטראף	ש ט ר א ף
שטראפן	ש ט ר א פ ן
שטרודלען	ש ט ר ו ד ל ע ן
שטרוי	ש ט ר ו י
שטריק	ש ט ר י ק
שטריקן	ש ט ר י ק ן
שטרעק	ש ט ר ע ק
שטרעקט	ש ט ר ע ק ט
שיבוש	ש י ב ו ש
שידוך	ש י ד ו ך
שידוכים	ש י ד ו כ י ם
שיט	ש י ט
שיטן	ש י ט ן
שיטערער	ש י ט ע ר ע ר
שייטל	ש י י ט ל
שייך	ש י י ך
שייכות	ש י י כ ו ת
שיין	ש י י ן
שיינט	ש י י נ ט
שיינס	ש י י נ ס
שיינע	ש י י נ ע
שיינעם	ש י י נ ע ם
שיינען	ש י י נ ע ן
שיינער	ש י י נ ע ר
שיינקייט	ש י י נ ק י י ט
שייעס	ש י י ע ס
שיך	ש י ך
שיכור	ש י כ ו ר
שיכורים	ש י כ ו ר י ם
שילדערן	ש י ל ד ע ר ן
שילערס	ש י ל ע ר ס
שימחה	ש י מ ח ה
שימחתנו	ש י מ ח ת נ ו
שין	ש י ן
שיסל	ש י ס ל
שיסן	ש י ס ן
שיסער	ש י ס ע ר
שיע	ש י ע
שיעור	ש י ע ו ר
שיעלע	ש י ע ל ע
שיער	ש י ע ר
שיף	ש י ף
שיפער	ש י פ ע ר
שיצט	ש י צ ט
שיק	ש י ק
שיקט	ש י ק ט
שיקט־אריין	ש י ק ט ־ א ר י י ן
שיקן	ש י ק ן
שיר	ש י ר
שכיח	ש כ י ח
שכירות	ש כ י ר ו ת
שכל	ש כ ל
שכנות	ש כ נ ו ת
שכנים	ש כ נ י ם
שכר	ש כ ר
של	ש ל
שלאבאדא	ש ל א ב א ד א
שלאגט	ש ל א ג ט
שלאגן	ש ל א ג ן
שלאנג	ש ל א נ ג
שלאנגען	ש ל א נ ג ע ן
שלאס	ש ל א ס
שלאף	ש ל א ף
שלאפגעטראנק	ש ל א פ ג ע ט ר א נ ק
שלאפט	ש ל א פ ט
שלאפן	ש ל א פ ן
שלאפנדיקן	ש ל א פ נ ד י ק ן
שלאפקייטן	ש ל א פ ק י י ט ן
שלום	ש ל ו ם
שלום־עליכם	ש ל ו ם ־ ע ל י כ ם
שלום־עליכמען	ש ל ו ם ־ ע ל י כ מ ע ן
שלומקע	ש ל ו מ ק ע
שלוק	ש ל ו ק
שלח־מנות	ש ל ח ־ מ נ ו ת
שלחן	ש ל ח ן
שלחן־ערוך	ש ל ח ן ־ ע ר ו ך
שלי	ש ל י
שליאך	ש ל י א ך
שליחות	ש ל י ח ו ת
שליחים	ש ל י ח י ם
שליטן	ש ל י ט ן
שליטנס	ש ל י ט נ ס
שליידער	ש ל י י ד ע ר
שליידערט	ש ל י י ד ע ר ט
שליידערנדיק	ש ל י י ד ע ר נ ד י ק
שלייער	ש ל י י ע ר
שלייפן	ש ל י י פ ן
שלים־שלים־מזל	ש ל י ם ־ ש ל י ם ־ מ ז ל
שלימזל	ש ל י מ ז ל
שלינג	ש ל י נ ג
שלינגען	ש ל י נ ג ע ן
שליסל	ש ל י ס ל
שליץ	ש ל י ץ
שלל	ש ל ל
שלמה	ש ל מ ה
שלעכט	ש ל ע כ ט
שלעכטיקייט	ש ל ע כ ט י ק י י ט
שלעכטס	ש ל ע כ ט ס
שלעכטער	ש ל ע כ ט ע ר
שלעפט	ש ל ע פ ט
שלעפן	ש ל ע פ ן
שלעפערס	ש ל ע פ ע ר ס
שלעק	ש ל ע ק
שם	ש ם
שמאטעס	ש מ א ט ע ס
שמאכטעס	ש מ א כ ט ע ס
שמו	ש מ ו
שמויגער	ש מ ו י ג ע ר
שמונה־עשרה	ש מ ו נ ה ־ ע ש ר ה
שמוסט	ש מ ו ס ט
שמועל	ש מ ו ע ל
שמועס	ש מ ו ע ס
שמועסט	ש מ ו ע ס ט
שמועסן	ש מ ו ע ס ן
שמועסנדיק	ש מ ו ע ס נ ד י ק
שמות	ש מ ו ת
שמחה	ש מ ח ה
שמחות	ש מ ח ו ת
שמחת	ש מ ח ת
שמחת־תורה	ש מ ח ת ־ ת ו ר ה
שמייכל	ש מ י י כ ל
שמייכלט	ש מ י י כ ל ט
שמייכלען	ש מ י י כ ל ע ן
שמייכלענדיקע	ש מ י י כ ל ע נ ד י ק ע
שמייכעלע	ש מ י י כ ע ל ע
שמייסן	ש מ י י ס ן
שמייסער	ש מ י י ס ע ר
שמיעה	ש מ י ע ה
שמיץ	ש מ י ץ
שמירעכץ	ש מ י ר ע כ ץ
שמע	ש מ ע
שמעו	ש מ ע ו
שמעון	ש מ ע ו ן
שמעלקע	ש מ ע ל ק ע
שמעלקען	ש מ ע ל ק ע ן
שמעק	ש מ ע ק
שמעקט	ש מ ע ק ט
שמעקן	ש מ ע ק ן
שמעקנדיקער	ש מ ע ק נ ד י ק ע ר
שמערל	ש מ ע ר ל
שמש	ש מ ש
שמשים	ש מ ש י ם
שנארכט	ש נ א ר כ ט
שנארכנדיקן	ש נ א ר כ נ ד י ק ן
שנארער	ש נ א ר ע ר
שנור	ש נ ו ר
שני־בשלישי	ש נ י ־ ב ש ל י ש י
שניט	ש נ י ט
שניט־סחורה	ש נ י ט ־ ס ח ו ר ה
שניי	ש נ י י
שניי־דעקע	ש נ י י ־ ד ע ק ע
שניי־ווייסן	ש נ י י ־ ו ו י י ס ן
שניידט	ש נ י י ד ט
שניידן	ש נ י י ד ן
שניידער	ש נ י י ד ע ר
שניידערוק	ש נ י י ד ע ר ו ק
שניידעריי	ש נ י י ד ע ר י י
שניידערס	ש נ י י ד ע ר ס
שנייט	ש נ י י ט
שניר	ש נ י ר
שנעל	ש נ ע ל
שעה	ש ע ה
שעיהס	ש ע י ה ס
שעלט	ש ע ל ט
שעלטן	ש ע ל ט ן
שעם	ש ע ם
שעמען	ש ע מ ע ן
שעמערירט	ש ע מ ע ר י ר ט
שענסטע	ש ע נ ס ט ע
שענסטער	ש ע נ ס ט ע ר
שענער	ש ע נ ע ר
שענק	ש ע נ ק
שענקען	ש ע נ ק ע ן
שענקער	ש ע נ ק ע ר
שענקערס	ש ע נ ק ע ר ס
שענקערקע	ש ע נ ק ע ר ק ע
שעפ	ש ע פ
שעפן	ש ע פ ן
שעפסן	ש ע פ ס ן
שעפעלעך	ש ע פ ע ל ע ך
שער־און־אייזן	ש ע ר ־ א ו ן ־ א י י ז ן
שער־בלאט	ש ע ר ־ ב ל א ט
שפאגל	ש פ א ג ל
שפאלט	ש פ א ל ט
שפאלע	ש פ א ל ע
שפאניען	ש פ א נ י ע ן
שפאנען	ש פ א נ ע ן
שפאס	ש פ א ס
שפאקולן	ש פ א ק ו ל ן
שפאר	ש פ א ר
שפארט	ש פ א ר ט
שפארן	ש פ א ר ן
שפארעניש	ש פ א ר ע נ י ש
שפיטאל	ש פ י ט א ל
שפיטאל־בעט	ש פ י ט א ל ־ ב ע ט
שפיי	ש פ י י
שפייז־געוועלבל	ש פ י י ז ־ ג ע ו ו ע ל ב ל
שפייען	ש פ י י ע ן
שפיל	ש פ י ל
שפילט	ש פ י ל ט
שפילן	ש פ י ל ן
שפילסט	ש פ י ל ס ט
שפילסטו	ש פ י ל ס ט ו
שפילשליווער	ש פ י ל ש ל י ו ו ע ר
שפינען	ש פ י נ ע ן
שפיץ	ש פ י ץ
שפיציק	ש פ י צ י ק
שפיצל	ש פ י צ ל
שפיצלעך	ש פ י צ ל ע ך
שפיצעכיקע	ש פ י צ ע כ י ק ע
שפירט	ש פ י ר ט
שפעט	ש פ ע ט
שפעטע	ש פ ע ט ע
שפעטער	ש פ ע ט ע ר
שפעטערדיקע	ש פ ע ט ע ר ד י ק ע
שפענדל	ש פ ע נ ד ל
שפענער	ש פ ע נ ע ר
שפענצטער	ש פ ע נ צ ט ע ר
שפענצער	ש פ ע נ צ ע ר
שפראך	ש פ ר א ך
שפראצן	ש פ ר א צ ן
שפרוך	ש פ ר ו ך
שפרייזט	ש פ ר י י ז ט
שפרייט	ש פ ר י י ט
שפרינצע	ש פ ר י נ צ ע
שפריצט	ש פ ר י צ ט
שפרעכט	ש פ ר ע כ ט
שפרעכערין	ש פ ר ע כ ע ר י ן
שקאלא	ש ק א ל א
שקצים	ש ק צ י ם
שקר־וכזב	ש ק ר ־ ו כ ז ב
שרה	ש ר ה
שרויפן	ש ר ו י פ ן
שריי	ש ר י י
שרייבט	ש ר י י ב ט
שרייבטיש	ש ר י י ב ט י ש
שרייבן	ש ר י י ב ן
שרייבער	ש ר י י ב ע ר
שרייט	ש ר י י ט
שרייען	ש ר י י ע ן
שריפטן	ש ר י פ ט ן
שרעק	ש ר ע ק
שרפה	ש ר פ ה
שרץ	ש ר ץ
שרצים	ש ר צ י ם
שררה	ש ר ר ה
שררות	ש ר ר ו ת
ששים	ש ש י ם
שששא	ש ש ש א
ששת	ש ש ת
שתחיה	ש ת ח י ה
תאוה	ת א ו ה
תאווה	ת א ו ו ה
תבואה	ת ב ו א ה
תבואות	ת ב ו א ו ת
תביעות	ת ב י ע ו ת
תהילום	ת ה י ל ו ם
תוהו־ובוהו־	ת ו ה ו ־ ו ב ו ה ו ־
תוהו־ובוהו־וועלט	ת ו ה ו ־ ו ב ו ה ו ־ ו ו ע ל ט
תוך	ת ו ך
תוכחה	ת ו כ ח ה
תופס	ת ו פ ס
תורה	ת ו ר ה
תורת־משה	ת ו ר ת ־ מ ש ה
תושב	ת ו ש ב
תחום־שבת	ת ח ו ם ־ ש ב ת
תחילת	ת ח י ל ת
תחינה	ת ח י נ ה
תחינות	ת ח י נ ו ת
תחתונים	ת ח ת ו נ י ם
תחתית	ת ח ת י ת
תיכף	ת י כ ף
תימן	ת י מ ן
תיקון	ת י ק ו ן
תירוץ	ת י ר ו ץ
תירוצים	ת י ר ו צ י ם
תכלית	ת כ ל י ת
תכריכים	ת כ ר י כ י ם
תכשיט	ת כ ש י ט
תל	ת ל
תלמוד	ת ל מ ו ד
תלמוד־תורה	ת ל מ ו ד ־ ת ו ר ה
תלמידי־בעל־שם	ת ל מ י ד י ־ ב ע ל ־ ש ם
תלמידי־הכמים	ת ל מ י ד י ־ ה כ מ י ם
תמיד	ת מ י ד
תמעוואטע	ת מ ע ו ו א ט ע
תנאים	ת נ א י ם
תנחום	ת נ ח ו ם
תענית	ת ע נ י ת
תעניתים	ת ע נ י ת י ם
תפוצות	ת פ ו צ ו ת
תפילה	ת פ י ל ה
תפילהלע	ת פ י ל ה ל ע
תפילות	ת פ י ל ו ת
תפילין	ת פ י ל י ן
תפילין־בייטעלע	ת פ י ל י ן ־ ב י י ט ע ל ע
תפיסה	ת פ י ס ה
תרגום־לשון	ת ר ג ו ם ־ ל ש ו ן
תרעומות	ת ר ע ו מ ו ת
תשובה	ת ש ו ב ה