'בטלן'	' ב ט ל ן '
'הענדום'	' ה ע נ ד ו ם '
'זיצן'	' ז י צ ן '
'טאַנאַך'	' ט אַ נ אַ ך '
'ס'	' ס '
'סמך'	' ס מ ך '
'סכּנה'	' ס כּ נ ה '
'עט'	' ע ט '
'װאָלװל'	' װ אָ ל װ ל '
'פּכע'	' פּ כ ע '
'פּענדום'	' פּ ע נ ד ו ם '
'פּש'	' פּ ש '
־איר	־ א י ר
־דער	־ ד ע ר
־װאָס	־ װ אָ ס
א	א
אבה	א ב ה
אבי־װער	א ב י ־ װ ע ר
אבן	א ב ן
אבר	א ב ר
אברהם	א ב ר ה ם
אברים	א ב ר י ם
אדם	א ד ם
אדר	א ד ר
אדרבא	א ד ר ב א
אוגערקע	א ו ג ע ר ק ע
אודאי	א ו ד א י
אוהבֿ	א ו ה בֿ
אום	א ו ם
אומבאַשרײַבלעך	א ו מ ב אַ ש ר ײַ ב ל ע ך
אומגליק	א ו מ ג ל י ק
אומגליקלעכער	א ו מ ג ל י ק ל ע כ ע ר
אומגליקן	א ו מ ג ל י ק ן
אומגעדולדיקער	א ו מ ג ע ד ו ל ד י ק ע ר
אומגעזוכט	א ו מ ג ע ז ו כ ט
אומגעלומפּערטן	א ו מ ג ע ל ו מ פּ ע ר ט ן
אומגעלומפּערטע	א ו מ ג ע ל ו מ פּ ע ר ט ע
אומגעקערט	א ו מ ג ע ק ע ר ט
אומגעריכט	א ו מ ג ע ר י כ ט
אומגערעכט	א ו מ ג ע ר ע כ ט
אומדרײען	א ו מ ד ר ײ ע ן
אומהײמלעך	א ו מ ה ײ מ ל ע ך
אומזיסט	א ו מ ז י ס ט
אומזיסטינע	א ו מ ז י ס ט י נ ע
אומחן	א ו מ ח ן
אומיסטן	א ו מ י ס ט ן
אוממעגלעך	א ו מ מ ע ג ל ע ך
אומעטום	א ו מ ע ט ו ם
אומעטיק	א ו מ ע ט י ק
אומעטיקע	א ו מ ע ט י ק ע
אומרײנע	א ו מ ר ײ נ ע
אומשלעפּן	א ו מ ש ל ע פּ ן
אומאַן	א ו מ אַ ן
אומאַנער	א ו מ אַ נ ע ר
אומכּבֿוד	א ו מ כּ בֿ ו ד
און	א ו ן
אונ	א ו נ
אונגעריכט	א ו נ ג ע ר י כ ט
אונדז	א ו נ ד ז
אונדזער	א ו נ ד ז ע ר
אונדזערע	א ו נ ד ז ע ר ע
אונטן	א ו נ ט ן
אונטער	א ו נ ט ע ר
אונטער־געסל	א ו נ ט ע ר ־ ג ע ס ל
אונטער־עסל	א ו נ ט ע ר ־ ע ס ל
אונטערגעבן	א ו נ ט ע ר ג ע ב ן
אונטערגעגאַנגען	א ו נ ט ע ר ג ע ג אַ נ ג ע ן
אונטערגעהאָלפֿן	א ו נ ט ע ר ג ע ה אָ ל פֿ ן
אונטערגעכאַפּט	א ו נ ט ע ר ג ע כ אַ פּ ט
אונטערגעצונדן	א ו נ ט ע ר ג ע צ ו נ ד ן
אונטערגעשריבן	א ו נ ט ע ר ג ע ש ר י ב ן
אונטערגעװאָרפֿן	א ו נ ט ע ר ג ע װ אָ ר פֿ ן
אונטערגײן	א ו נ ט ע ר ג ײ ן
אונטערהוסטן	א ו נ ט ע ר ה ו ס ט ן
אונטערזוכט	א ו נ ט ע ר ז ו כ ט
אונטערחתמענען	א ו נ ט ע ר ח ת מ ע נ ע ן
אונטערן	א ו נ ט ע ר ן
אונטערצוהעלפֿן	א ו נ ט ע ר צ ו ה ע ל פֿ ן
אונטערצינדן	א ו נ ט ע ר צ י נ ד ן
אונטערשערן	א ו נ ט ע ר ש ע ר ן
אונטערשרײַבן	א ו נ ט ע ר ש ר ײַ ב ן
אוניװערסיטעט	א ו נ י װ ע ר ס י ט ע ט
אונקוקן	א ו נ ק ו ק ן
אוצר	א ו צ ר
אוצרות	א ו צ ר ו ת
אור	א ו ר
אורח	א ו ר ח
אורחים	א ו ר ח י ם
אותיות	א ו ת י ו ת
אופֿן	א ו פֿ ן
אז	א ז
אחים	א ח י ם
אחינו	א ח י נ ו
אחר	א ח ר
אטעם	א ט ע ם
אי	א י
איבער	א י ב ע ר
איבערבעט	א י ב ע ר ב ע ט
איבערבעטן	א י ב ע ר ב ע ט ן
איבערגעבן	א י ב ע ר ג ע ב ן
איבערגעבראָכן	א י ב ע ר ג ע ב ר אָ כ ן
איבערגעבױגן	א י ב ע ר ג ע ב ױ ג ן
איבערגעגעבן	א י ב ע ר ג ע ג ע ב ן
איבערגעדרוקט	א י ב ע ר ג ע ד ר ו ק ט
איבערגעדרײט	א י ב ע ר ג ע ד ר ײ ט
איבערגעזונגען	א י ב ע ר ג ע ז ו נ ג ע ן
איבערגעזען	א י ב ע ר ג ע ז ע ן
איבערגעזעצט	א י ב ע ר ג ע ז ע צ ט
איבערגעחזרט	א י ב ע ר ג ע ח ז ר ט
איבערגעלעבט	א י ב ע ר ג ע ל ע ב ט
איבערגעלעגטע	א י ב ע ר ג ע ל ע ג ט ע
איבערגעלײגט	א י ב ע ר ג ע ל ײ ג ט
איבערגעלאָזט	א י ב ע ר ג ע ל אָ ז ט
איבערגענומען	א י ב ע ר ג ע נ ו מ ע ן
איבערגעקוקט	א י ב ע ר ג ע ק ו ק ט
איבערגעקלונגען	א י ב ע ר ג ע ק ל ו נ ג ע ן
איבערגעקערט	א י ב ע ר ג ע ק ע ר ט
איבערגעקריגט	א י ב ע ר ג ע ק ר י ג ט
איבערגעריסן	א י ב ע ר ג ע ר י ס ן
איבערגערעכנט	א י ב ע ר ג ע ר ע כ נ ט
איבערגעשריגן	א י ב ע ר ג ע ש ר י ג ן
איבערגעשפּיצטער	א י ב ע ר ג ע ש פּ י צ ט ע ר
איבערגעפֿאַלן	א י ב ע ר ג ע פֿ אַ ל ן
איבערגעפֿאָרן	א י ב ע ר ג ע פֿ אָ ר ן
איבערגײן	א י ב ע ר ג ײ ן
איבערהױפּט	א י ב ע ר ה ױ פּ ט
איבערחזרן	א י ב ע ר ח ז ר ן
איבערטון	א י ב ע ר ט ו ן
איבערטראַכטן	א י ב ע ר ט ר אַ כ ט ן
איבעריק	א י ב ע ר י ק
איבעריקן	א י ב ע ר י ק ן
איבעריקס	א י ב ע ר י ק ס
איבערלײענען	א י ב ע ר ל ײ ע נ ע ן
איבערלאָזן	א י ב ע ר ל אָ ז ן
איבערמאָרגן	א י ב ע ר מ אָ ר ג ן
איבערן	א י ב ע ר ן
איבערנעכטיקן	א י ב ע ר נ ע כ ט י ק ן
איבערנעמען	א י ב ע ר נ ע מ ע ן
איבערצוג	א י ב ע ר צ ו ג
איבערצולאָזן	א י ב ע ר צ ו ל אָ ז ן
איבערצונעכטיקן	א י ב ע ר צ ו נ ע כ ט י ק ן
איבערצוקומען	א י ב ע ר צ ו ק ו מ ע ן
איבערקוקן	א י ב ע ר ק ו ק ן
איבערקלײַבערין	א י ב ע ר ק ל ײַ ב ע ר י ן
איבעררעדן	א י ב ע ר ר ע ד ן
איבערשמועסן	א י ב ע ר ש מ ו ע ס ן
איבערשפּאַרן	א י ב ע ר ש פּ אַ ר ן
איבעראַל	א י ב ע ר אַ ל
איבערפֿילט	א י ב ע ר פֿ י ל ט
איבערפֿרעגן	א י ב ע ר פֿ ר ע ג ן
איובֿ	א י ו בֿ
איז	א י ז
איזשביצער	א י ז ש ב י צ ע ר
איזװאַשטשיקעס	א י ז װ אַ ש ט ש י ק ע ס
איטלעכן	א י ט ל ע כ ן
איטלעכע	א י ט ל ע כ ע
איטלעכער	א י ט ל ע כ ע ר
איטע	א י ט ע
איטשע	א י ט ש ע
איך	א י ך
אילון	א י ל ו ן
אים	א י ם
אים־ירצה־השם	א י ם ־ י ר צ ה ־ ה ש ם
אימה	א י מ ה
אימער	א י מ ע ר
אימשטאַנד	א י מ ש ט אַ נ ד
אין	א י ן
אין־יעקב	א י ן ־ י ע ק ב
אינגעװײד	א י נ ג ע װ ײ ד
אינדזל	א י נ ד ז ל
אינדיטשקע	א י נ ד י ט ש ק ע
אינדיאַנער	א י נ ד י אַ נ ע ר
אינטעליגענץ	א י נ ט ע ל י ג ע נ ץ
אינטערעס	א י נ ט ע ר ע ס
אינטערעסירט	א י נ ט ע ר ע ס י ר ט
אינטערעסאַנט	א י נ ט ע ר ע ס אַ נ ט
אינטערעסאַנטע	א י נ ט ע ר ע ס אַ נ ט ע
אינטריגע	א י נ ט ר י ג ע
אינס	א י נ ס
אינסטיטוציעס	א י נ ס ט י ט ו צ י ע ס
אינסטרומענטן	א י נ ס ט ר ו מ ע נ ט ן
אינסינואַציעס	א י נ ס י נ ו אַ צ י ע ס
אינעם	א י נ ע ם
אינעװײניק	א י נ ע װ ײ נ י ק
איצט	א י צ ט
איצטיקע	א י צ ט י ק ע
איצטיקער	א י צ ט י ק ע ר
איצטער	א י צ ט ע ר
איר	א י ר
איר'ט	א י ר ' ט
איריקן	א י ר י ק ן
איריקע	א י ר י ק ע
אירן	א י ר ן
אירס	א י ר ס
אירע	א י ר ע
אירער	א י ר ע ר
איש	א י ש
איװאַן	א י װ אַ ן
אך	א ך
אכילה	א כ י ל ה
אכסניה	א כ ס נ י ה
אל	א ל
אל־מלך־נאמן	א ל ־ מ ל ך ־ נ א מ ן
אליהו	א ל י ה ו
אלמן	א ל מ ן
אלף	א ל ף
אם	א ם
אמונה	א מ ו נ ה
אמת	א מ ת
אמת־זאָגער	א מ ת ־ ז אָ ג ע ר
אמתדיק	א מ ת ד י ק
אמתן	א מ ת ן
אמתע	א מ ת ע
אמתער	א מ ת ע ר
אן	א ן
אסור	א ס ו ר
אסטר	א ס ט ר
אסתּר	א ס תּ ר
אצינד	א צ י נ ד
ארון	א ר ו ן
ארכו	א ר כ ו
ארץ־	א ר ץ ־
ארץ־ישׂראל	א ר ץ ־ י שׂ ר א ל
ארץ־ישׂראל־ערד	א ר ץ ־ י שׂ ר א ל ־ ע ר ד
ארױס	א ר ױ ס
אש	א ש
אש־להבֿה	א ש ־ ל ה בֿ ה
אשה	א ש ה
אשר	א ש ר
אשת	א ש ת
אשת־איש	א ש ת ־ א י ש
אתרוג	א ת ר ו ג
אװדאי	א װ ד א י
אױב	א ױ ב
אױבן	א ױ ב ן
אױבן־אָן	א ױ ב ן ־ אָ ן
אױבנאָן	א ױ ב נ אָ ן
אױבערהאַר	א ױ ב ע ר ה אַ ר
אױבערשטער	א ױ ב ע ר ש ט ע ר
אױבערפֿלעכע	א ױ ב ע ר פֿ ל ע כ ע
אױג	א ױ ג
אױגן	א ױ ג ן
אױגעלעך	א ױ ג ע ל ע ך
אױך	א ױ ך
אױס	א ױ ס
אױס־און	א ױ ס ־ א ו ן
אױסבילדעװען	א ױ ס ב י ל ד ע װ ע ן
אױסבעסערונגען	א ױ ס ב ע ס ע ר ו נ ג ע ן
אױסגעברענט	א ױ ס ג ע ב ר ע נ ט
אױסגעבראָכן	א ױ ס ג ע ב ר אָ כ ן
אױסגעבױגן	א ױ ס ג ע ב ױ ג ן
אױסגעבױט	א ױ ס ג ע ב ױ ט
אױסגעגלאָצטע	א ױ ס ג ע ג ל אָ צ ט ע
אױסגעגראָבן	א ױ ס ג ע ג ר אָ ב ן
אױסגעגאַנגען	א ױ ס ג ע ג אַ נ ג ע ן
אױסגעגאָסן	א ױ ס ג ע ג אָ ס ן
אױסגעדינטער	א ױ ס ג ע ד י נ ט ע ר
אױסגעהערט	א ױ ס ג ע ה ע ר ט
אױסגעהאַלטן	א ױ ס ג ע ה אַ ל ט ן
אױסגעזען	א ױ ס ג ע ז ע ן
אױסגעטריקנט	א ױ ס ג ע ט ר י ק נ ט
אױסגעטרײסלט	א ױ ס ג ע ט ר ײ ס ל ט
אױסגעטראַכט	א ױ ס ג ע ט ר אַ כ ט
אױסגעלערנט	א ױ ס ג ע ל ע ר נ ט
אױסגעלײזט	א ױ ס ג ע ל ײ ז ט
אױסגעלײזטן	א ױ ס ג ע ל ײ ז ט ן
אױסגעלאָזט	א ױ ס ג ע ל אָ ז ט
אױסגעמיטן	א ױ ס ג ע מ י ט ן
אױסגעמישט	א ױ ס ג ע מ י ש ט
אױסגעמאָלט	א ױ ס ג ע מ אָ ל ט
אױסגעניכטערט	א ױ ס ג ע נ י כ ט ע ר ט
אױסגעצױגן	א ױ ס ג ע צ ױ ג ן
אױסגעצײכנט	א ױ ס ג ע צ ײ כ נ ט
אױסגעקליבן	א ױ ס ג ע ק ל י ב ן
אױסגעקערט	א ױ ס ג ע ק ע ר ט
אױסגעקערעװעט	א ױ ס ג ע ק ע ר ע װ ע ט
אױסגעקראַצט	א ױ ס ג ע ק ר אַ צ ט
אױסגעקױלעט	א ױ ס ג ע ק ױ ל ע ט
אױסגערוט	א ױ ס ג ע ר ו ט
אױסגערופֿן	א ױ ס ג ע ר ו פֿ ן
אױסגעריסן	א ױ ס ג ע ר י ס ן
אױסגערעדט	א ױ ס ג ע ר ע ד ט
אױסגעשטודירט	א ױ ס ג ע ש ט ו ד י ר ט
אױסגעשטעלט	א ױ ס ג ע ש ט ע ל ט
אױסגעשטעלטע	א ױ ס ג ע ש ט ע ל ט ע
אױסגעשטערנט	א ױ ס ג ע ש ט ע ר נ ט
אױסגעשטרעקט	א ױ ס ג ע ש ט ר ע ק ט
אױסגעשלעפּט	א ױ ס ג ע ש ל ע פּ ט
אױסגעשלאָגן	א ױ ס ג ע ש ל אָ ג ן
אױסגעשמירט	א ױ ס ג ע ש מ י ר ט
אױסגעשפּיגן	א ױ ס ג ע ש פּ י ג ן
אױסגעשפּאַנט	א ױ ס ג ע ש פּ אַ נ ט
אױסגעװיזן	א ױ ס ג ע װ י ז ן
אױסגעװען	א ױ ס ג ע װ ע ן
אױסגעװאַקסן	א ױ ס ג ע װ אַ ק ס ן
אױסגעפּאַטשט	א ױ ס ג ע פּ אַ ט ש ט
אױסגעפֿירט	א ױ ס ג ע פֿ י ר ט
אױסגעפֿרױרן	א ױ ס ג ע פֿ ר ױ ר ן
אױסגעפֿאַלן	א ױ ס ג ע פֿ אַ ל ן
אױסגעפֿאַלענע	א ױ ס ג ע פֿ אַ ל ע נ ע
אױסגײן	א ױ ס ג ײ ן
אױסדערצײלן	א ױ ס ד ע ר צ ײ ל ן
אױסהערן	א ױ ס ה ע ר ן
אױסהאַלטן	א ױ ס ה אַ ל ט ן
אױסזוכן	א ױ ס ז ו כ ן
אױסזיצן	א ױ ס ז י צ ן
אױסטענהן	א ױ ס ט ע נ ה ן
אױסטערליש	א ױ ס ט ע ר ל י ש
אױסטערליש־װוּנדערלעכע	א ױ ס ט ע ר ל י ש ־ װ וּ נ ד ע ר ל ע כ ע
אױסטערלישע	א ױ ס ט ע ר ל י ש ע
אױסטערלישער	א ױ ס ט ע ר ל י ש ע ר
אױסטראַכטענישן	א ױ ס ט ר אַ כ ט ע נ י ש ן
אױסטאָן	א ױ ס ט אָ ן
אױסלערנען	א ױ ס ל ע ר נ ע ן
אױסלײגן	א ױ ס ל ײ ג ן
אױסלײגעכץ־רעפֿאָרמען	א ױ ס ל ײ ג ע כ ץ ־ ר ע פֿ אָ ר מ ע ן
אױסלאַנד	א ױ ס ל אַ נ ד
אױסלאָזן	א ױ ס ל אָ ז ן
אױסמײַדנדיק	א ױ ס מ ײַ ד נ ד י ק
אױסן	א ױ ס ן
אױסניכטערן	א ױ ס נ י כ ט ע ר ן
אױסנעמעניש	א ױ ס נ ע מ ע נ י ש
אױסנװײניק	א ױ ס נ װ ײ נ י ק
אױסנײען	א ױ ס נ ײ ע ן
אױסער	א ױ ס ע ר
אױסצובעטלען	א ױ ס צ ו ב ע ט ל ע ן
אױסצולערנען	א ױ ס צ ו ל ע ר נ ע ן
אױסצורעדן	א ױ ס צ ו ר ע ד ן
אױסציען	א ױ ס צ י ע ן
אױסצאָלן	א ױ ס צ אָ ל ן
אױסקומען	א ױ ס ק ו מ ע ן
אױסקערן	א ױ ס ק ע ר ן
אױסקױקלען	א ױ ס ק ױ ק ל ע ן
אױסרוען	א ױ ס ר ו ע ן
אױסרעדן	א ױ ס ר ע ד ן
אױסרעכענען	א ױ ס ר ע כ ע נ ע ן
אױסרײדן	א ױ ס ר ײ ד ן
אױסרײַסן	א ױ ס ר ײַ ס ן
אױסשטרעקנדיק	א ױ ס ש ט ר ע ק נ ד י ק
אױסשטײן	א ױ ס ש ט ײ ן
אױסשלײפֿן	א ױ ס ש ל ײ פֿ ן
אױסשלאָגן	א ױ ס ש ל אָ ג ן
אױסװײניק	א ױ ס װ ײ נ י ק
אױספּרוּװן	א ױ ס פּ ר וּ װ ן
אױספֿירן	א ױ ס פֿ י ר ן
אױספֿאָרשן	א ױ ס פֿ אָ ר ש ן
אױער	א ױ ע ר
אױערן	א ױ ע ר ן
אױף	א ױ ף
אױרינגל	א ױ ר י נ ג ל
אױװן	א ױ װ ן
אױװן־אָן	א ױ װ ן ־ אָ ן
אױבֿנאָן	א ױ בֿ נ אָ ן
אױפֿבױען	א ױ פֿ ב ױ ע ן
אױפֿגעבױט	א ױ פֿ ג ע ב ױ ט
אױפֿגעגעסן	א ױ פֿ ג ע ג ע ס ן
אױפֿגעגעסענע	א ױ פֿ ג ע ג ע ס ע נ ע
אױפֿגעדעקט	א ױ פֿ ג ע ד ע ק ט
אױפֿגעהערט	א ױ פֿ ג ע ה ע ר ט
אױפֿגעהױבן	א ױ פֿ ג ע ה ױ ב ן
אױפֿגעהאַלטן	א ױ פֿ ג ע ה אַ ל ט ן
אױפֿגעזאַמלט	א ױ פֿ ג ע ז אַ מ ל ט
אױפֿגעטרײסלט	א ױ פֿ ג ע ט ר ײ ס ל ט
אױפֿגעכאַפּט	א ױ פֿ ג ע כ אַ פּ ט
אױפֿגעלעבט	א ױ פֿ ג ע ל ע ב ט
אױפֿגעלײגט	א ױ פֿ ג ע ל ײ ג ט
אױפֿגעלאָפֿן	א ױ פֿ ג ע ל אָ פֿ ן
אױפֿגענײט	א ױ פֿ ג ע נ ײ ט
אױפֿגעקומענער	א ױ פֿ ג ע ק ו מ ע נ ע ר
אױפֿגערופֿן	א ױ פֿ ג ע ר ו פֿ ן
אױפֿגעריכט	א ױ פֿ ג ע ר י כ ט
אױפֿגערױמט	א ױ פֿ ג ע ר ױ מ ט
אױפֿגעשטעלטע	א ױ פֿ ג ע ש ט ע ל ט ע
אױפֿגעשטאַנען	א ױ פֿ ג ע ש ט אַ נ ע ן
אױפֿגעשריבן	א ױ פֿ ג ע ש ר י ב ן
אױפֿגעשײַנט	א ױ פֿ ג ע ש ײַ נ ט
אױפֿגעװעקט	א ױ פֿ ג ע װ ע ק ט
אױפֿגעפּוצט	א ױ פֿ ג ע פּ ו צ ט
אױפֿהענגען	א ױ פֿ ה ע נ ג ע ן
אױפֿהער	א ױ פֿ ה ע ר
אױפֿהערן	א ױ פֿ ה ע ר ן
אױפֿהײבן	א ױ פֿ ה ײ ב ן
אױפֿכאַפּן	א ױ פֿ כ אַ פּ ן
אױפֿלאָג	א ױ פֿ ל אָ ג
אױפֿן	א ױ פֿ ן
אױפֿנײען	א ױ פֿ נ ײ ע ן
אױפֿצוהערן	א ױ פֿ צ ו ה ע ר ן
אױפֿצוהױבן	א ױ פֿ צ ו ה ױ ב ן
אױפֿצוזעצן	א ױ פֿ צ ו ז ע צ ן
אױפֿצוכאָװען	א ױ פֿ צ ו כ אָ װ ע ן
אױפֿצורופֿן	א ױ פֿ צ ו ר ו פֿ ן
אױפֿצוריכטן	א ױ פֿ צ ו ר י כ ט ן
אױפֿצושטײן	א ױ פֿ צ ו ש ט ײ ן
אױפֿקלערן	א ױ פֿ ק ל ע ר ן
אױפֿשטײן	א ױ פֿ ש ט ײ ן
אױפֿשײן	א ױ פֿ ש ײ ן
אױפֿשײַנען	א ױ פֿ ש ײַ נ ע ן
אײביק	א ײ ב י ק
אײביקע	א ײ ב י ק ע
אײבערשטן	א ײ ב ע ר ש ט ן
אײגנטלעך	א ײ ג נ ט ל ע ך
אײגנס	א ײ ג נ ס
אײגעלעך	א ײ ג ע ל ע ך
אײגענע	א ײ ג ע נ ע
אײגענעם	א ײ ג ע נ ע ם
אײגענער	א ײ ג ע נ ע ר
אײדל	א ײ ד ל
אײדלען	א ײ ד ל ע ן
אײדלער	א ײ ד ל ע ר
אײדלקײט	א ײ ד ל ק ײ ט
אײדעלן	א ײ ד ע ל ן
אײדעלע	א ײ ד ע ל ע
אײדעלער	א ײ ד ע ל ע ר
אײדעם	א ײ ד ע ם
אײדעמס	א ײ ד ע מ ס
אײדער	א ײ ד ע ר
אײזל־קאָפּ	א ײ ז ל ־ ק אָ פּ
אײלסטו	א ײ ל ס ט ו
אײן	א ײ ן
אײנגעפֿאַלן	א ײ נ ג ע פֿ אַ ל ן
אײניקל	א ײ נ י ק ל
אײניקלעך	א ײ נ י ק ל ע ך
אײנס	א ײ נ ס
אײנע	א ײ נ ע
אײנעם	א ײ נ ע ם
אײנער	א ײ נ ע ר
אײנציק	א ײ נ צ י ק
אײנציקן	א ײ נ צ י ק ן
אײנציקע	א ײ נ צ י ק ע
אײנציקער	א ײ נ צ י ק ע ר
אײנציקװײַז	א ײ נ צ י ק װ ײַ ז
אײערנעכטיק	א ײ ע ר נ ע כ ט י ק
אײראָפּע	א ײ ר אָ פּ ע
אײשישאָק	א ײ ש י ש אָ ק
אײַ	א ײַ
אײַזיק	א ײַ ז י ק
אײַזיק־מאיר	א ײַ ז י ק ־ מ א י ר
אײַזערן	א ײַ ז ע ר ן
אײַך	א ײַ ך
אײַלן	א ײַ ל ן
אײַלנדיקע	א ײַ ל נ ד י ק ע
אײַן	א ײַ ן
אײַנגעבעטן	א ײַ נ ג ע ב ע ט ן
אײַנגעבראָכן	א ײַ נ ג ע ב ר אָ כ ן
אײַנגעגעבן	א ײַ נ ג ע ג ע ב ן
אײַנגעגאַנגען	א ײַ נ ג ע ג אַ נ ג ע ן
אײַנגעדרעמלט	א ײַ נ ג ע ד ר ע מ ל ט
אײַנגעהערט	א ײַ נ ג ע ה ע ר ט
אײַנגעהױקערט	א ײַ נ ג ע ה ױ ק ע ר ט
אײַנגעהאַלטן	א ײַ נ ג ע ה אַ ל ט ן
אײַנגעהאַנדלט	א ײַ נ ג ע ה אַ נ ד ל ט
אײַנגעלײגט	א ײַ נ ג ע ל ײ ג ט
אײַנגעלאַדן	א ײַ נ ג ע ל אַ ד ן
אײַנגעמאַכץ	א ײַ נ ג ע מ אַ כ ץ
אײַנגענומען	א ײַ נ ג ע נ ו מ ע ן
אײַנגעעקשנט	א ײַ נ ג ע ע ק ש נ ט
אײַנגערעדט	א ײַ נ ג ע ר ע ד ט
אײַנגעשטימט	א ײַ נ ג ע ש ט י מ ט
אײַנגעשלאָפֿן	א ײַ נ ג ע ש ל אָ פֿ ן
אײַנגעשרומפּענע	א ײַ נ ג ע ש ר ו מ פּ ע נ ע
אײַנגעשפּאַנט	א ײַ נ ג ע ש פּ אַ נ ט
אײַנגעשפּאַרט	א ײַ נ ג ע ש פּ אַ ר ט
אײַנגעװױנט	א ײַ נ ג ע װ ױ נ ט
אײַנגעפֿינען	א ײַ נ ג ע פֿ י נ ע ן
אײַנגעפֿלאַנסט	א ײַ נ ג ע פֿ ל אַ נ ס ט
אײַנגעפֿאַלן	א ײַ נ ג ע פֿ אַ ל ן
אײַנגײן	א ײַ נ ג ײ ן
אײַנדרוק	א ײַ נ ד ר ו ק
אײַנהילן	א ײַ נ ה י ל ן
אײַנהאַלטן	א ײַ נ ה אַ ל ט ן
אײַנזיצן	א ײַ נ ז י צ ן
אײַננעמען	א ײַ נ נ ע מ ע ן
אײַנקױפֿן	א ײַ נ ק ױ פֿ ן
אײַנשטודירען	א ײַ נ ש ט ו ד י ר ע ן
אײַנשטעלן	א ײַ נ ש ט ע ל ן
אײַנשלאָפֿן	א ײַ נ ש ל אָ פֿ ן
אײַנשפּאַנען	א ײַ נ ש פּ אַ נ ע ן
אײַנװײקן	א ײַ נ װ ײ ק ן
אײַנפֿירן	א ײַ נ פֿ י ר ן
אײַנפֿאַל	א ײַ נ פֿ אַ ל
אײַנפֿאַלן	א ײַ נ פֿ אַ ל ן
אײַער	א ײַ ע ר
אײַערן	א ײַ ע ר ן
אײַערס	א ײַ ע ר ס
אײַערע	א ײַ ע ר ע
אוּנדזער	א וּ נ ד ז ע ר
אפּקױפֿן	א פּ ק ױ פֿ ן
אבֿן־טובֿ	א בֿ ן ־ ט ו בֿ
אבֿר	א בֿ ר
אבֿרהם	א בֿ ר ה ם
אבֿרים	א בֿ ר י ם
אפֿילו	א פֿ י ל ו
אפֿשר	א פֿ ש ר
ב	ב
בא	ב א
באמת	ב א מ ת
באר	ב א ר
באשר	ב א ש ר
בגד	ב ג ד
בגדים	ב ג ד י ם
בדחן	ב ד ח ן
בדיל	ב ד י ל
בדעה	ב ד ע ה
בדרך	ב ד ר ך
בהיותו	ב ה י ו ת ו
בהלה	ב ה ל ה
בהמה	ב ה מ ה
בהמות	ב ה מ ו ת
בהן	ב ה ן
בודעפֿערען	ב ו ד ע פֿ ע ר ע ן
בוזעמס	ב ו ז ע מ ס
בוך	ב ו ך
בוכהאַלטער	ב ו כ ה אַ ל ט ע ר
בוכשטאַב	ב ו כ ש ט אַ ב
בולט	ב ו ל ט
בולקע	ב ו ל ק ע
בורא	ב ו ר א
בוריקעס־באָרשט	ב ו ר י ק ע ס ־ ב אָ ר ש ט
בורשטין	ב ו ר ש ט י ן
בושה	ב ו ש ה
בזיון	ב ז י ו ן
בזיונות	ב ז י ו נ ו ת
בזשעזאָװסקי	ב ז ש ע ז אָ װ ס ק י
בזשעזאָװסקיס	ב ז ש ע ז אָ װ ס ק י ס
בזשעװזאָװסקיס	ב ז ש ע װ ז אָ װ ס ק י ס
בחור	ב ח ו ר
בחורים	ב ח ו ר י ם
בחורימלעך	ב ח ו ר י מ ל ע ך
בחוש	ב ח ו ש
בחינם	ב ח י נ ם
בחצי־חינם	ב ח צ י ־ ח י נ ם
בחרם	ב ח ר ם
בטבע	ב ט ב ע
בטהרה	ב ט ה ר ה
בטוח	ב ט ו ח
בטחון	ב ט ח ו ן
בטל	ב ט ל
בטלט	ב ט ל ט
בטבֿע	ב ט בֿ ע
ביד	ב י ד
בידנע	ב י ד נ ע
ביז	ב י ז
ביזט	ב י ז ט
ביזן	ב י ז ן
ביטול	ב י ט ו ל
ביטער	ב י ט ע ר
ביטערע	ב י ט ע ר ע
ביכלעך	ב י כ ל ע ך
ביכעלעך	ב י כ ע ל ע ך
ביכער	ב י כ ע ר
בילבול	ב י ל ב ו ל
בילגאָרײער	ב י ל ג אָ ר ײ ע ר
בילדונג	ב י ל ד ו נ ג
בילדן	ב י ל ד ן
בילדער	ב י ל ד ע ר
ביליק	ב י ל י ק
בילן	ב י ל ן
בימה	ב י מ ה
בימים	ב י מ י ם
בין	ב י ן
בינדט	ב י נ ד ט
בינטל	ב י נ ט ל
ביסט	ב י ס ט
ביסטו	ב י ס ט ו
ביסל	ב י ס ל
ביסלעך	ב י ס ל ע ך
ביסן	ב י ס ן
ביסעלע	ב י ס ע ל ע
בירגער	ב י ר ג ע ר
בירושה	ב י ר ו ש ה
בישיבֿה	ב י ש י בֿ ה
בית	ב י ת
בית־דין	ב י ת ־ ד י ן
בית־דין־שטוב	ב י ת ־ ד י ן ־ ש ט ו ב
בית־המדרש	ב י ת ־ ה מ ד ר ש
בית־המדרש־גמרות	ב י ת ־ ה מ ד ר ש ־ ג מ ר ו ת
בית־המיקדש	ב י ת ־ ה מ י ק ד ש
בית־מדרש	ב י ת ־ מ ד ר ש
ביתר	ב י ת ר
ביוּש	ב י וּ ש
ביתּ־מדרש	ב י תּ ־ מ ד ר ש
בכל	ב כ ל
בכלל	ב כ ל ל
בכן	ב כ ן
בלוט	ב ל ו ט
בלוטיק	ב ל ו ט י ק
בלוטיקן	ב ל ו ט י ק ן
בלוטן	ב ל ו ט ן
בלומכע	ב ל ו מ כ ע
בלומען	ב ל ו מ ע ן
בליט	ב ל י ט
בליצט	ב ל י צ ט
בליק	ב ל י ק
בלישטשעט	ב ל י ש ט ש ע ט
בלישטשען	ב ל י ש ט ש ע ן
בלעטערט	ב ל ע ט ע ר ט
בלעך	ב ל ע ך
בלעכענער	ב ל ע כ ע נ ע ר
בלענדנדיקער	ב ל ע נ ד נ ד י ק ע ר
בלױ	ב ל ױ
בלױז	ב ל ױ ז
בלױזן	ב ל ױ ז ן
בלױזער	ב ל ױ ז ע ר
בלױע	ב ל ױ ע
בלױען	ב ל ױ ע ן
בלײכע	ב ל ײ כ ע
בלײַבט	ב ל ײַ ב ט
בלײַבן	ב ל ײַ ב ן
בלאַט	ב ל אַ ט
בלאַנקט	ב ל אַ נ ק ט
בלאַס	ב ל אַ ס
בלאַסער	ב ל אַ ס ע ר
בלאָז	ב ל אָ ז
בלאָזט	ב ל אָ ז ט
בלאָזן	ב ל אָ ז ן
בלאָטע	ב ל אָ ט ע
בלאָטעס	ב ל אָ ט ע ס
בלאָטער	ב ל אָ ט ע ר
בלאָנדזשע	ב ל אָ נ ד ז ש ע
בלאָנדזשען	ב ל אָ נ ד ז ש ע ן
במנוחה	ב מ נ ו ח ה
במצװת	ב מ צ װ ת
בן	ב ן
בן־ציון	ב ן ־ צ י ו ן
בן־תּורה	ב ן ־ תּ ו ר ה
בני	ב נ י
בני־בית	ב נ י ־ ב י ת
בני־ביתן	ב נ י ־ ב י ת ן
בעדער	ב ע ד ע ר
בעזעם	ב ע ז ע ם
בעזעמס	ב ע ז ע מ ס
בעט	ב ע ט
בעטגעװאַנט	ב ע ט ג ע װ אַ נ ט
בעטלברױט	ב ע ט ל ב ר ױ ט
בעטלען	ב ע ט ל ע ן
בעטלער	ב ע ט ל ע ר
בעטן	ב ע ט ן
בעך	ב ע ך
בעכטעװ	ב ע כ ט ע װ
בעכטעװער	ב ע כ ט ע װ ע ר
בעל	ב ע ל
בעל־דקדוק	ב ע ל ־ ד ק ד ו ק
בעל־דרשער	ב ע ל ־ ד ר ש ע ר
בעל־הבית	ב ע ל ־ ה ב י ת
בעל־הבתּישקײט	ב ע ל ־ ה ב תּ י ש ק ײ ט
בעל־הנס	ב ע ל ־ ה נ ס
בעל־חובֿ	ב ע ל ־ ח ו בֿ
בעל־חשבֿון	ב ע ל ־ ח ש בֿ ו ן
בעל־לשון־קודש	ב ע ל ־ ל ש ו ן ־ ק ו ד ש
בעל־מלאכה	ב ע ל ־ מ ל א כ ה
בעל־מלאכות	ב ע ל ־ מ ל א כ ו ת
בעל־מלאָכות	ב ע ל ־ מ ל אָ כ ו ת
בעל־משגיח	ב ע ל ־ מ ש ג י ח
בעל־עגלה	ב ע ל ־ ע ג ל ה
בעל־עבֿירהניק	ב ע ל ־ ע בֿ י ר ה נ י ק
בעל־צדקה	ב ע ל ־ צ ד ק ה
בעל־שם	ב ע ל ־ ש ם
בעל־כּרחך	ב ע ל ־ כּ ר ח ך
בעל־פּרנסה	ב ע ל ־ פּ ר נ ס ה
בעל־תּאװה	ב ע ל ־ תּ א װ ה
בעל־תּאװת	ב ע ל ־ תּ א װ ת
בעל־תּנך	ב ע ל ־ תּ נ ך
בעלי־בתּים	ב ע ל י ־ ב תּ י ם
בעלי־הבתּים	ב ע ל י ־ ה ב תּ י ם
בעלי־חײם	ב ע ל י ־ ח ײ ם
בעלי־עגלות	ב ע ל י ־ ע ג ל ו ת
בעלי־עבֿירות	ב ע ל י ־ ע בֿ י ר ו ת
בעלמע	ב ע ל מ ע
בעלן	ב ע ל ן
בעלנים	ב ע ל נ י ם
בעלקעס	ב ע ל ק ע ס
בעלקעסן	ב ע ל ק ע ס ן
בעלת־צדקה	ב ע ל ת ־ צ ד ק ה
בענטשליכט	ב ע נ ט ש ל י כ ט
בעניע	ב ע נ י ע
בענצן	ב ע נ צ ן
בענצע	ב ע נ צ ע
בענצען	ב ע נ צ ע ן
בענצעס	ב ע נ צ ע ס
בענק	ב ע נ ק
בענקט	ב ע נ ק ט
בענקל	ב ע נ ק ל
בענקעלע	ב ע נ ק ע ל ע
בענקעניש	ב ע נ ק ע נ י ש
בעסטן	ב ע ס ט ן
בעסטע	ב ע ס ט ע
בעסער	ב ע ס ע ר
בעסער־ערגער	ב ע ס ע ר ־ ע ר ג ע ר
בעסערער	ב ע ס ע ר ע ר
בעקלעך	ב ע ק ל ע ך
בער	ב ע ר
בערגל	ב ע ר ג ל
בערגלעך	ב ע ר ג ל ע ך
בערגעלסאָן	ב ע ר ג ע ל ס אָ ן
בערד	ב ע ר ד
בערדל	ב ע ר ד ל
בעריש	ב ע ר י ש
בערישעס	ב ע ר י ש ע ס
בערל	ב ע ר ל
בערן	ב ע ר ן
בערעלע	ב ע ר ע ל ע
בעת	ב ע ת
בצבור	ב צ ב ו ר
בקיאות	ב ק י א ו ת
בקשה	ב ק ש ה
בקבֿלה	ב ק בֿ ל ה
בראשית	ב ר א ש י ת
ברוגז	ב ר ו ג ז
ברוגז־טאַנץ	ב ר ו ג ז ־ ט אַ נ ץ
ברודיקע	ב ר ו ד י ק ע
ברודער	ב ר ו ד ע ר
ברוך	ב ר ו ך
ברוך־הבא	ב ר ו ך ־ ה ב א
ברוך־הוא	ב ר ו ך ־ ה ו א
ברוך־השם	ב ר ו ך ־ ה ש ם
ברונעם	ב ר ו נ ע ם
ברוסט	ב ר ו ס ט
ברוק	ב ר ו ק
ברוקלין	ב ר ו ק ל י ן
ברוקלינער	ב ר ו ק ל י נ ע ר
בריאה	ב ר י א ה
ברידזש	ב ר י ד ז ש
ברידער	ב ר י ד ע ר
בריה	ב ר י ה
בריליאַנטן	ב ר י ל י אַ נ ט ן
בריליאַנטענע	ב ר י ל י אַ נ ט ע נ ע
ברילן	ב ר י ל ן
ברירה	ב ר י ר ה
ברית	ב ר י ת
בריתן	ב ר י ת ן
בריװ	ב ר י װ
בריװל	ב ר י װ ל
בריװלעך	ב ר י װ ל ע ך
בריװנשטעלערס	ב ר י װ נ ש ט ע ל ע ר ס
בריװעלע	ב ר י װ ע ל ע
ברכה	ב ר כ ה
ברכות	ב ר כ ו ת
ברעטער	ב ר ע ט ע ר
ברעכן	ב ר ע כ ן
ברענגט	ב ר ע נ ג ט
ברענגען	ב ר ע נ ג ע ן
ברענט	ב ר ע נ ט
ברענען	ב ר ע נ ע ן
ברענענדיקע	ב ר ע נ ע נ ד י ק ע
ברעקל	ב ר ע ק ל
ברױט	ב ר ױ ט
ברױך	ב ר ױ ך
ברױן־און־בלאָ	ב ר ױ ן ־ א ו ן ־ ב ל אָ
ברײט	ב ר ײ ט
ברײטן	ב ר ײ ט ן
ברײטע	ב ר ײ ט ע
ברײטער	ב ר ײ ט ע ר
ברײצטע	ב ר ײ צ ט ע
ברײַען	ב ר ײַ ע ן
בראָט	ב ר אָ ט
בראָטן	ב ר אָ ט ן
בראָך	ב ר אָ ך
בראָנזענע	ב ר אָ נ ז ע נ ע
בראָנפֿן	ב ר אָ נ פֿ ן
בראָקעניו	ב ר אָ ק ע נ י ו
בשום	ב ש ו ם
בשלום	ב ש ל ו ם
בשעת	ב ש ע ת
בשעת־הדחק	ב ש ע ת ־ ה ד ח ק
בשעת־מעשׂה	ב ש ע ת ־ מ ע שׂ ה
בשעתן	ב ש ע ת ן
בת	ב ת
בת־יחידה	ב ת ־ י ח י ד ה
בװדאי	ב װ ד א י
בױבעריק	ב ױ ב ע ר י ק
בױג	ב ױ ג
בױגן	ב ױ ג ן
בױגעלע	ב ױ ג ע ל ע
בױגעװדיק	ב ױ ג ע װ ד י ק
בױד	ב ױ ד
בױדעם	ב ױ ד ע ם
בױך	ב ױ ך
בױם	ב ױ ם
בױמל	ב ױ מ ל
בױמער	ב ױ מ ע ר
בױען	ב ױ ע ן
בױרן	ב ױ ר ן
בײגט	ב ײ ג ט
בײדן	ב ײ ד ן
בײדע	ב ײ ד ע
בײז	ב ײ ז
בײז־װוּנדער	ב ײ ז ־ װ וּ נ ד ע ר
בײזן	ב ײ ז ן
בײזע	ב ײ ז ע
בײזערט	ב ײ ז ע ר ט
בײלע־יענטע	ב ײ ל ע ־ י ע נ ט ע
בײם	ב ײ ם
בײמל	ב ײ מ ל
בײמער	ב ײ מ ע ר
בײנדל	ב ײ נ ד ל
בײנער	ב ײ נ ע ר
בײַ	ב ײַ
בײַגעטראָגן	ב ײַ ג ע ט ר אָ ג ן
בײַדל	ב ײַ ד ל
בײַטלע	ב ײַ ט ל ע
בײַטש	ב ײַ ט ש
בײַטשל	ב ײַ ט ש ל
בײַטאָג	ב ײַ ט אָ ג
בײַל	ב ײַ ל
בײַם	ב ײַ ם
בײַסן	ב ײַ ס ן
בײַסעניש	ב ײַ ס ע נ י ש
בײַשפּיל	ב ײַ ש פּ י ל
בשׂורה	ב שׂ ו ר ה
בשׂימחה	ב שׂ י מ ח ה
בשׂר	ב שׂ ר
באַגליקן	ב אַ ג ל י ק ן
באַגלײט	ב אַ ג ל ײ ט
באַגלײַט	ב אַ ג ל ײַ ט
באַגעגנט	ב אַ ג ע ג נ ט
באַגעגעניש	ב אַ ג ע ג ע נ י ש
באַגעגענישן	ב אַ ג ע ג ע נ י ש ן
באַגערט	ב אַ ג ע ר ט
באַגראָבן	ב אַ ג ר אָ ב ן
באַגײן	ב אַ ג ײ ן
באַגײַסטערט	ב אַ ג ײַ ס ט ע ר ט
באַגײַװערטע	ב אַ ג ײַ װ ע ר ט ע
באַגאָסן	ב אַ ג אָ ס ן
באַדענקט	ב אַ ד ע נ ק ט
באַדעקט	ב אַ ד ע ק ט
באַדעקנס	ב אַ ד ע ק נ ס
באַדאַרף	ב אַ ד אַ ר ף
באַדאַרפֿט	ב אַ ד אַ ר פֿ ט
באַדאַרפֿן	ב אַ ד אַ ר פֿ ן
באַהיט	ב אַ ה י ט
באַהאַלט	ב אַ ה אַ ל ט
באַהאַלטן	ב אַ ה אַ ל ט ן
באַהאַלטענע	ב אַ ה אַ ל ט ע נ ע
באַהאַנגן	ב אַ ה אַ נ ג ן
באַזוכן	ב אַ ז ו כ ן
באַזונדער	ב אַ ז ו נ ד ע ר
באַזונדערע	ב אַ ז ו נ ד ע ר ע
באַזונדערער	ב אַ ז ו נ ד ע ר ע ר
באַזעצט	ב אַ ז ע צ ט
באַזאָרגן	ב אַ ז אָ ר ג ן
באַטראַכט	ב אַ ט ר אַ כ ט
באַטאַפּן	ב אַ ט אַ פּ ן
באַל	ב אַ ל
באַלד	ב אַ ל ד
באַלוט	ב אַ ל ו ט
באַלמעלאָכעס	ב אַ ל מ ע ל אָ כ ע ס
באַלעבאַטים	ב אַ ל ע ב אַ ט י ם
באַלעבאָס	ב אַ ל ע ב אָ ס
באַלערנדיק	ב אַ ל ע ר נ ד י ק
באַלקן	ב אַ ל ק ן
באַלױכטן	ב אַ ל ױ כ ט ן
באַלײדיקט	ב אַ ל ײ ד י ק ט
באַלאַדע	ב אַ ל אַ ד ע
באַמיען	ב אַ מ י ע ן
באַמערק	ב אַ מ ע ר ק
באַמערקונגען	ב אַ מ ע ר ק ו נ ג ע ן
באַמערקט	ב אַ מ ע ר ק ט
באַמערקען	ב אַ מ ע ר ק ע ן
באַן	ב אַ ן
באַנד	ב אַ נ ד
באַנוצט	ב אַ נ ו צ ט
באַנוצן	ב אַ נ ו צ ן
באַניע	ב אַ נ י ע
באַנק	ב אַ נ ק
באַנקעס	ב אַ נ ק ע ס
באַנקראָטירט	ב אַ נ ק ר אָ ט י ר ט
באַנײט	ב אַ נ ײ ט
באַנאַנד	ב אַ נ אַ נ ד
באַציט	ב אַ צ י ט
באַצאָלט	ב אַ צ אָ ל ט
באַצאָלן	ב אַ צ אָ ל ן
באַקומט	ב אַ ק ו מ ט
באַקומען	ב אַ ק ו מ ע ן
באַקומענדיק	ב אַ ק ו מ ע נ ד י ק
באַקוקט	ב אַ ק ו ק ט
באַקלאָגן	ב אַ ק ל אָ ג ן
באַקן	ב אַ ק ן
באַקענט	ב אַ ק ע נ ט
באַקאַנט	ב אַ ק אַ נ ט
באַקאַנטן	ב אַ ק אַ נ ט ן
באַקאַנטע	ב אַ ק אַ נ ט ע
באַקאַנטער	ב אַ ק אַ נ ט ע ר
באַר־מיצװה	ב אַ ר ־ מ י צ װ ה
באַרג	ב אַ ר ג
באַרג־אַרױף	ב אַ ר ג ־ אַ ר ױ ף
באַרג־אַראָפּ	ב אַ ר ג ־ אַ ר אָ פּ
באַרימט	ב אַ ר י מ ט
באַרימטע	ב אַ ר י מ ט ע
באַרימטער	ב אַ ר י מ ט ע ר
באַרימען	ב אַ ר י מ ע ן
באַרעדט	ב אַ ר ע ד ט
באַרעדעװדיק	ב אַ ר ע ד ע װ ד י ק
באַרעכנט	ב אַ ר ע כ נ ט
באַשולדיקונג	ב אַ ש ו ל ד י ק ו נ ג
באַשטעלט	ב אַ ש ט ע ל ט
באַשטײן	ב אַ ש ט ײ ן
באַשיצט	ב אַ ש י צ ט
באַשלאָגן	ב אַ ש ל אָ ג ן
באַשלאָסן	ב אַ ש ל אָ ס ן
באַשמעקן	ב אַ ש מ ע ק ן
באַשערט	ב אַ ש ע ר ט
באַשעפֿעניש	ב אַ ש ע פֿ ע נ י ש
באַשעפֿער	ב אַ ש ע פֿ ע ר
באַשר	ב אַ ש ר
באַשריבן	ב אַ ש ר י ב ן
באַשײַמפּערלעך	ב אַ ש ײַ מ פּ ע ר ל ע ך
באַשאַפֿן	ב אַ ש אַ פֿ ן
באַשפּיגן	ב אַ ש פּ י ג ן
באַשפּריצט	ב אַ ש פּ ר י צ ט
באַװיזן	ב אַ װ י ז ן
באַװײַז	ב אַ װ ײַ ז
באַװײַזט	ב אַ װ ײַ ז ט
באַװײַזן	ב אַ װ ײַ ז ן
באַװאַסערט	ב אַ װ אַ ס ע ר ט
באַװאַקסענע	ב אַ װ אַ ק ס ע נ ע
באַװאָרנט	ב אַ װ אָ ר נ ט
באַװוּסטן	ב אַ װ וּ ס ט ן
באַפֿעל	ב אַ פֿ ע ל
באַפֿעסטיקט	ב אַ פֿ ע ס ט י ק ט
באַפֿרײַנדעט	ב אַ פֿ ר ײַ נ ד ע ט
באַפֿױלן	ב אַ פֿ ױ ל ן
באַפֿאַלן	ב אַ פֿ אַ ל ן
באָבע	ב אָ ב ע
באָדט	ב אָ ד ט
באָדנדיק	ב אָ ד נ ד י ק
באָלאַן	ב אָ ל אַ ן
באָנטשע	ב אָ נ ט ש ע
באָנטשען	ב אָ נ ט ש ע ן
באָנטשעס	ב אָ נ ט ש ע ס
באָרד	ב אָ ר ד
באָרשט	ב אָ ר ש ט
באָרװעס	ב אָ ר װ ע ס
באָרװעסע	ב אָ ר װ ע ס ע
בכּוח	ב כּ ו ח
בכּל	ב כּ ל
בכּבֿודיקע	ב כּ בֿ ו ד י ק ע
בכּבֿודיקערע	ב כּ בֿ ו ד י ק ע ר ע
בפּתח	ב פּ ת ח
בתּורה	ב תּ ו ר ה
בתּי־מדרשים	ב תּ י ־ מ ד ר ש י ם
בפֿירוש	ב פֿ י ר ו ש
בפֿירושע	ב פֿ י ר ו ש ע
בפֿרט	ב פֿ ר ט
ג'	ג '
גאון	ג א ו ן
גאונים	ג א ו נ י ם
גבאי	ג ב א י
גבאים	ג ב א י ם
גביר	ג ב י ר
גבירים	ג ב י ר י ם
גדול	ג ד ו ל
גדולה	ג ד ו ל ה
גדלות	ג ד ל ו ת
גדלע	ג ד ל ע
גובערנאַטאָר	ג ו ב ע ר נ אַ ט אָ ר
גוזמא	ג ו ז מ א
גוט	ג ו ט
גוט־גוט	ג ו ט ־ ג ו ט
גוט־יום־טובֿ	ג ו ט ־ י ו ם ־ ט ו בֿ
גוט־שלעכט	ג ו ט ־ ש ל ע כ ט
גוטן	ג ו ט ן
גוטס	ג ו ט ס
גוטע	ג ו ט ע
גוטער	ג ו ט ע ר
גולם	ג ו ל ם
גומענע	ג ו מ ע נ ע
גוססן	ג ו ס ס ן
גוף	ג ו ף
גוצקײט	ג ו צ ק ײ ט
גור	ג ו ר
גופֿא	ג ו פֿ א
גזלנים	ג ז ל נ י ם
גזר־דין	ג ז ר ־ ד י ן
גטן	ג ט ן
גיב	ג י ב
גיבורים	ג י ב ו ר י ם
גיבן	ג י ב ן
גיהנום	ג י ה נ ו ם
גיהנם	ג י ה נ ם
גיט	ג י ט
גיטל	ג י ט ל
גיטער	ג י ט ע ר
גיך	ג י ך
גיכער	ג י כ ע ר
גיכקײט	ג י כ ק ײ ט
גילגול	ג י ל ג ו ל
גילגולים	ג י ל ג ו ל י ם
גילדן	ג י ל ד ן
גילדױנים	ג י ל ד ױ נ י ם
גימנאַזיסט	ג י מ נ אַ ז י ס ט
גינגאָלדענע	ג י נ ג אָ ל ד ע נ ע
גינט	ג י נ ט
גיסט	ג י ס ט
גלוסט	ג ל ו ס ט
גלוסטן	ג ל ו ס ט ן
גלות	ג ל ו ת
גלות־געצי	ג ל ו ת ־ ג ע צ י
גלופּסק	ג ל ו פּ ס ק
גלופּסקער	ג ל ו פּ ס ק ע ר
גליד	ג ל י ד
גליד־גליד־געשװעסטערקינד	ג ל י ד ־ ג ל י ד ־ ג ע ש װ ע ס ט ע ר ק י נ ד
גליטשט	ג ל י ט ש ט
גליטשיקע	ג ל י ט ש י ק ע
גליק	ג ל י ק
גליקלעך	ג ל י ק ל ע ך
גליקלעכן	ג ל י ק ל ע כ ן
גליקלעכער	ג ל י ק ל ע כ ע ר
גלעזל	ג ל ע ז ל
גלעזלעך	ג ל ע ז ל ע ך
גלעזעלע	ג ל ע ז ע ל ע
גלעזער	ג ל ע ז ע ר
גלעזערנע	ג ל ע ז ע ר נ ע
גלעקלעך	ג ל ע ק ל ע ך
גלױבט	ג ל ױ ב ט
גלױבן	ג ל ױ ב ן
גלײבן	ג ל ײ ב ן
גלײַך	ג ל ײַ ך
גלײַכט	ג ל ײַ כ ט
גלײַכן	ג ל ײַ כ ן
גלײַכע	ג ל ײַ כ ע
גלײַכער	ג ל ײַ כ ע ר
גלאַט	ג ל אַ ט
גלאַטיק	ג ל אַ ט י ק
גלאַנץ	ג ל אַ נ ץ
גלאַנצנדיק־רױטלעך	ג ל אַ נ צ נ ד י ק ־ ר ױ ט ל ע ך
גלאָז	ג ל אָ ז
גלאָצט	ג ל אָ צ ט
גלאָק	ג ל אָ ק
גלאָקע	ג ל אָ ק ע
גמור	ג מ ו ר
גמילת־חסדים	ג מ י ל ת ־ ח ס ד י ם
גמרא	ג מ ר א
גמרא־מלמד	ג מ ר א ־ מ ל מ ד
גמרה	ג מ ר ה
גן־עדן	ג ן ־ ע ד ן
גןעדן	ג ן ע ד ן
גנב	ג נ ב
גניבֿה	ג נ י בֿ ה
גנבֿ	ג נ בֿ
גנבֿה	ג נ בֿ ה
גנבֿהט	ג נ בֿ ה ט
גנבֿהנען	ג נ בֿ ה נ ע ן
גנבֿות	ג נ בֿ ו ת
גנבֿים	ג נ בֿ י ם
גנבֿעט	ג נ בֿ ע ט
געב־אָפּ	ג ע ב ־ אָ פּ
געבונדן	ג ע ב ו נ ד ן
געבילדעט	ג ע ב י ל ד ע ט
געבליבן	ג ע ב ל י ב ן
געבליט	ג ע ב ל י ט
געבליצט	ג ע ב ל י צ ט
געבלאָזן	ג ע ב ל אָ ז ן
געבן	ג ע ב ן
געבעט	ג ע ב ע ט
געבעטלט	ג ע ב ע ט ל ט
געבעטן	ג ע ב ע ט ן
געבענקט	ג ע ב ע נ ק ט
געבעק	ג ע ב ע ק
געבריהט	ג ע ב ר י ה ט
געברענגט	ג ע ב ר ע נ ג ט
געברענט	ג ע ב ר ע נ ט
געבראַכט	ג ע ב ר אַ כ ט
געבראָטענע	ג ע ב ר אָ ט ע נ ע
געבראָכן	ג ע ב ר אָ כ ן
געבױגן	ג ע ב ױ ג ן
געבױרן	ג ע ב ױ ר ן
געבױרענער	ג ע ב ױ ר ע נ ע ר
געבאַקענעם	ג ע ב אַ ק ע נ ע ם
געבאָטן	ג ע ב אָ ט ן
געבאָרן	ג ע ב אָ ר ן
געגט	ג ע ג ט
געגליכן	ג ע ג ל י כ ן
געגלױבט	ג ע ג ל ױ ב ט
געגלײבט	ג ע ג ל ײ ב ט
געגנט	ג ע ג נ ט
געגנבֿעט	ג ע ג נ בֿ ע ט
געגעבן	ג ע ג ע ב ן
געגעסן	ג ע ג ע ס ן
געגרײט	ג ע ג ר ײ ט
געגרײַזלט	ג ע ג ר ײַ ז ל ט
געגאַנגען	ג ע ג אַ נ ג ע ן
געדולד	ג ע ד ו ל ד
געדונגען	ג ע ד ו נ ג ע ן
געדיכט	ג ע ד י כ ט
געדיכטע	ג ע ד י כ ט ע
געדינט	ג ע ד י נ ט
געדענק	ג ע ד ע נ ק
געדענקט	ג ע ד ע נ ק ט
געדענקט־זשע	ג ע ד ע נ ק ט ־ ז ש ע
געדענקן	ג ע ד ע נ ק ן
געדענקסט	ג ע ד ע נ ק ס ט
געדענקען	ג ע ד ע נ ק ע ן
געדערים	ג ע ד ע ר י ם
געדרונגען	ג ע ד ר ו נ ג ע ן
געדרוקט	ג ע ד ר ו ק ט
געדרימלט	ג ע ד ר י מ ל ט
געדרײט	ג ע ד ר ײ ט
געדראַפּעט	ג ע ד ר אַ פּ ע ט
געדױזשעט	ג ע ד ױ ז ש ע ט
געדױערט	ג ע ד ױ ע ר ט
געדאַכט	ג ע ד אַ כ ט
געדאַנקט	ג ע ד אַ נ ק ט
געדאַרפֿט	ג ע ד אַ ר פֿ ט
געדאַװנט	ג ע ד אַ װ נ ט
געהונקען	ג ע ה ו נ ק ע ן
געהילץ	ג ע ה י ל ץ
געהיצט	ג ע ה י צ ט
געהעצט	ג ע ה ע צ ט
געהער	ג ע ה ע ר
געהערט	ג ע ה ע ר ט
געהעריק	ג ע ה ע ר י ק
געהעריקע	ג ע ה ע ר י ק ע
געהױבענע	ג ע ה ױ ב ע נ ע
געהײמע	ג ע ה ײ מ ע
געהײסן	ג ע ה ײ ס ן
געהײצט	ג ע ה ײ צ ט
געהאַט	ג ע ה אַ ט
געהאַלטן	ג ע ה אַ ל ט ן
געהאַלטען	ג ע ה אַ ל ט ע ן
געהאַנגען	ג ע ה אַ נ ג ע ן
געהאַנדלט	ג ע ה אַ נ ד ל ט
געהאַקט	ג ע ה אַ ק ט
געהאַרט	ג ע ה אַ ר ט
געהאָדעװעט	ג ע ה אָ ד ע װ ע ט
געהאָדעװעטע	ג ע ה אָ ד ע װ ע ט ע
געהאָלפֿן	ג ע ה אָ ל פֿ ן
געהאָקטן	ג ע ה אָ ק ט ן
געהאָרכט	ג ע ה אָ ר כ ט
געזוכט	ג ע ז ו כ ט
געזונגן	ג ע ז ו נ ג ן
געזונגען	ג ע ז ו נ ג ע ן
געזונט	ג ע ז ו נ ט
געזונטע	ג ע ז ו נ ט ע
געזונטער	ג ע ז ו נ ט ע ר
געזונטערהײט	ג ע ז ו נ ט ע ר ה ײ ט
געזונקען	ג ע ז ו נ ק ע ן
געזידלט	ג ע ז י ד ל ט
געזינדל	ג ע ז י נ ד ל
געזעלן	ג ע ז ע ל ן
געזען	ג ע ז ע ן
געזעסן	ג ע ז ע ס ן
געזעצט	ג ע ז ע צ ט
געזעצטער	ג ע ז ע צ ט ע ר
געזעצע	ג ע ז ע צ ע
געזשומעט	ג ע ז ש ו מ ע ט
געזשאַלעװעט	ג ע ז ש אַ ל ע װ ע ט
געזאַמלט	ג ע ז אַ מ ל ט
געזאַנג	ג ע ז אַ נ ג
געזאַנגען	ג ע ז אַ נ ג ע ן
געזאָגט	ג ע ז אָ ג ט
געזאָלט	ג ע ז אָ ל ט
געזאָרגט	ג ע ז אָ ר ג ט
געחוזקט	ג ע ח ו ז ק ט
געחזרט	ג ע ח ז ר ט
געחלומט	ג ע ח ל ו מ ט
געחלשט	ג ע ח ל ש ט
געחתמעט	ג ע ח ת מ ע ט
געטונקלט	ג ע ט ו נ ק ל ט
געטלעכער	ג ע ט ל ע כ ע ר
געטענהט	ג ע ט ע נ ה ט
געטרונקען	ג ע ט ר ו נ ק ע ן
געטריבן	ג ע ט ר י ב ן
געטרױ	ג ע ט ר ױ
געטרױסט	ג ע ט ר ױ ס ט
געטרױערט	ג ע ט ר ױ ע ר ט
געטרײסט	ג ע ט ר ײ ס ט
געטרײַ	ג ע ט ר ײַ
געטראַכט	ג ע ט ר אַ כ ט
געטראָגן	ג ע ט ר אָ ג ן
געטראָפֿן	ג ע ט ר אָ פֿ ן
געטשעפּעט	ג ע ט ש ע פּ ע ט
געטױגט	ג ע ט ױ ג ט
געטױט	ג ע ט ױ ט
געטאַנצט	ג ע ט אַ נ צ ט
געטאָגט	ג ע ט אָ ג ט
געטאָן	ג ע ט אָ ן
געירשנט	ג ע י ר ש נ ט
געיאַדעט	ג ע י אַ ד ע ט
געיאָגט	ג ע י אָ ג ט
געיאָמער	ג ע י אָ מ ע ר
געכאַפּט	ג ע כ אַ פּ ט
געכאָרכלט	ג ע כ אָ ר כ ל ט
געל	ג ע ל
געלד	ג ע ל ד
געלונגען	ג ע ל ו נ ג ע ן
געלזוכט	ג ע ל ז ו כ ט
געלט	ג ע ל ט
געליטן	ג ע ל י ט ן
געלן	ג ע ל ן
געלע	ג ע ל ע
געלעבט	ג ע ל ע ב ט
געלעגן	ג ע ל ע ג ן
געלעגנהײט	ג ע ל ע ג נ ה ײ ט
געלעגער	ג ע ל ע ג ע ר
געלעזן	ג ע ל ע ז ן
געלעכטער	ג ע ל ע כ ט ע ר
געלעקט	ג ע ל ע ק ט
געלער	ג ע ל ע ר
געלערט	ג ע ל ע ר ט
געלערנט	ג ע ל ע ר נ ט
געלױבט	ג ע ל ױ ב ט
געלױכטן	ג ע ל ױ כ ט ן
געלײגט	ג ע ל ײ ג ט
געלײזט	ג ע ל ײ ז ט
געלײמט	ג ע ל ײ מ ט
געלײענט	ג ע ל ײ ע נ ט
געלאַטעט	ג ע ל אַ ט ע ט
געלאַכט	ג ע ל אַ כ ט
געלאָזט	ג ע ל אָ ז ט
געלאָפֿן	ג ע ל אָ פֿ ן
געמוסרט	ג ע מ ו ס ר ט
געמורמלט	ג ע מ ו ר מ ל ט
געמזענע	ג ע מ ז ע נ ע
געמיש	ג ע מ י ש
געמישפּט	ג ע מ י ש פּ ט
געמלט	ג ע מ ל ט
געמעגט	ג ע מ ע ג ט
געמעקעט	ג ע מ ע ק ע ט
געמערט	ג ע מ ע ר ט
געמרוקעט	ג ע מ ר ו ק ע ט
געמײזעכץ	ג ע מ ײ ז ע כ ץ
געמײנט	ג ע מ ײ נ ט
געמאַך	ג ע מ אַ ך
געמאַכט	ג ע מ אַ כ ט
געמאַכטע	ג ע מ אַ כ ט ע
געמאָלט	ג ע מ אָ ל ט
געמאָלן	ג ע מ אָ ל ן
געמאָנט	ג ע מ אָ נ ט
גענדז	ג ע נ ד ז
גענדזן־שמאַלץ	ג ע נ ד ז ן ־ ש מ אַ ל ץ
גענוג	ג ע נ ו ג
גענוגיקע	ג ע נ ו ג י ק ע
גענומען	ג ע נ ו מ ע ן
געניטער	ג ע נ י ט ע ר
גענעכטיקט	ג ע נ ע כ ט י ק ט
גענעץ	ג ע נ ע ץ
גענעראַל	ג ע נ ע ר אַ ל
גענעראַלן	ג ע נ ע ר אַ ל ן
גענױ	ג ע נ ױ
גענײט	ג ע נ ײ ט
גענאָסן	ג ע נ אָ ס ן
גענאָװעפֿאַ	ג ע נ אָ װ ע פֿ אַ
געסט	ג ע ס ט
געסטרעכירט	ג ע ס ט ר ע כ י ר ט
געסטראַשעט	ג ע ס ט ר אַ ש ע ט
געסל	ג ע ס ל
געסלעך	ג ע ס ל ע ך
געענדיקט	ג ע ע נ ד י ק ט
געענטפֿערט	ג ע ע נ ט פֿ ע ר ט
געעפֿנט	ג ע ע פֿ נ ט
געצוקערטע	ג ע צ ו ק ע ר ט ע
געצי	ג ע צ י
געצי'ן	ג ע צ י ' ן
געצי־גובערנאַטאָר	ג ע צ י ־ ג ו ב ע ר נ אַ ט אָ ר
געציטערט	ג ע צ י ט ע ר ט
געצין	ג ע צ י ן
געציס	ג ע צ י ס
געציקלטער	ג ע צ י ק ל ט ע ר
געצל	ג ע צ ל
געצױגן	ג ע צ ױ ג ן
געצאַנקט	ג ע צ אַ נ ק ט
געצאַצקעט	ג ע צ אַ צ ק ע ט
געצאָלט	ג ע צ אָ ל ט
געקומען	ג ע ק ו מ ע ן
געקוקט	ג ע ק ו ק ט
געקלונגען	ג ע ק ל ו נ ג ע ן
געקליבן	ג ע ק ל י ב ן
געקליבענע	ג ע ק ל י ב ע נ ע
געקלױבן	ג ע ק ל ױ ב ן
געקלײדט	ג ע ק ל ײ ד ט
געקלאָגט	ג ע ק ל אָ ג ט
געקניפּט	ג ע ק נ י פּ ט
געקנעלט	ג ע ק נ ע ל ט
געקנאַלט	ג ע ק נ אַ ל ט
געקנאַקט	ג ע ק נ אַ ק ט
געקענט	ג ע ק ע נ ט
געקעניגט	ג ע ק ע נ י ג ט
געקריגן	ג ע ק ר י ג ן
געקריצט	ג ע ק ר י צ ט
געקרעכצט	ג ע ק ר ע כ צ ט
געקרײעט	ג ע ק ר ײ ע ט
געקראָגן	ג ע ק ר אָ ג ן
געקראָכן	ג ע ק ר אָ כ ן
געקװעטשט	ג ע ק װ ע ט ש ט
געקװעלט	ג ע ק װ ע ל ט
געקױלעטע	ג ע ק ױ ל ע ט ע
געקױפֿט	ג ע ק ױ פֿ ט
געקאַטשעט	ג ע ק אַ ט ש ע ט
געקאָכט	ג ע ק אָ כ ט
געקאָנט	ג ע ק אָ נ ט
געקאָסט	ג ע ק אָ ס ט
גערגעלעך	ג ע ר ג ע ל ע ך
גערודער	ג ע ר ו ד ע ר
גערונצלט	ג ע ר ו נ צ ל ט
גערוקט	ג ע ר ו ק ט
גערופֿן	ג ע ר ו פֿ ן
גערטנער	ג ע ר ט נ ע ר
געריבן	ג ע ר י ב ן
גערידער	ג ע ר י ד ע ר
געריכט	ג ע ר י כ ט
געריסן	ג ע ר י ס ן
גערן	ג ע ר ן
גערעדט	ג ע ר ע ד ט
גערעכט	ג ע ר ע כ ט
גערעכטיקײט	ג ע ר ע כ ט י ק ײ ט
גערעכנט	ג ע ר ע כ נ ט
גערעכערט	ג ע ר ע כ ע ר ט
גערעשט	ג ע ר ע ש ט
גערױש	ג ע ר ױ ש
גערײד	ג ע ר ײ ד
גערײכערט	ג ע ר ײ כ ע ר ט
געראַטעװעט	ג ע ר אַ ט ע װ ע ט
געראַטעװעטער	ג ע ר אַ ט ע װ ע ט ע ר
געראָט	ג ע ר אָ ט
געראָטן	ג ע ר אָ ט ן
געראָטענע	ג ע ר אָ ט ע נ ע
געראָטענער	ג ע ר אָ ט ע נ ע ר
געראָי	ג ע ר אָ י
געשטופּלטער	ג ע ש ט ו פּ ל ט ע ר
געשטיקט	ג ע ש ט י ק ט
געשטעל	ג ע ש ט ע ל
געשטעלט	ג ע ש ט ע ל ט
געשטרױכלט	ג ע ש ט ר ױ כ ל ט
געשטראָפֿט	ג ע ש ט ר אָ פֿ ט
געשטױגן	ג ע ש ט ױ ג ן
געשטױנט	ג ע ש ט ױ נ ט
געשטאַלט	ג ע ש ט אַ ל ט
געשטאַלטן	ג ע ש ט אַ ל ט ן
געשטאַמט	ג ע ש ט אַ מ ט
געשטאַנען	ג ע ש ט אַ נ ע ן
געשטאָכן	ג ע ש ט אָ כ ן
געשטאָרבן	ג ע ש ט אָ ר ב ן
געשטאָרבענע	ג ע ש ט אָ ר ב ע נ ע
געשיכטע	ג ע ש י כ ט ע
געשילדערט	ג ע ש י ל ד ע ר ט
געשיקט	ג ע ש י ק ט
געשיפֿט	ג ע ש י פֿ ט
געשלעפּט	ג ע ש ל ע פּ ט
געשלאָגן	ג ע ש ל אָ ג ן
געשלאָגען	ג ע ש ל אָ ג ע ן
געשלאָפֿן	ג ע ש ל אָ פֿ ן
געשמועסט	ג ע ש מ ו ע ס ט
געשמיסן	ג ע ש מ י ס ן
געשמירט	ג ע ש מ י ר ט
געשמײכלט	ג ע ש מ ײ כ ל ט
געשמאַק	ג ע ש מ אַ ק
געשעמט	ג ע ש ע מ ט
געשען	ג ע ש ע ן
געשענקט	ג ע ש ע נ ק ט
געשענקטן	ג ע ש ע נ ק ט ן
געשעצטעס	ג ע ש ע צ ט ע ס
געשעפֿט	ג ע ש ע פֿ ט
געשעפֿטן	ג ע ש ע פֿ ט ן
געשריבן	ג ע ש ר י ב ן
געשריגן	ג ע ש ר י ג ן
געשרײ	ג ע ש ר ײ
געשװיגן	ג ע ש װ י ג ן
געשװילעכץ	ג ע ש װ י ל ע כ ץ
געשװינד	ג ע ש װ י נ ד
געשװינדלט	ג ע ש װ י נ ד ל ט
געשװעבט	ג ע ש װ ע ב ט
געשװױרן	ג ע ש װ ױ ר ן
געשװױרען	ג ע ש װ ױ ר ע ן
געשװױרענער	ג ע ש װ ױ ר ע נ ע ר
געשװאָרן	ג ע ש װ אָ ר ן
געשװאָרענע	ג ע ש װ אָ ר ע נ ע
געשװוּמען	ג ע ש װ וּ מ ע ן
געשױרענער	ג ע ש ױ ר ע נ ע ר
געשײדט	ג ע ש ײ ד ט
געשאַדט	ג ע ש אַ ד ט
געשאַט	ג ע ש אַ ט
געשאָטן	ג ע ש אָ ט ן
געשאָכטן	ג ע ש אָ כ ט ן
געשאָכטענע	ג ע ש אָ כ ט ע נ ע
געשאָלטן	ג ע ש אָ ל ט ן
געשאָסן	ג ע ש אָ ס ן
געשאָקלט	ג ע ש אָ ק ל ט
געשפּיצט	ג ע ש פּ י צ ט
געשפּירט	ג ע ש פּ י ר ט
געשפּאָרט	ג ע ש פּ אָ ר ט
געװיזן	ג ע װ י ז ן
געװיטער	ג ע װ י ט ע ר
געװינען	ג ע װ י נ ע ן
געװיס	ג ע װ י ס
געװיסן	ג ע װ י ס ן
געװיסער	ג ע װ י ס ע ר
געװיקלט	ג ע װ י ק ל ט
געװיר	ג ע װ י ר
געװיאַקעט	ג ע װ י אַ ק ע ט
געװעזן	ג ע װ ע ז ן
געװעלב	ג ע װ ע ל ב
געװעלבן	ג ע װ ע ל ב ן
געװעלטיקט	ג ע װ ע ל ט י ק ט
געװען	ג ע װ ע ן
געװענדט	ג ע װ ע נ ד ט
געװױנט	ג ע װ ױ נ ט
געװױר	ג ע װ ױ ר
געװײן	ג ע װ ײ ן
געװײנט	ג ע װ ײ נ ט
געװײנטלעך	ג ע װ ײ נ ט ל ע ך
געװײנלעך	ג ע װ ײ נ ל ע ך
געװאַלגערט	ג ע װ אַ ל ג ע ר ט
געװאַלד	ג ע װ אַ ל ד
געװאַלדן	ג ע װ אַ ל ד ן
געװאַנדלט	ג ע װ אַ נ ד ל ט
געװאַנדערט	ג ע װ אַ נ ד ע ר ט
געװאַנט־קרעמער	ג ע װ אַ נ ט ־ ק ר ע מ ע ר
געװאַקסן	ג ע װ אַ ק ס ן
געװאַרט	ג ע װ אַ ר ט
געװאַשן	ג ע װ אַ ש ן
געװאָלט	ג ע װ אָ ל ט
געװאָר	ג ע װ אָ ר
געװאָרגן	ג ע װ אָ ר ג ן
געװאָרטשעט	ג ע װ אָ ר ט ש ע ט
געװאָרן	ג ע װ אָ ר ן
געװאָרנט	ג ע װ אָ ר נ ט
געװאָרפֿן	ג ע װ אָ ר פֿ ן
געװוּסט	ג ע װ וּ ס ט
געאַכטעט	ג ע אַ כ ט ע ט
געאַנט	ג ע אַ נ ט
געאַרבעט	ג ע אַ ר ב ע ט
געאַרט	ג ע אַ ר ט
געפּגרט	ג ע פּ ג ר ט
געפּטרט	ג ע פּ ט ר ט
געפּלעפֿט	ג ע פּ ל ע פֿ ט
געפּלאַצט	ג ע פּ ל אַ צ ט
געפּלאַצטע	ג ע פּ ל אַ צ ט ע
געפּסקנט	ג ע פּ ס ק נ ט
געפּראַװעט	ג ע פּ ר אַ װ ע ט
געפּרוּװט	ג ע פּ ר וּ װ ט
געפּאַסט	ג ע פּ אַ ס ט
געפּאַקט	ג ע פּ אַ ק ט
געפּאַקטע	ג ע פּ אַ ק ט ע
געפֿונען	ג ע פֿ ו נ ע ן
געפֿידלט	ג ע פֿ י ד ל ט
געפֿיל	ג ע פֿ י ל
געפֿילט	ג ע פֿ י ל ט
געפֿין	ג ע פֿ י ן
געפֿינט	ג ע פֿ י נ ט
געפֿינען	ג ע פֿ י נ ע ן
געפֿירט	ג ע פֿ י ר ט
געפֿירטן	ג ע פֿ י ר ט ן
געפֿלױגן	ג ע פֿ ל ױ ג ן
געפֿלאַטערט	ג ע פֿ ל אַ ט ע ר ט
געפֿעלט	ג ע פֿ ע ל ט
געפֿעלן	ג ע פֿ ע ל ן
געפֿעס	ג ע פֿ ע ס
געפֿעפֿערטע	ג ע פֿ ע פֿ ע ר ט ע
געפֿרעגט	ג ע פֿ ר ע ג ט
געפֿרױרן	ג ע פֿ ר ױ ר ן
געפֿרײט	ג ע פֿ ר ײ ט
געפֿױלט	ג ע פֿ ױ ל ט
געפֿאַלן	ג ע פֿ אַ ל ן
געפֿאַלענעם	ג ע פֿ אַ ל ע נ ע ם
געפֿאַלענער	ג ע פֿ אַ ל ע נ ע ר
געפֿאַסט	ג ע פֿ אַ ס ט
געפֿאָרן	ג ע פֿ אָ ר ן
גרונט	ג ר ו נ ט
גרוש	ג ר ו ש
גריבל	ג ר י ב ל
גריבער	ג ר י ב ע ר
גריכנלאַנד	ג ר י כ נ ל אַ נ ד
גרימצאָרן	ג ר י מ צ אָ ר ן
גרין	ג ר י ן
גרינג	ג ר י נ ג
גרינדן	ג ר י נ ד ן
גרינס	ג ר י נ ס
גרינסן	ג ר י נ ס ן
גרינע	ג ר י נ ע
גרינעם	ג ר י נ ע ם
גרינער	ג ר י נ ע ר
גריסן	ג ר י ס ן
גריץ	ג ר י ץ
גרעזל	ג ר ע ז ל
גרעזער	ג ר ע ז ע ר
גרעסטן	ג ר ע ס ט ן
גרעסטע	ג ר ע ס ט ע
גרעסטער	ג ר ע ס ט ע ר
גרעסער	ג ר ע ס ע ר
גרעסערע	ג ר ע ס ע ר ע
גרעסערער	ג ר ע ס ע ר ע ר
גרױלעך	ג ר ױ ל ע ך
גרױס	ג ר ױ ס
גרױס־פּױלן	ג ר ױ ס ־ פּ ױ ל ן
גרױסן	ג ר ױ ס ן
גרױסע	ג ר ױ ס ע
גרױסעס	ג ר ױ ס ע ס
גרױסער	ג ר ױ ס ע ר
גרױסשטאָטישן	ג ר ױ ס ש ט אָ ט י ש ן
גרױען	ג ר ױ ע ן
גרײט	ג ר ײ ט
גרײטן	ג ר ײ ט ן
גרײַדיקער	ג ר ײַ ד י ק ע ר
גרײַז	ג ר ײַ ז
גרײַזן	ג ר ײַ ז ן
גראַגער	ג ר אַ ג ע ר
גראַם	ג ר אַ ם
גראַמאַטיק	ג ר אַ מ אַ ט י ק
גראַף	ג ר אַ ף
גראַפֿיניע	ג ר אַ פֿ י נ י ע
גראָבן	ג ר אָ ב ן
גראָבע	ג ר אָ ב ע
גראָבער	ג ר אָ ב ע ר
גראָד	ג ר אָ ד
גראָז	ג ר אָ ז
גראָזן	ג ר אָ ז ן
גראָס־אינקװיזיטאָרען	ג ר אָ ס ־ א י נ ק װ י ז י ט אָ ר ע ן
גראָשן	ג ר אָ ש ן
גװאַלד	ג װ אַ ל ד
גװאַלדעװעט	ג װ אַ ל ד ע װ ע ט
גױ	ג ױ
גױים	ג ױ י ם
גױישן	ג ױ י ש ן
גױישע	ג ױ י ש ע
גײ	ג ײ
גײט	ג ײ ט
גײט־אונטער	ג ײ ט ־ א ו נ ט ע ר
גײט־צו	ג ײ ט ־ צ ו
גײן	ג ײ ן
גײען	ג ײ ע ן
גײַסט	ג ײַ ס ט
גאַזלאַמפּטערנס	ג אַ ז ל אַ מ פּ ט ע ר נ ס
גאַזעטן	ג אַ ז ע ט ן
גאַזשע	ג אַ ז ש ע
גאַל	ג אַ ל
גאַל־שטײנער	ג אַ ל ־ ש ט ײ נ ע ר
גאַלײגט	ג אַ ל ײ ג ט
גאַנג	ג אַ נ ג
גאַנדז	ג אַ נ ד ז
גאַנץ	ג אַ נ ץ
גאַנצן	ג אַ נ צ ן
גאַנצע	ג אַ נ צ ע
גאַנצער	ג אַ נ צ ע ר
גאַס	ג אַ ס
גאַס־לאַמטערנס	ג אַ ס ־ ל אַ מ ט ע ר נ ס
גאַסט	ג אַ ס ט
גאַסן	ג אַ ס ן
גאַרטל	ג אַ ר ט ל
גאָב	ג אָ ב
גאָדערן	ג אָ ד ע ר ן
גאָט	ג אָ ט
גאָט'ס	ג אָ ט ' ס
גאָטלאָבער	ג אָ ט ל אָ ב ע ר
גאָטס	ג אָ ט ס
גאָטעס	ג אָ ט ע ס
גאָטעס־דינסט	ג אָ ט ע ס ־ ד י נ ס ט
גאָלד	ג אָ ל ד
גאָלדמאַן	ג אָ ל ד מ אַ ן
גאָלדע	ג אָ ל ד ע
גאָלדענע	ג אָ ל ד ע נ ע
גאָלדענער	ג אָ ל ד ע נ ע ר
גאָלע	ג אָ ל ע
גאָלער	ג אָ ל ע ר
גאָסטינעץ	ג אָ ס ט י נ ע ץ
גאָר	ג אָ ר
גאָרגל	ג אָ ר ג ל
גאָרגלען	ג אָ ר ג ל ע ן
גאָרגלשטײן	ג אָ ר ג ל ש ט ײ ן
גאָרטן	ג אָ ר ט ן
גאָרניט	ג אָ ר נ י ט
גאָרנישט	ג אָ ר נ י ש ט
גאָרער	ג אָ ר ע ר
גאָרשקאָװ	ג אָ ר ש ק אָ װ
גאָרשקאָװער	ג אָ ר ש ק אָ װ ע ר
גאָראָדאָװאַי	ג אָ ר אָ ד אָ װ אַ י
גבֿול	ג בֿ ו ל
גבֿורה	ג בֿ ו ר ה
גבֿיר	ג בֿ י ר
גבֿירים	ג בֿ י ר י ם
גבֿר	ג בֿ ר
גבֿרת	ג בֿ ר ת
ד	ד
ד'	ד '
דאגה	ד א ג ה
דאורײתא	ד א ו ר ײ ת א
דבור	ד ב ו ר
דבורים	ד ב ו ר י ם
דגוש	ד ג ו ש
דו	ד ו
דוד	ד ו ד
דוחק	ד ו ח ק
דוכט	ד ו כ ט
דוכטן	ד ו כ ט ן
דול	ד ו ל
דונער	ד ו נ ע ר
דוקא	ד ו ק א
דוקאַטן	ד ו ק אַ ט ן
דור	ד ו ר
דורך	ד ו ר ך
דורכגעגאַנגען	ד ו ר כ ג ע ג אַ נ ג ע ן
דורכגענעצט	ד ו ר כ ג ע נ ע צ ט
דורכגעשטופּט	ד ו ר כ ג ע ש ט ו פּ ט
דורכגעשלאָגן	ד ו ר כ ג ע ש ל אָ ג ן
דורכגעשמועסט	ד ו ר כ ג ע ש מ ו ע ס ט
דורכגעשפּאַצירט	ד ו ר כ ג ע ש פּ אַ צ י ר ט
דורכגעפֿירט	ד ו ר כ ג ע פֿ י ר ט
דורכגעפֿלױגן	ד ו ר כ ג ע פֿ ל ױ ג ן
דורכגעפֿאָרן	ד ו ר כ ג ע פֿ אָ ר ן
דורכגײענדיק	ד ו ר כ ג ײ ע נ ד י ק
דורכהײצן	ד ו ר כ ה ײ צ ן
דורכן	ד ו ר כ ן
דורכצופֿירן	ד ו ר כ צ ו פֿ י ר ן
דורכפֿאַל	ד ו ר כ פֿ אַ ל
דורכפֿאָרן	ד ו ר כ פֿ אָ ר ן
דורשט	ד ו ר ש ט
דופֿק	ד ו פֿ ק
די	ד י
דיבוקים	ד י ב ו ק י ם
דיבור	ד י ב ו ר
דיבורים	ד י ב ו ר י ם
דיזן	ד י ז ן
דיזע	ד י ז ע
דיזעם	ד י ז ע ם
דיזער	ד י ז ע ר
דיך	ד י ך
דיכטונג	ד י כ ט ו נ ג
דיכטער	ד י כ ט ע ר
דימענט	ד י מ ע נ ט
דין	ד י ן
דינים	ד י נ י ם
דינסטן	ד י נ ס ט ן
דינע	ד י נ ע
דינעם	ד י נ ע ם
דינען	ד י נ ע ן
דיעלע	ד י ע ל ע
דיק	ד י ק
דיקלעכע	ד י ק ל ע כ ע
דיקן	ד י ק ן
דיקס	ד י ק ס
דיר	ד י ר
דירה	ד י ר ה
דישע	ד י ש ע
דיפּלאָם	ד י פּ ל אָ ם
דלות	ד ל ו ת
דמיון	ד מ י ו ן
דע	ד ע
דעגראַדירן	ד ע ג ר אַ ד י ר ן
דעד	ד ע ד
דעה	ד ע ה
דעות	ד ע ו ת
דעי	ד ע י
דעם	ד ע ם
דעמאָלט	ד ע מ אָ ל ט
דען	ד ע ן
דענסטמאָל	ד ע נ ס ט מ אָ ל
דענצמאָל	ד ע נ צ מ אָ ל
דעסט	ד ע ס ט
דעסטװעגן	ד ע ס ט װ ע ג ן
דעקט	ד ע ק ט
דעקל	ד ע ק ל
דעקלאַמירט	ד ע ק ל אַ מ י ר ט
דער	ד ע ר
דערבײַ	ד ע ר ב ײַ
דערבאַרעמט	ד ע ר ב אַ ר ע מ ט
דערגעבן	ד ע ר ג ע ב ן
דערגרונטעװען	ד ע ר ג ר ו נ ט ע װ ע ן
דערגײן	ד ע ר ג ײ ן
דערגײען	ד ע ר ג ײ ע ן
דערגאַנגען	ד ע ר ג אַ נ ג ע ן
דערהערט	ד ע ר ה ע ר ט
דערהערנדיק	ד ע ר ה ע ר נ ד י ק
דערהרגענען	ד ע ר ה ר ג ע נ ע ן
דערהאַרן	ד ע ר ה אַ ר ן
דערונטער	ד ע ר ו נ ט ע ר
דערזעט	ד ע ר ז ע ט
דערזען	ד ע ר ז ע ן
דערטראָגן	ד ע ר ט ר אָ ג ן
דערטאַפּט	ד ע ר ט אַ פּ ט
דעריבער	ד ע ר י ב ע ר
דערין	ד ע ר י ן
דערכאַפּן	ד ע ר כ אַ פּ ן
דערלעבט	ד ע ר ל ע ב ט
דערלעבן	ד ע ר ל ע ב ן
דערלעג	ד ע ר ל ע ג
דערלױבן	ד ע ר ל ױ ב ן
דערלײגן	ד ע ר ל ײ ג ן
דערלײַדן	ד ע ר ל ײַ ד ן
דערלאַנגט	ד ע ר ל אַ נ ג ט
דערלאַנגען	ד ע ר ל אַ נ ג ע ן
דערלאַנגענדיק	ד ע ר ל אַ נ ג ע נ ד י ק
דערמיט	ד ע ר מ י ט
דערמאָנט	ד ע ר מ אָ נ ט
דערמאָנען	ד ע ר מ אָ נ ע ן
דערנענטערט	ד ע ר נ ע נ ט ע ר ט
דערנאָך	ד ע ר נ אָ ך
דערצו	ד ע ר צ ו
דערציטערטער	ד ע ר צ י ט ע ר ט ע ר
דערצײל	ד ע ר צ ײ ל
דערצײלונגען	ד ע ר צ ײ ל ו נ ג ע ן
דערצײלט	ד ע ר צ ײ ל ט
דערצײלן	ד ע ר צ ײ ל ן
דערקוטשען	ד ע ר ק ו ט ש ע ן
דערקלערט	ד ע ר ק ל ע ר ט
דערקען	ד ע ר ק ע ן
דערקענט	ד ע ר ק ע נ ט
דערקענען	ד ע ר ק ע נ ע ן
דערשטיקטע	ד ע ר ש ט י ק ט ע
דערשלאָגענער	ד ע ר ש ל אָ ג ע נ ע ר
דערשלאָפֿט	ד ע ר ש ל אָ פֿ ט
דערשרעקט	ד ע ר ש ר ע ק ט
דערשראָקן	ד ע ר ש ר אָ ק ן
דערשראָקענע	ד ע ר ש ר אָ ק ע נ ע
דערשראָקענעם	ד ע ר ש ר אָ ק ע נ ע ם
דערשראָקענער	ד ע ר ש ר אָ ק ע נ ע ר
דערשײַנען	ד ע ר ש ײַ נ ע ן
דערשפּירט	ד ע ר ש פּ י ר ט
דערװעגן	ד ע ר װ ע ג ן
דערװײַל	ד ע ר װ ײַ ל
דערװאַקסענע	ד ע ר װ אַ ק ס ע נ ע
דערװאַקסענעם	ד ע ר װ אַ ק ס ע נ ע ם
דערװאַרט	ד ע ר װ אַ ר ט
דערװוּסט	ד ע ר װ וּ ס ט
דערױף	ד ע ר ױ ף
דערפֿון	ד ע ר פֿ ו ן
דערפֿילט	ד ע ר פֿ י ל ט
דערפֿער	ד ע ר פֿ ע ר
דערפֿרײט	ד ע ר פֿ ר ײ ט
דערפֿאַר	ד ע ר פֿ אַ ר
דערפֿאָלגט	ד ע ר פֿ אָ ל ג ט
דעתו	ד ע ת ו
דקדוק	ד ק ד ו ק
דר'ערד	ד ר ' ע ר ד
דרוק	ד ר ו ק
דרוקן	ד ר ו ק ן
דרוקער	ד ר ו ק ע ר
דרוקערין	ד ר ו ק ע ר י ן
דרוקערײַ	ד ר ו ק ע ר ײַ
דריטן	ד ר י ט ן
דריטע	ד ר י ט ע
דריטער	ד ר י ט ע ר
דרימל	ד ר י מ ל
דרינגט	ד ר י נ ג ט
דרינגען	ד ר י נ ג ע ן
דרינען	ד ר י נ ע ן
דריקט	ד ר י ק ט
דריקען	ד ר י ק ע ן
דרך	ד ר ך
דרך־ארץ	ד ר ך ־ א ר ץ
דרך־הטבע	ד ר ך ־ ה ט ב ע
דרענגלעך	ד ר ע נ ג ל ע ך
דרשה	ד ר ש ה
דרשות	ד ר ש ו ת
דרשן	ד ר ש ן
דרױב	ד ר ױ ב
דרױסן	ד ר ױ ס ן
דרײדלעך	ד ר ײ ד ל ע ך
דרײט	ד ר ײ ט
דרײסט	ד ר ײ ס ט
דרײען	ד ר ײ ע ן
דרײער	ד ר ײ ע ר
דרײפֿוס	ד ר ײ פֿ ו ס
דרײפֿוסן	ד ר ײ פֿ ו ס ן
דרײפֿוסעס	ד ר ײ פֿ ו ס ע ס
דרײַ	ד ר ײַ
דרײַסיק־פֿערציק	ד ר ײַ ס י ק ־ פֿ ע ר צ י ק
דרײַציק	ד ר ײַ צ י ק
דראַמע	ד ר אַ מ ע
דראַמען־שרײַבער	ד ר אַ מ ע ן ־ ש ר ײַ ב ע ר
דראַמאַטישער	ד ר אַ מ אַ ט י ש ע ר
דראָשקעס	ד ר אָ ש ק ע ס
דרכּי	ד ר כּ י
דװקא	ד װ ק א
דױערט	ד ױ ע ר ט
דױערן	ד ױ ע ר ן
דײַטש	ד ײַ ט ש
דײַטשישע	ד ײַ ט ש י ש ע
דײַטשל	ד ײַ ט ש ל
דײַן	ד ײַ ן
דײַניקע	ד ײַ נ י ק ע
דײַנע	ד ײַ נ ע
דאַהער	ד אַ ה ע ר
דאַטשע	ד אַ ט ש ע
דאַך	ד אַ ך
דאַך־פֿענצטערל	ד אַ ך ־ פֿ ע נ צ ט ע ר ל
דאַכט	ד אַ כ ט
דאַמע	ד אַ מ ע
דאַמען	ד אַ מ ע ן
דאַמאָלסט	ד אַ מ אָ ל ס ט
דאַנטיסט	ד אַ נ ט י ס ט
דאַנציקער	ד אַ נ צ י ק ע ר
דאַנק	ד אַ נ ק
דאַנקען	ד אַ נ ק ע ן
דאַר	ד אַ ר
דאַרום	ד אַ ר ו ם
דאַרס	ד אַ ר ס
דאַרער	ד אַ ר ע ר
דאַרף	ד אַ ר ף
דאַרױס	ד אַ ר ױ ס
דאַראַבאַן	ד אַ ר אַ ב אַ ן
דאַרפֿט	ד אַ ר פֿ ט
דאַרפֿן	ד אַ ר פֿ ן
דאַרפֿסטו	ד אַ ר פֿ ס ט ו
דאַשעק	ד אַ ש ע ק
דאַװן	ד אַ װ ן
דאַװנט	ד אַ װ נ ט
דאַװנען	ד אַ װ נ ע ן
דאַװען	ד אַ װ ע ן
דאַװענען	ד אַ װ ע נ ע ן
דאָ	ד אָ
דאָזיקן	ד אָ ז י ק ן
דאָזיקע	ד אָ ז י ק ע
דאָזיקער	ד אָ ז י ק ע ר
דאָך	ד אָ ך
דאָנערשטיק	ד אָ נ ע ר ש ט י ק
דאָנערשטאָג	ד אָ נ ע ר ש ט אָ ג
דאָס	ד אָ ס
דאָסײַדיש־לשון	ד אָ ס ײַ ד י ש ־ ל ש ו ן
דאָקטער	ד אָ ק ט ע ר
דאָקטױרים	ד אָ ק ט ױ ר י ם
דאָקטאָר	ד אָ ק ט אָ ר
דאָקטאָר־טיטל	ד אָ ק ט אָ ר ־ ט י ט ל
דאָקטאָרקע	ד אָ ק ט אָ ר ק ע
דאָר	ד אָ ר
דאָרט	ד אָ ר ט
דאָרטיקע	ד אָ ר ט י ק ע
דאָרטיקער	ד אָ ר ט י ק ע ר
דאָרטן	ד אָ ר ט ן
דאָרף	ד אָ ר ף
דאָרפֿס־הונט	ד אָ ר פֿ ס ־ ה ו נ ט
דאָרפֿס־ײד	ד אָ ר פֿ ס ־ ײ ד
דאָרפֿסגײער	ד אָ ר פֿ ס ג ײ ע ר
דבֿרי	ד בֿ ר י
דפֿן	ד פֿ ן
ה'	ה '
הבא	ה ב א
הבדלה	ה ב ד ל ה
הבדלות	ה ב ד ל ו ת
הגבור	ה ג ב ו ר
הגדול	ה ג ד ו ל
הגם	ה ג ם
הדחק	ה ד ח ק
הדל	ה ד ל
הדעות	ה ד ע ו ת
הדר	ה ד ר
הדרשן	ה ד ר ש ן
הדאָקטאָריע	ה ד אָ ק ט אָ ר י ע
ההם	ה ה ם
הו־האַ	ה ו ־ ה אַ
הוה	ה ו ה
הוליאַק	ה ו ל י אַ ק
הומאַניטאַרע	ה ו מ אַ נ י ט אַ ר ע
הומאָריסט	ה ו מ אָ ר י ס ט
הון	ה ו ן
הונגער	ה ו נ ג ע ר
הונגעריק	ה ו נ ג ע ר י ק
הונגעריקער	ה ו נ ג ע ר י ק ע ר
הונגערן	ה ו נ ג ע ר ן
הונדערט	ה ו נ ד ע ר ט
הונדערטער	ה ו נ ד ע ר ט ע ר
הונט	ה ו נ ט
הוסט	ה ו ס ט
הוצאה	ה ו צ א ה
הורטאָװניקעס	ה ו ר ט אָ װ נ י ק ע ס
הורװיץ	ה ו ר װ י ץ
הושענא־רבה	ה ו ש ע נ א ־ ר ב ה
הושענות	ה ו ש ע נ ו ת
החג	ה ח ג
היבשע	ה י ב ש ע
היגע	ה י ג ע
היגער	ה י ג ע ר
היום	ה י ו ם
היט	ה י ט
היטל	ה י ט ל
היטלען	ה י ט ל ע ן
היטן	ה י ט ן
הילט	ה י ל ט
הילכט	ה י ל כ ט
הילף	ה י ל ף
הילצערנע	ה י ל צ ע ר נ ע
הילצערנער	ה י ל צ ע ר נ ע ר
הימים	ה י מ י ם
הימל	ה י מ ל
הימעל	ה י מ ע ל
הימעל־פֿאָטער	ה י מ ע ל ־ פֿ אָ ט ע ר
הין	ה י ן
הינטישע	ה י נ ט י ש ע
הינטן	ה י נ ט ן
הינטען	ה י נ ט ע ן
הינטער	ה י נ ט ע ר
הינטער־געסלעך	ה י נ ט ע ר ־ ג ע ס ל ע ך
הינטערגעסל	ה י נ ט ע ר ג ע ס ל
הינטערן	ה י נ ט ע ר ן
הינטערשטע	ה י נ ט ע ר ש ט ע
הינער	ה י נ ע ר
הינער־פֿרעסער	ה י נ ע ר ־ פֿ ר ע ס ע ר
הינערשע	ה י נ ע ר ש ע
היץ	ה י ץ
הירזשען	ה י ר ז ש ע ן
היפּשן	ה י פּ ש ן
הכנות	ה כ נ ו ת
הכנסת־אורחים	ה כ נ ס ת ־ א ו ר ח י ם
הלואי	ה ל ו א י
הלל	ה ל ל
הללױהס	ה ל ל ױ ה ס
הלמאי	ה ל מ א י
הלװאי	ה ל װ א י
המדרש	ה מ ד ר ש
המון	ה מ ו ן
המוציא	ה מ ו צ י א
המות	ה מ ו ת
המזון	ה מ ז ו ן
המכתבֿ	ה מ כ ת בֿ
המלך	ה מ ל ך
המן	ה מ ן
המנס	ה מ נ ס
המעשׂה	ה מ ע שׂ ה
המקומות	ה מ ק ו מ ו ת
הנאה	ה נ א ה
הנביא	ה נ ב י א
הנה	ה נ ה
הסינט	ה ס י נ ט
הסכּמה	ה ס כּ מ ה
העברעער	ה ע ב ר ע ע ר
העברעיִזמען	ה ע ב ר ע יִ ז מ ע ן
העזה	ה ע ז ה
העכט	ה ע כ ט
העכסט	ה ע כ ס ט
העכסטנס	ה ע כ ס ט נ ס
העכער	ה ע כ ע ר
העכערע	ה ע כ ע ר ע
העל	ה ע ל
העלד	ה ע ל ד
העלדזער	ה ע ל ד ז ע ר
העלן	ה ע ל ן
העלע	ה ע ל ע
העלענאַ	ה ע ל ע נ אַ
העלפֿט	ה ע ל פֿ ט
העלפֿן	ה ע ל פֿ ן
העמד	ה ע מ ד
העמדלעך	ה ע מ ד ל ע ך
הענגט	ה ע נ ג ט
הענד	ה ע נ ד
הענדום־פּענדום	ה ע נ ד ו ם ־ פּ ע נ ד ו ם
הענדל	ה ע נ ד ל
הענדלס	ה ע נ ד ל ס
הענדלען	ה ע נ ד ל ע ן
הענט	ה ע נ ט
הענער	ה ע נ ע ר
הענקער	ה ע נ ק ע ר
הענרי	ה ע נ ר י
העק	ה ע ק
הער	ה ע ר
הערט	ה ע ר ט
הערינג	ה ע ר י נ ג
הערן	ה ע ר ן
הערנדיק	ה ע ר נ ד י ק
הערסט	ה ע ר ס ט
הערצל־קלײן	ה ע ר צ ל ־ ק ל ײ ן
הערצלעכן	ה ע ר צ ל ע כ ן
הערש־מענדל	ה ע ר ש ־ מ ע נ ד ל
הערשל	ה ע ר ש ל
הערשלס	ה ע ר ש ל ס
הערשלען	ה ע ר ש ל ע ן
הערשאַפֿטן	ה ע ר ש אַ פֿ ט ן
העװיות	ה ע װ י ו ת
העפֿט	ה ע פֿ ט
הצלחה	ה צ ל ח ה
הקדש	ה ק ד ש
הקטורת	ה ק ט ו ר ת
הקלע	ה ק ל ע
הקפֿה	ה ק פֿ ה
הקפֿות	ה ק פֿ ו ת
הר־הזיתים	ה ר ־ ה ז י ת י ם
הרגעט	ה ר ג ע ט
הרוביעשױװ	ה ר ו ב י ע ש ױ װ
הריגות	ה ר י ג ו ת
הרבֿ	ה ר בֿ
השירים	ה ש י ר י ם
השם	ה ש ם
השמים	ה ש מ י ם
השנה	ה ש נ ה
השערה	ה ש ע ר ה
השבֿועות	ה ש בֿ ו ע ו ת
השבֿיעי	ה ש בֿ י ע י
התחלה	ה ת ח ל ה
התמדה	ה ת מ ד ה
הױב	ה ױ ב
הױבט	ה ױ ב ט
הױדלקע	ה ױ ד ל ק ע
הױדעט	ה ױ ד ע ט
הױדען	ה ױ ד ע ן
הױז	ה ױ ז
הױזגעזינט	ה ױ ז ג ע ז י נ ט
הױזן	ה ױ ז ן
הױט	ה ױ ט
הױך	ה ױ ך
הױכן	ה ױ כ ן
הױכע	ה ױ כ ע
הױכער	ה ױ כ ע ר
הױל	ה ױ ל
הױלן	ה ױ ל ן
הױלע	ה ױ ל ע
הױלער	ה ױ ל ע ר
הױף	ה ױ ף
הױקער	ה ױ ק ע ר
הױפּטדאַמע	ה ױ פּ ט ד אַ מ ע
הײ	ה ײ
הײבט	ה ײ ב ט
הײבן	ה ײ ב ן
הײזעריק	ה ײ ז ע ר י ק
הײזעריקלעך	ה ײ ז ע ר י ק ל ע ך
הײזעריקער	ה ײ ז ע ר י ק ע ר
הײך	ה ײ ך
הײל	ה ײ ל
הײלט	ה ײ ל ט
הײליקן	ה ײ ל י ק ן
הײליקע	ה ײ ל י ק ע
הײליקער	ה ײ ל י ק ע ר
הײלן	ה ײ ל ן
הײם	ה ײ ם
הײמיש	ה ײ מ י ש
הײמישן	ה ײ מ י ש ן
הײמלעכער	ה ײ מ ל ע כ ע ר
הײס	ה ײ ס
הײסט	ה ײ ס ט
הײסן	ה ײ ס ן
הײסע	ה ײ ס ע
הײסער	ה ײ ס ע ר
הײַזל	ה ײַ ז ל
הײַזער	ה ײַ ז ע ר
הײַזקע	ה ײַ ז ק ע
הײַנט	ה ײַ נ ט
הײַנטיקן	ה ײַ נ ט י ק ן
הײַנטיקע	ה ײַ נ ט י ק ע
השׂכּלה	ה שׂ כּ ל ה
השׂכּלה־זאַכן	ה שׂ כּ ל ה ־ ז אַ כ ן
האַבעליאַק	ה אַ ב ע ל י אַ ק
האַלב	ה אַ ל ב
האַלב־געבעטן	ה אַ ל ב ־ ג ע ב ע ט ן
האַלב־געפֿרעגט	ה אַ ל ב ־ ג ע פֿ ר ע ג ט
האַלבן	ה אַ ל ב ן
האַלבע	ה אַ ל ב ע
האַלבער	ה אַ ל ב ע ר
האַלדז	ה אַ ל ד ז
האַלדזן	ה אַ ל ד ז ן
האַלז	ה אַ ל ז
האַלט	ה אַ ל ט
האַלטן	ה אַ ל ט ן
האַלסט	ה אַ ל ס ט
האַנדל	ה אַ נ ד ל
האַנדלט	ה אַ נ ד ל ט
האַנדלען	ה אַ נ ד ל ע ן
האַנט	ה אַ נ ט
האַנטוך	ה אַ נ ט ו ך
האַנטעך	ה אַ נ ט ע ך
האַנטפֿאַס	ה אַ נ ט פֿ אַ ס
האַק	ה אַ ק
האַקט	ה אַ ק ט
האַקן	ה אַ ק ן
האַרבן	ה אַ ר ב ן
האַרבעריק	ה אַ ר ב ע ר י ק
האַרבשטאַרק	ה אַ ר ב ש ט אַ ר ק
האַרט	ה אַ ר ט
האַרטע	ה אַ ר ט ע
האַרטער	ה אַ ר ט ע ר
האַרמידער	ה אַ ר מ י ד ע ר
האַרמאָניש	ה אַ ר מ אָ נ י ש
האַרץ	ה אַ ר ץ
האַרץ־װײכיקע	ה אַ ר ץ ־ װ ײ כ י ק ע
האַרצט	ה אַ ר צ ט
האַרציק	ה אַ ר צ י ק
האַרציקע	ה אַ ר צ י ק ע
האַרציקער	ה אַ ר צ י ק ע ר
האַרצן	ה אַ ר צ ן
האַרצװײטאָג	ה אַ ר צ װ ײ ט אָ ג
האַרפּע	ה אַ ר פּ ע
האַװען	ה אַ װ ע ן
האָב	ה אָ ב
האָבן	ה אָ ב ן
האָבער	ה אָ ב ע ר
האָדל	ה אָ ד ל
האָזן	ה אָ ז ן
האָזן־פֿיסל	ה אָ ז ן ־ פֿ י ס ל
האָט	ה אָ ט
האָט'ן	ה אָ ט ' ן
האָטץ	ה אָ ט ץ
האָל	ה אָ ל
האָלץ	ה אָ ל ץ
האָן	ה אָ ן
האָניק	ה אָ נ י ק
האָניק־קעפּלעך	ה אָ נ י ק ־ ק ע פּ ל ע ך
האָנאָר	ה אָ נ אָ ר
האָסט	ה אָ ס ט
האָסטו	ה אָ ס ט ו
האָקוס	ה אָ ק ו ס
האָקן	ה אָ ק ן
האָר	ה אָ ר
האָר־פֿלאַקס	ה אָ ר ־ פֿ ל אַ ק ס
האָרינשטײנס	ה אָ ר י נ ש ט ײ נ ס
האָרכן	ה אָ ר כ ן
האָרעװעט	ה אָ ר ע װ ע ט
האָרעװען	ה אָ ר ע װ ע ן
האָרעפּאַשניקעס	ה אָ ר ע פּ אַ ש נ י ק ע ס
האָרעפּאַשנעם	ה אָ ר ע פּ אַ ש נ ע ם
האָפֿט	ה אָ פֿ ט
האָפֿענונג	ה אָ פֿ ע נ ו נ ג
האָפֿערדיק	ה אָ פֿ ע ר ד י ק
הכּלל	ה כּ ל ל
הפּרשה	ה פּ ר ש ה
הבֿדלה	ה בֿ ד ל ה
הבֿדלתּ	ה בֿ ד ל תּ
הבֿדלתּען	ה בֿ ד ל תּ ע ן
הפֿקר	ה פֿ ק ר
ו־ק־ד־ל־תּ	ו ־ ק ־ ד ־ ל ־ תּ
ו־ק־ד־ש־תּ	ו ־ ק ־ ד ־ ש ־ תּ
ו־קד־לתּ	ו ־ ק ד ־ ל תּ
ואביון	ו א ב י ו ן
ואופֿן	ו א ו פֿ ן
ואין	ו א י ן
ואת	ו א ת
ובכל	ו ב כ ל
ובפֿרט	ו ב פֿ ר ט
ודורש	ו ד ו ר ש
ודם	ו ד ם
והנורא	ו ה נ ו ר א
והכּלה	ו ה כּ ל ה
והבֿדלתּ	ו ה בֿ ד ל תּ
וחשבון	ו ח ש ב ו ן
ולא	ו ל א
ולכן	ו ל כ ן
ומי	ו מ י
ומציל	ו מ צ י ל
ונשתּומם	ו נ ש תּ ו מ ם
ועיר	ו ע י ר
ועל	ו ע ל
וקדלתּ	ו ק ד ל תּ
וקדשתּ	ו ק ד ש תּ
וקדשתּען	ו ק ד ש תּ ע ן
וראנה	ו ר א נ ה
ושלוה	ו ש ל ו ה
ושלום	ו ש ל ו ם
ושׂמחה	ו שׂ מ ח ה
וכּך	ו כּ ך
וכּמה	ו כּ מ ה
זהב	ז ה ב
זוך	ז ו ך
זוכה	ז ו כ ה
זוכט	ז ו כ ט
זוכן	ז ו כ ן
זול	ז ו ל
זולצערס	ז ו ל צ ע ר ס
זומער	ז ו מ ע ר
זומער־נאַכט	ז ו מ ע ר ־ נ אַ כ ט
זומער־צײַט	ז ו מ ע ר ־ צ ײַ ט
זומערדיק־הײסער	ז ו מ ע ר ד י ק ־ ה ײ ס ע ר
זומערנאַכט	ז ו מ ע ר נ אַ כ ט
זומערשטאָף	ז ו מ ע ר ש ט אָ ף
זומערשפּרענקעלעך	ז ו מ ע ר ש פּ ר ע נ ק ע ל ע ך
זומערװינט	ז ו מ ע ר װ י נ ט
זומערװינטן	ז ו מ ע ר װ י נ ט ן
זומפּ	ז ו מ פּ
זומפּן	ז ו מ פּ ן
זון	ז ו ן
זונגאָלד	ז ו נ ג אָ ל ד
זונטיק	ז ו נ ט י ק
זונס	ז ו נ ס
זוסמאַנס	ז ו ס מ אַ נ ס
זופּ	ז ו פּ
זי	ז י
זיבן	ז י ב ן
זיבעטער	ז י ב ע ט ע ר
זיבענע	ז י ב ע נ ע
זיבעצן	ז י ב ע צ ן
זידל־נאָמען	ז י ד ל ־ נ אָ מ ע ן
זידלט	ז י ד ל ט
זידלען	ז י ד ל ע ן
זיך	ז י ך
זיכער	ז י כ ע ר
זיכערן	ז י כ ע ר ן
זילבער	ז י ל ב ע ר
זילבערנע	ז י ל ב ע ר נ ע
זין	ז י ן
זינג	ז י נ ג
זינגט	ז י נ ג ט
זינגען	ז י נ ג ע ן
זינגענדיק־יאָמערדיקן	ז י נ ג ע נ ד י ק ־ י אָ מ ע ר ד י ק ן
זינגפֿױגל	ז י נ ג פֿ ױ ג ל
זינד	ז י נ ד
זינדיק	ז י נ ד י ק
זינדיקסט	ז י נ ד י ק ס ט
זינט	ז י נ ט
זינען	ז י נ ע ן
זיס	ז י ס
זיס־װײנענדיק	ז י ס ־ װ ײ נ ע נ ד י ק
זיסל	ז י ס ל
זיסלען	ז י ס ל ע ן
זיסן	ז י ס ן
זיסע	ז י ס ע
זיסערע	ז י ס ע ר ע
זיץ	ז י ץ
זיצט	ז י צ ט
זיצן	ז י צ ן
זיצנדיק	ז י צ נ ד י ק
זיװג	ז י װ ג
זיװג־תּחינה	ז י װ ג ־ תּ ח י נ ה
זיפֿצט	ז י פֿ צ ט
זכות	ז כ ו ת
זכיה	ז כ י ה
זכר	ז כ ר
זלמן	ז ל מ ן
זלאָדי	ז ל אָ ד י
זלאָדיעװקע	ז ל אָ ד י ע װ ק ע
זמירות	ז מ י ר ו ת
זמן	ז מ ן
זע	ז ע
זעהר	ז ע ה ר
זעונג	ז ע ו נ ג
זעט	ז ע ט
זעכצן	ז ע כ צ ן
זעלביקע	ז ע ל ב י ק ע
זעלבן	ז ע ל ב ן
זעלבע	ז ע ל ב ע
זעלבער	ז ע ל ב ע ר
זעלטן	ז ע ל ט ן
זעליג	ז ע ל י ג
זעליגל	ז ע ל י ג ל
זען	ז ע ן
זענט	ז ע נ ט
זענען	ז ע נ ע ן
זעסט	ז ע ס ט
זעסטו	ז ע ס ט ו
זעען	ז ע ע ן
זעענדיק	ז ע ע נ ד י ק
זעץ	ז ע ץ
זעצט	ז ע צ ט
זעצן	ז ע צ ן
זעק	ז ע ק
זעקל	ז ע ק ל
זעקס	ז ע ק ס
זעקסטן	ז ע ק ס ט ן
זעקסער	ז ע ק ס ע ר
זעקעלע	ז ע ק ע ל ע
זעקעלען	ז ע ק ע ל ע ן
זערנעס	ז ע ר נ ע ס
זשופּיצע	ז ש ו פּ י צ ע
זשידי	ז ש י ד י
זשידיװסקאַ	ז ש י ד י װ ס ק אַ
זשיפּע	ז ש י פּ ע
זשליאָק	ז ש ל י אָ ק
זשע	ז ש ע
זשעדנע	ז ש ע ד נ ע
זשאַנדאַרן	ז ש אַ נ ד אַ ר ן
זשאַרגאָן	ז ש אַ ר ג אָ ן
זשאַרגאָניסטן	ז ש אַ ר ג אָ נ י ס ט ן
זװג	ז װ ג
זױלן	ז ױ ל ן
זױמט	ז ױ מ ט
זױמען־שטױב	ז ױ מ ע ן ־ ש ט ױ ב
זױערלעך	ז ױ ע ר ל ע ך
זױערע	ז ױ ע ר ע
זױפֿל	ז ױ פֿ ל
זײ	ז ײ
זײגער	ז ײ ג ע ר
זײגערנע	ז ײ ג ע ר נ ע
זײדן	ז ײ ד ן
זײדנס	ז ײ ד נ ס
זײדע	ז ײ ד ע
זײט	ז ײ ט
זײענדיק	ז ײ ע נ ד י ק
זײער	ז ײ ע ר
זײער־זײער	ז ײ ע ר ־ ז ײ ע ר
זײערטװעגן	ז ײ ע ר ט װ ע ג ן
זײערע	ז ײ ע ר ע
זײערער	ז ײ ע ר ע ר
זײַ	ז ײַ
זײַד	ז ײַ ד
זײַדל	ז ײַ ד ל
זײַדלען	ז ײַ ד ל ע ן
זײַט	ז ײַ ט
זײַטיק	ז ײַ ט י ק
זײַטיקע	ז ײַ ט י ק ע
זײַטן	ז ײַ ט ן
זײַן	ז ײַ ן
זײַניקע	ז ײַ נ י ק ע
זײַנס	ז ײַ נ ס
זײַנע	ז ײַ נ ע
זײַנעט	ז ײַ נ ע ט
זײַנעם	ז ײַ נ ע ם
זײַנען	ז ײַ נ ע ן
זײַנער	ז ײַ נ ע ר
זײַנװלס	ז ײַ נ װ ל ס
זײַען	ז ײַ ע ן
זאַט	ז אַ ט
זאַטשעפּען	ז אַ ט ש ע פּ ע ן
זאַך	ז אַ ך
זאַכן	ז אַ כ ן
זאַלב	ז אַ ל ב
זאַמד	ז אַ מ ד
זאַמלט	ז אַ מ ל ט
זאַמלען	ז אַ מ ל ע ן
זאַמאַשטש	ז אַ מ אַ ש ט ש
זאַמאָסטש	ז אַ מ אָ ס ט ש
זאַמאָשטש	ז אַ מ אָ ש ט ש
זאַץ	ז אַ ץ
זאַק	ז אַ ק
זאַקנאָדל	ז אַ ק נ אָ ד ל
זאַפּט	ז אַ פּ ט
זאַפּרעשטשאָנע	ז אַ פּ ר ע ש ט ש אָ נ ע
זאַפּאַני־בראַטאַ	ז אַ פּ אַ נ י ־ ב ר אַ ט אַ
זאַפֿראַן	ז אַ פֿ ר אַ ן
זאָג	ז אָ ג
זאָגט	ז אָ ג ט
זאָגט־זשע	ז אָ ג ט ־ ז ש ע
זאָגן	ז אָ ג ן
זאָגנדיק	ז אָ ג נ ד י ק
זאָגסט	ז אָ ג ס ט
זאָגסטו	ז אָ ג ס ט ו
זאָגען	ז אָ ג ע ן
זאָל	ז אָ ל
זאָלט	ז אָ ל ט
זאָלן	ז אָ ל ן
זאָלסט	ז אָ ל ס ט
זאָלסטו	ז אָ ל ס ט ו
זאָלען	ז אָ ל ע ן
זאָנע	ז אָ נ ע
זאָקן	ז אָ ק ן
זאָקן־פֿאַבריקאַנט	ז אָ ק ן ־ פֿ אַ ב ר י ק אַ נ ט
זאָרג	ז אָ ר ג
זאָרגט	ז אָ ר ג ט
זאָרגן	ז אָ ר ג ן
זכּרון	ז כּ ר ו ן
חבה	ח ב ה
חברה־מאַן	ח ב ר ה ־ מ אַ ן
חדושים	ח ד ו ש י ם
חדר	ח ד ר
חדר־געלט	ח ד ר ־ ג ע ל ט
חדר־יונגלעך	ח ד ר ־ י ו נ ג ל ע ך
חדר־יִינגל	ח ד ר ־ יִ י נ ג ל
חדר־יִינגלעך	ח ד ר ־ יִ י נ ג ל ע ך
חדרים	ח ד ר י ם
חודש	ח ו ד ש
חוזק־לאַטע	ח ו ז ק ־ ל אַ ט ע
חול־המועד	ח ו ל ־ ה מ ו ע ד
חולה	ח ו ל ה
חולים	ח ו ל י ם
חולין	ח ו ל י ן
חוסן	ח ו ס ן
חוץ	ח ו ץ
חוצפּה	ח ו צ פּ ה
חוקר	ח ו ק ר
חורבן	ח ו ר ב ן
חוש	ח ו ש
חושך	ח ו ש ך
חופּה	ח ו פּ ה
חזיר	ח ז י ר
חזן	ח ז ן
חזנס	ח ז נ ס
חזר	ח ז ר
חי־וקײם	ח י ־ ו ק ײ ם
חידוש	ח י ד ו ש
חידושים	ח י ד ו ש י ם
חיות	ח י ו ת
חיל	ח י ל
חילול־השם	ח י ל ו ל ־ ה ש ם
חילוף	ח י ל ו ף
חילוק	ח י ל ו ק
חילופֿט	ח י ל ו פֿ ט
חכם	ח כ ם
חכמה	ח כ מ ה
חכמים	ח כ מ י ם
חכמת	ח כ מ ת
חלה	ח ל ה
חלום	ח ל ו ם
חלומות	ח ל ו מ ו ת
חלילה	ח ל י ל ה
חליצה־שיך	ח ל י צ ה ־ ש י ך
חלף	ח ל ף
חלק	ח ל ק
חלשות	ח ל ש ו ת
חלשט	ח ל ש ט
חלשן	ח ל ש ן
חלאַתן	ח ל אַ ת ן
חלבֿ	ח ל בֿ
חן	ח ן
חנא	ח נ א
חנה	ח נ ה
חנוכה־לעמפּלעך	ח נ ו כ ה ־ ל ע מ פּ ל ע ך
חנוכּה	ח נ ו כּ ה
חנוכּה־ליכטלעך	ח נ ו כּ ה ־ ל י כ ט ל ע ך
חניפֿה	ח נ י פֿ ה
חניפֿהלעך	ח נ י פֿ ה ל ע ך
חס	ח ס
חס־ושלום	ח ס ־ ו ש ל ו ם
חסיד	ח ס י ד
חסידות	ח ס י ד ו ת
חסידים	ח ס י ד י ם
חסר־דעה	ח ס ר ־ ד ע ה
חסרון	ח ס ר ו ן
חסרונות	ח ס ר ו נ ו ת
חצות	ח צ ו ת
חצי	ח צ י
חקירה־ספֿרים	ח ק י ר ה ־ ס פֿ ר י ם
חקרן	ח ק ר ן
חרותינו	ח ר ו ת י נ ו
חרובֿ	ח ר ו בֿ
חרטה	ח ר ט ה
חריפֿות	ח ר י פֿ ו ת
חרם	ח ר ם
חרפּה	ח ר פּ ה
חשבון	ח ש ב ו ן
חשבונות	ח ש ב ו נ ו ת
חשובֿ	ח ש ו בֿ
חשובֿן	ח ש ו בֿ ן
חשק	ח ש ק
חשבֿונען	ח ש בֿ ו נ ע ן
חתונה	ח ת ו נ ה
חתונות	ח ת ו נ ו ת
חתימה	ח ת י מ ה
חתמענען	ח ת מ ע נ ע ן
חתן	ח ת ן
חתן־כּלה	ח ת ן ־ כּ ל ה
חײ	ח ײ
חײם	ח ײ ם
חײמניק	ח ײ מ נ י ק
חשׂוך־בנים	ח שׂ ו ך ־ ב נ י ם
חאָבן	ח אָ ב ן
חאָט	ח אָ ט
חבֿר	ח בֿ ר
חבֿרה	ח בֿ ר ה
חבֿרה־משניות	ח בֿ ר ה ־ מ ש נ י ו ת
חבֿרה־מאַן	ח בֿ ר ה ־ מ אַ ן
חבֿרות	ח בֿ ר ו ת
חבֿרן	ח בֿ ר ן
חפֿצים	ח פֿ צ י ם
ט	ט
ט'אָסטו	ט ' אָ ס ט ו
טהור	ט ה ו ר
טו	ט ו
טוב	ט ו ב
טוביה	ט ו ב י ה
טוביהן	ט ו ב י ה ן
טוט	ט ו ט
טומטום	ט ו מ ט ו ם
טומל	ט ו מ ל
טון	ט ו ן
טונקט	ט ו נ ק ט
טונקלהײט	ט ו נ ק ל ה ײ ט
טונקעלן	ט ו נ ק ע ל ן
טונקעלע	ט ו נ ק ע ל ע
טונקעלער	ט ו נ ק ע ל ע ר
טועם	ט ו ע ם
טוען	ט ו ע ן
טוענדיק	ט ו ע נ ד י ק
טוץ	ט ו ץ
טורבין	ט ו ר ב י ן
טורמע	ט ו ר מ ע
טובֿ	ט ו בֿ
טובֿה	ט ו בֿ ה
טובֿים	ט ו בֿ י ם
טובֿימס	ט ו בֿ י מ ס
טינט	ט י נ ט
טינטער	ט י נ ט ע ר
טיף	ט י ף
טיר	ט י ר
טירן	ט י ר ן
טירװענטל	ט י ר װ ע נ ט ל
טיש	ט י ש
טישטשע	ט י ש ט ש ע
טיפֿן	ט י פֿ ן
טיפֿער	ט י פֿ ע ר
טלומיק	ט ל ו מ י ק
טלית	ט ל י ת
טלית־און־תּפֿילין	ט ל י ת ־ א ו ן ־ תּ פֿ י ל י ן
טליתים	ט ל י ת י ם
טעג	ט ע ג
טעות	ט ע ו ת
טעכטער	ט ע כ ט ע ר
טעכטערל	ט ע כ ט ע ר ל
טעלער	ט ע ל ע ר
טעם	ט ע ם
טעמים	ט ע מ י ם
טעמפּל	ט ע מ פּ ל
טעמפּעלע	ט ע מ פּ ע ל ע
טענה	ט ע נ ה
טענהט	ט ע נ ה ט
טענהען	ט ע נ ה ע ן
טענות	ט ע נ ו ת
טענטלען	ט ע נ ט ל ע ן
טענער	ט ע נ ע ר
טענצל	ט ע נ צ ל
טעצל	ט ע צ ל
טעקסט	ט ע ק ס ט
טערק	ט ע ר ק
טערקישע	ט ע ר ק י ש ע
טערקישער	ט ע ר ק י ש ע ר
טערקײַ	ט ע ר ק ײַ
טעװעלע	ט ע װ ע ל ע
טעאַטער	ט ע אַ ט ע ר
טעאַטער־דירעקטאָר	ט ע אַ ט ע ר ־ ד י ר ע ק ט אָ ר
טעאַטער־שטיק	ט ע אַ ט ע ר ־ ש ט י ק
טעאָדאָר	ט ע אָ ד אָ ר
טעפּלעך	ט ע פּ ל ע ך
טרובאַטש	ט ר ו ב אַ ט ש
טרונק	ט ר ו נ ק
טרוקן	ט ר ו ק ן
טרוקענע	ט ר ו ק ע נ ע
טרוקענער	ט ר ו ק ע נ ע ר
טרופּע	ט ר ו פּ ע
טרחה	ט ר ח ה
טריב	ט ר י ב
טריט	ט ר י ט
טרינקאען	ט ר י נ ק א ע ן
טרינקט	ט ר י נ ק ט
טרינקן	ט ר י נ ק ן
טרינקען	ט ר י נ ק ע ן
טרעגער	ט ר ע ג ע ר
טרעגערס	ט ר ע ג ע ר ס
טרעט	ט ר ע ט
טרעף	ט ר ע ף
טרערן	ט ר ע ר ן
טרעפּ	ט ר ע פּ
טרעפֿט	ט ר ע פֿ ט
טרעפֿן	ט ר ע פֿ ן
טרױם־פֿירנדיקער	ט ר ױ ם ־ פֿ י ר נ ד י ק ע ר
טרױער	ט ר ױ ע ר
טרױערט	ט ר ױ ע ר ט
טרױעריק	ט ר ױ ע ר י ק
טרױעריקן	ט ר ױ ע ר י ק ן
טרױעריקע	ט ר ױ ע ר י ק ע
טרײסט	ט ר ײ ס ט
טרײסלט	ט ר ײ ס ל ט
טרײסלען	ט ר ײ ס ל ע ן
טרײף	ט ר ײ ף
טרײַ	ט ר ײַ
טרײַבט	ט ר ײַ ב ט
טראַגעדיע	ט ר אַ ג ע ד י ע
טראַטואַרן	ט ר אַ ט ו אַ ר ן
טראַכט	ט ר אַ כ ט
טראַכטן	ט ר אַ כ ט ן
טראַכטנדיק	ט ר אַ כ ט נ ד י ק
טראַמװײ	ט ר אַ מ װ ײ
טראַמװײס	ט ר אַ מ װ ײ ס
טראַף	ט ר אַ ף
טראָג	ט ר אָ ג
טראָגט	ט ר אָ ג ט
טראָגן	ט ר אָ ג ן
טראָגסט	ט ר אָ ג ס ט
טראָץ	ט ר אָ ץ
טראָפּן	ט ר אָ פּ ן
טשולאַנטשיק	ט ש ו ל אַ נ ט ש י ק
טשיקאַװע	ט ש י ק אַ װ ע
טשעבילסקיס	ט ש ע ב י ל ס ק י ס
טשעמאָדאַנטשיק	ט ש ע מ אָ ד אַ נ ט ש י ק
טשעקאַװע	ט ש ע ק אַ װ ע
טשװישן	ט ש װ י ש ן
טשױרטש	ט ש ױ ר ט ש
טשײַניקל	ט ש ײַ נ י ק ל
טװאַן	ט װ אַ ן
טױ	ט ױ
טױ־באַדעקטן	ט ױ ־ ב אַ ד ע ק ט ן
טױב	ט ױ ב
טױבלעך	ט ױ ב ל ע ך
טױג	ט ױ ג
טױגן	ט ױ ג ן
טױזנט	ט ױ ז נ ט
טױזנטער	ט ױ ז נ ט ע ר
טױט	ט ױ ט
טױט־שיכּור	ט ױ ט ־ ש י כּ ו ר
טױטן	ט ױ ט ן
טױטן־שטיבל	ט ױ ט ן ־ ש ט י ב ל
טױטע	ט ױ ט ע
טױער	ט ױ ע ר
טױשן	ט ױ ש ן
טײ	ט ײ
טײגן	ט ײ ג ן
טײל	ט ײ ל
טײַטלט	ט ײַ ט ל ט
טײַך	ט ײַ ך
טײַער	ט ײַ ע ר
טײַערסטע	ט ײַ ע ר ס ט ע
טײַערע	ט ײַ ע ר ע
טײַערער	ט ײַ ע ר ע ר
טאַבליצע	ט אַ ב ל י צ ע
טאַבאַק־פּושקע	ט אַ ב אַ ק ־ פּ ו ש ק ע
טאַגלי	ט אַ ג ל י
טאַטן	ט אַ ט ן
טאַטנס	ט אַ ט נ ס
טאַטע	ט אַ ט ע
טאַטע־מאַמע	ט אַ ט ע ־ מ אַ מ ע
טאַטעס	ט אַ ט ע ס
טאַנצן	ט אַ נ צ ן
טאַקי	ט אַ ק י
טאַקסע	ט אַ ק ס ע
טאַקע	ט אַ ק ע
טאַראַראַם	ט אַ ר אַ ר אַ ם
טאַפּט	ט אַ פּ ט
טאַפּן	ט אַ פּ ן
טאַפֿלי	ט אַ פֿ ל י
טאָ	ט אָ
טאָג	ט אָ ג
טאָג־און־נאַכט	ט אָ ג ־ א ו ן ־ נ אַ כ ט
טאָדיען	ט אָ ד י ע ן
טאָטער	ט אָ ט ע ר
טאָטשעט	ט אָ ט ש ע ט
טאָכטער	ט אָ כ ט ע ר
טאָכטערל	ט אָ כ ט ע ר ל
טאָכטערס	ט אָ כ ט ע ר ס
טאָלסטױ	ט אָ ל ס ט ױ
טאָלער	ט אָ ל ע ר
טאָלאָטשינאָװס	ט אָ ל אָ ט ש י נ אָ װ ס
טאָמער	ט אָ מ ע ר
טאָן	ט אָ ן
טאָר	ט אָ ר
טאָרגעס	ט אָ ר ג ע ס
טאָרן	ט אָ ר ן
טאָפּ	ט אָ פּ
טאָפּלט	ט אָ פּ ל ט
טאָפּעלער	ט אָ פּ ע ל ע ר
טאָפּאָליעס	ט אָ פּ אָ ל י ע ס
טפּש	ט פּ ש
טבֿלע	ט בֿ ל ע
טבֿלען	ט בֿ ל ע ן
טבֿע	ט בֿ ע
טפֿו	ט פֿ ו
טפֿחים	ט פֿ ח י ם
יהונתן	י ה ו נ ת ן
יהונתנען	י ה ו נ ת נ ע ן
יהושע־העשל	י ה ו ש ע ־ ה ע ש ל
יהושע־העשלס	י ה ו ש ע ־ ה ע ש ל ס
יוגנט	י ו ג נ ט
יודישען	י ו ד י ש ע ן
יודע	י ו ד ע
יודעלע	י ו ד ע ל ע
יודאָפֿאָב	י ו ד אָ פֿ אָ ב
יוזיפֿיל	י ו ז י פֿ י ל
יוכע	י ו כ ע
יום	י ו ם
יום־	י ו ם ־
יום־טוב	י ו ם ־ ט ו ב
יום־טובֿ	י ו ם ־ ט ו בֿ
יום־טובֿדיק	י ו ם ־ ט ו בֿ ד י ק
יום־טובֿדיקן	י ו ם ־ ט ו בֿ ד י ק ן
יום־טובֿדיקער	י ו ם ־ ט ו בֿ ד י ק ע ר
יום־כּיפּור	י ו ם ־ כּ י פּ ו ר
יום־כּפּור	י ו ם ־ כּ פּ ו ר
יומא	י ו מ א
יונג	י ו נ ג
יונגע	י ו נ ג ע
יונגע־לײַט	י ו נ ג ע ־ ל ײַ ט
יונגעטשקער	י ו נ ג ע ט ש ק ע ר
יונגען	י ו נ ג ע ן
יונגענמאַן	י ו נ ג ע נ מ אַ ן
יונגער	י ו נ ג ע ר
יונגער־מאַן	י ו נ ג ע ר ־ מ אַ ן
יונגערמאַן	י ו נ ג ע ר מ אַ ן
יונגװאַרג	י ו נ ג װ אַ ר ג
יוניש	י ו נ י ש
יוסטן	י ו ס ט ן
יוסטע	י ו ס ט ע
יוסלען	י ו ס ל ע ן
יוצא	י ו צ א
יורד	י ו ר ד
יוראָפּ	י ו ר אָ פּ
יושר	י ו ש ר
יושבֿים	י ו ש בֿ י ם
יופּיצע	י ו פּ י צ ע
יופּע	י ו פּ ע
יובֿל	י ו בֿ ל
יחוס	י ח ו ס
יחות	י ח ו ת
ים	י ם
ים־סוף	י ם ־ ס ו ף
ימח	י מ ח
ימי	י מ י
ימים	י מ י ם
ימים־טובֿים	י מ י ם ־ ט ו בֿ י ם
ימים־נוראים	י מ י ם ־ נ ו ר א י ם
ימים־נוראָים	י מ י ם ־ נ ו ר אָ י ם
ימים־נוראָימדיקער	י מ י ם ־ נ ו ר אָ י מ ד י ק ע ר
יסורים	י ס ו ר י ם
יעדן	י ע ד ן
יעדע	י ע ד ע
יעדעס	י ע ד ע ס
יעדער	י ע ד ע ר
יעדערן	י ע ד ע ר ן
יעלה	י ע ל ה
יעלות	י ע ל ו ת
יענע	י ע נ ע
יענעם	י ע נ ע ם
יענעמס	י ע נ ע מ ס
יענעס	י ע נ ע ס
יענער	י ע נ ע ר
יענץ	י ע נ ץ
יענקיס	י ע נ ק י ס
יעצו	י ע צ ו
יעצט	י ע צ ט
יעקב	י ע ק ב
יעקבֿ	י ע ק בֿ
יצאה	י צ א ה
יצחק	י צ ח ק
יצר־הרע	י צ ר ־ ה ר ע
יצר־הרע־בלעטערלעך	י צ ר ־ ה ר ע ־ ב ל ע ט ע ר ל ע ך
יקום־	י ק ו ם ־
ירא־אלוהים	י ר א ־ א ל ו ה י ם
ירא־שמים	י ר א ־ ש מ י ם
יראת־שמײם־פּענעמל	י ר א ת ־ ש מ ײ ם ־ פּ ע נ ע מ ל
ירדן	י ר ד ן
ירוחם	י ר ו ח ם
ירוחם־גרונים	י ר ו ח ם ־ ג ר ו נ י ם
ירושה	י ר ו ש ה
יריד	י ר י ד
יריחו	י ר י ח ו
ירצה	י ר צ ה
יש	י ש
ישיבֿה־בחורים	י ש י בֿ ה ־ ב ח ו ר י ם
ישראל	י ש ר א ל
יתברך	י ת ב ר ך
יתום	י ת ו ם
יתומות	י ת ו מ ו ת
יתומים	י ת ו מ י ם
יתומישע	י ת ו מ י ש ע
יתומס	י ת ו מ ס
יװנישע	י װ נ י ש ע
יױך	י ױ ך
ייִ	י יִ
ייִד	י יִ ד
ייִדינע	י יִ ד י נ ע
ייִדיש	י יִ ד י ש
ייִדישע	י יִ ד י ש ע
ייִדן	י יִ ד ן
ייִדענע	י יִ ד ע נ ע
ייִנגל	י יִ נ ג ל
ייִנגסטן	י יִ נ ג ס ט ן
ישׂראל	י שׂ ר א ל
ישׂראליק	י שׂ ר א ל י ק
יאַדראָ	י אַ ד ר אָ
יאַכנוק	י אַ כ נ ו ק
יאַנדעס	י אַ נ ד ע ס
יאַנעװ	י אַ נ ע װ
יאַנקל	י אַ נ ק ל
יאַסמין	י אַ ס מ י ן
יאַרמולקע	י אַ ר מ ו ל ק ע
יאַרעמע	י אַ ר ע מ ע
יאַשעק	י אַ ש ע ק
יאַשעקן	י אַ ש ע ק ן
יאַבֿדו	י אַ בֿ ד ו
יאָ	י אָ
יאָגט	י אָ ג ט
יאָגן	י אָ ג ן
יאָגנדיק	י אָ ג נ ד י ק
יאָלד	י אָ ל ד
יאָמער	י אָ מ ע ר
יאָמערלעך	י אָ מ ע ר ל ע ך
יאָסעלע	י אָ ס ע ל ע
יאָר	י אָ ר
יאָרן	י אָ ר ן
כ'בין	כ ' ב י ן
כ'גײ	כ ' ג ײ
כ'האָב	כ ' ה אָ ב
כ'זאָג	כ ' ז אָ ג
כ'טו	כ ' ט ו
כ'לעבן	כ ' ל ע ב ן
כ'מײן	כ ' מ ײ ן
כ'נעם	כ ' נ ע ם
כ'קום	כ ' ק ו ם
כ'װיל	כ ' װ י ל
כ'װײס	כ ' װ ײ ס
כ'װאָלט	כ ' װ אָ ל ט
כ'פֿאַרשטײ	כ ' פֿ אַ ר ש ט ײ
כבוד	כ ב ו ד
כדין	כ ד י ן
כורעים	כ ו ר ע י ם
כיכיקעט	כ י כ י ק ע ט
כיכעניש	כ י כ ע נ י ש
כירורג	כ י ר ו ר ג
כל	כ ל
כלום	כ ל ו ם
כלומרשט	כ ל ו מ ר ש ט
כלאַמידע	כ ל אַ מ י ד ע
כעלם	כ ע ל ם
כעלמער	כ ע ל מ ע ר
כרעמזלעך	כ ר ע מ ז ל ע ך
כרײן	כ ר ײ ן
כװאַליעס	כ װ אַ ל י ע ס
כאַ	כ אַ
כאַ־כאַ־כאַ־כאַ־כאַ	כ אַ ־ כ אַ ־ כ אַ ־ כ אַ ־ כ אַ
כאַליאַסטרע	כ אַ ל י אַ ס ט ר ע
כאַמולע	כ אַ מ ו ל ע
כאַראַקטער־ראָליסט	כ אַ ר אַ ק ט ע ר ־ ר אָ ל י ס ט
כאַראַקטאָרן	כ אַ ר אַ ק ט אָ ר ן
כאַפּ	כ אַ פּ
כאַפּ־אונטער	כ אַ פּ ־ א ו נ ט ע ר
כאַפּט	כ אַ פּ ט
כאַפּן	כ אַ פּ ן
כאַפּעניש	כ אַ פּ ע נ י ש
כאָטש	כ אָ ט ש
כאָליערע	כ אָ ל י ע ר ע
כאָלערע	כ אָ ל ע ר ע
כאָרכלעניש	כ אָ ר כ ל ע נ י ש
ל	ל
לא	ל א
לאבל	ל א ב ל
לאה	ל א ה
לאזן	ל א ז ן
לאחדימניצעס	ל א ח ד י מ נ י צ ע ס
לבטלה	ל ב ט ל ה
לדוגמא	ל ד ו ג מ א
לה	ל ה
להבדיל	ל ה ב ד י ל
להוט	ל ה ו ט
להחתן	ל ה ח ת ן
להכעיס	ל ה כ ע י ס
להם	ל ה ם
להבֿדיל	ל ה בֿ ד י ל
להבֿה	ל ה בֿ ה
לובלין	ל ו ב ל י ן
לובלינערס	ל ו ב ל י נ ע ר ס
לומדות	ל ו מ ד ו ת
לומדים	ל ו מ ד י ם
לונג־און־לעבערס	ל ו נ ג ־ א ו ן ־ ל ע ב ע ר ס
לונגלעך	ל ו נ ג ל ע ך
לונגען	ל ו נ ג ע ן
לוסטיקער	ל ו ס ט י ק ע ר
לועג	ל ו ע ג
לופֿט	ל ו פֿ ט
לופֿטן	ל ו פֿ ט ן
לחכמים	ל ח כ מ י ם
לחלוטין	ל ח ל ו ט י ן
לחם	ל ח ם
לחתום	ל ח ת ו ם
לחײם	ל ח ײ ם
ליב	ל י ב
ליבן	ל י ב ן
ליבע	ל י ב ע
ליבער	ל י ב ע ר
ליבערשט	ל י ב ע ר ש ט
ליבשאַפֿט	ל י ב ש אַ פֿ ט
ליגט	ל י ג ט
ליגן	ל י ג ן
ליגנער	ל י ג נ ע ר
ליגנערס	ל י ג נ ע ר ס
ליד	ל י ד
לידל	ל י ד ל
לידלעך	ל י ד ל ע ך
לידער	ל י ד ע ר
ליהודעם	ל י ה ו ד ע ם
ליולקע	ל י ו ל ק ע
ליטע	ל י ט ע
ליטװאַק	ל י ט װ אַ ק
ליטװאַקעס	ל י ט װ אַ ק ע ס
ליכט	ל י כ ט
ליכטיק	ל י כ ט י ק
ליכטיקן	ל י כ ט י ק ן
ליכטיקער	ל י כ ט י ק ע ר
ליכטיקײט	ל י כ ט י ק ײ ט
לינדע	ל י נ ד ע
לינקס	ל י נ ק ס
לינקע	ל י נ ק ע
לינקער	ל י נ ק ע ר
ליסט	ל י ס ט
ליציטירט	ל י צ י ט י ר ט
ליאַדע	ל י אַ ד ע
ליאַרעם	ל י אַ ר ע ם
ליאַפּעס	ל י אַ פּ ע ס
ליפּן	ל י פּ ן
ליפּעס	ל י פּ ע ס
לכל	ל כ ל
למאי	ל מ א י
למדן	ל מ ד ן
למוד	ל מ ו ד
למות	ל מ ו ת
למען	ל מ ע ן
למעריבֿ	ל מ ע ר י בֿ
למאַי	ל מ אַ י
לנו	ל נ ו
לסוף	ל ס ו ף
לעב	ל ע ב
לעבט	ל ע ב ט
לעבן	ל ע ב ן
לעבסט	ל ע ב ס ט
לעבעדיק	ל ע ב ע ד י ק
לעבעדיקע	ל ע ב ע ד י ק ע
לעבעדיקער	ל ע ב ע ד י ק ע ר
לעבעדיקערהײט	ל ע ב ע ד י ק ע ר ה ײ ט
לעגאַליזירט	ל ע ג אַ ל י ז י ר ט
לעדערנעם	ל ע ד ע ר נ ע ם
לעולם	ל ע ו ל ם
לעטשלעך	ל ע ט ש ל ע ך
לעיר	ל ע י ר
לעכל	ל ע כ ל
לעכלעך	ל ע כ ל ע ך
לעכערדיקן	ל ע כ ע ר ד י ק ן
לעמבערג	ל ע מ ב ע ר ג
לעמבעריק	ל ע מ ב ע ר י ק
לעמל	ל ע מ ל
לענג	ל ע נ ג
לענגער	ל ע נ ג ע ר
לענגערע	ל ע נ ג ע ר ע
לענדן	ל ע נ ד ן
לענדער	ל ע נ ד ע ר
לענט	ל ע נ ט
לעסינג	ל ע ס י נ ג
לעצטן	ל ע צ ט ן
לעצטנס	ל ע צ ט נ ס
לעצטע	ל ע צ ט ע
לעצטער	ל ע צ ט ע ר
לעק	ל ע ק
לעקיש	ל ע ק י ש
לעקישבערן	ל ע ק י ש ב ע ר ן
לעקעך	ל ע ק ע ך
לער	ל ע ר
לערן	ל ע ר ן
לערנט	ל ע ר נ ט
לערנען	ל ע ר נ ע ן
לערניִינגל	ל ע ר נ יִ י נ ג ל
לערער	ל ע ר ע ר
לעשן	ל ע ש ן
לעפֿצן	ל ע פֿ צ ן
לץ	ל ץ
לצים	ל צ י ם
לצלן	ל צ ל ן
לצנות	ל צ נ ו ת
לקדושת	ל ק ד ו ש ת
לרובֿ	ל ר ו בֿ
לרש	ל ר ש
לשבת	ל ש ב ת
לשון	ל ש ו ן
לשון־קודש	ל ש ו ן ־ ק ו ד ש
לשון־קודש־װאָרט	ל ש ו ן ־ ק ו ד ש ־ װ אָ ר ט
לשון־קודשיסטן	ל ש ו ן ־ ק ו ד ש י ס ט ן
לשלום	ל ש ל ו ם
לװיה	ל װ י ה
לװיה־גײערקע	ל װ י ה ־ ג ײ ע ר ק ע
לױ	ל ױ
לױ־יצחק	ל ױ ־ י צ ח ק
לױב	ל ױ ב
לױבן	ל ױ ב ן
לױט	ל ױ ט
לױן	ל ױ ן
לױנט	ל ױ נ ט
לױף	ל ױ ף
לױתן	ל ױ ת ן
לױפֿט	ל ױ פֿ ט
לױפֿן	ל ױ פֿ ן
לױפֿסט	ל ױ פֿ ס ט
לױפֿערס	ל ױ פֿ ע ר ס
לײב	ל ײ ב
לײבוש	ל ײ ב ו ש
לײבן	ל ײ ב ן
לײג	ל ײ ג
לײגט	ל ײ ג ט
לײגן	ל ײ ג ן
לײגסט	ל ײ ג ס ט
לײדיק	ל ײ ד י ק
לײזונג	ל ײ ז ו נ ג
לײזער	ל ײ ז ע ר
לײזער־יוסל	ל ײ ז ע ר ־ י ו ס ל
לײזער־יוסלן	ל ײ ז ע ר ־ י ו ס ל ן
לײזער־יוסלען	ל ײ ז ע ר ־ י ו ס ל ע ן
לײמען	ל ײ מ ע ן
לײענט	ל ײ ע נ ט
לײענען	ל ײ ע נ ע ן
לײקענען	ל ײ ק ע נ ע ן
לײַב	ל ײַ ב
לײַבוש	ל ײַ ב ו ש
לײַבל	ל ײַ ב ל
לײַדט	ל ײַ ד ט
לײַדן	ל ײַ ד ן
לײַט	ל ײַ ט
לײַטזעליקע	ל ײַ ט ז ע ל י ק ע
לײַטזעליקײט	ל ײַ ט ז ע ל י ק ײ ט
לײַטישן	ל ײַ ט י ש ן
לײַטישע	ל ײַ ט י ש ע
לײַטישער	ל ײַ ט י ש ע ר
לײַטן	ל ײַ ט ן
לײַטס	ל ײַ ט ס
לײַכט	ל ײַ כ ט
לײַכטער	ל ײַ כ ט ע ר
לײַװנטענע	ל ײַ װ נ ט ע נ ע
לײַפּציג	ל ײַ פּ צ י ג
לאַבן	ל אַ ב ן
לאַטע	ל אַ ט ע
לאַטקע	ל אַ ט ק ע
לאַך	ל אַ ך
לאַכט	ל אַ כ ט
לאַכן	ל אַ כ ן
לאַכסט	ל אַ כ ס ט
לאַכען	ל אַ כ ע ן
לאַמבאָרי	ל אַ מ ב אָ ר י
לאַנג	ל אַ נ ג
לאַנגלעכע	ל אַ נ ג ל ע כ ע
לאַנגן	ל אַ נ ג ן
לאַנגע	ל אַ נ ג ע
לאַנגען	ל אַ נ ג ע ן
לאַנגער	ל אַ נ ג ע ר
לאַנגװײַליק	ל אַ נ ג װ ײַ ל י ק
לאַסט	ל אַ ס ט
לאָגיש	ל אָ ג י ש
לאָדזש	ל אָ ד ז ש
לאָדן	ל אָ ד ן
לאָדנטיש	ל אָ ד נ ט י ש
לאָז	ל אָ ז
לאָזט	ל אָ ז ט
לאָזן	ל אָ ז ן
לאָזסטו	ל אָ ז ס ט ו
לאָך	ל אָ ך
לאָם	ל אָ ם
לאָמיך	ל אָ מ י ך
לאָמיר	ל אָ מ י ר
לאָנדאָן	ל אָ נ ד אָ ן
לאָסט	ל אָ ס ט
לאָקשן	ל אָ ק ש ן
לאָרד	ל אָ ר ד
לאָשעק	ל אָ ש ע ק
לכּבֿוד	ל כּ בֿ ו ד
לבֿיתו	ל בֿ י ת ו
לבֿנה	ל בֿ נ ה
מ'איז	מ ' א י ז
מ'בלײַבט	מ ' ב ל ײַ ב ט
מ'גײט	מ ' ג ײ ט
מ'האָט	מ ' ה אָ ט
מ'זעט	מ ' ז ע ט
מ'זאָל	מ ' ז אָ ל
מ'לערנט	מ ' ל ע ר נ ט
מ'לײענט	מ ' ל ײ ע נ ט
מ'מײנט	מ ' מ ײ נ ט
מ'מאַכט	מ ' מ אַ כ ט
מ'קען	מ ' ק ע ן
מ'קאָן	מ ' ק אָ ן
מ'רופֿט	מ ' ר ו פֿ ט
מ'שלעפּט	מ ' ש ל ע פּ ט
מ'שמעקט	מ ' ש מ ע ק ט
מ'װעט	מ ' װ ע ט
מ'פֿאַרגעסט	מ ' פֿ אַ ר ג ע ס ט
מ־ל־ך	מ ־ ל ־ ך
מאה	מ א ה
מאושטשינע	מ א ו ש ט ש י נ ע
מאיר	מ א י ר
מאכל	מ א כ ל
מאמרים	מ א מ ר י ם
מאסף	מ א ס ף
מבטיח	מ ב ט י ח
מג'	מ ג '
מגולגל	מ ג ו ל ג ל
מגיד	מ ג י ד
מגן־דודל	מ ג ן ־ ד ו ד ל
מגרש	מ ג ר ש
מגפֿה	מ ג פֿ ה
מדבריות	מ ד ב ר י ו ת
מדינה	מ ד י נ ה
מדינות	מ ד י נ ו ת
מדרגה	מ ד ר ג ה
מדרש	מ ד ר ש
מה־יעשהניק	מ ה ־ י ע ש ה נ י ק
מה־יפֿית	מ ה ־ י פֿ י ת
מהדר	מ ה ד ר
מהומה	מ ה ו מ ה
מהכתּיתי	מ ה כ תּ י ת י
מהלך	מ ה ל ך
מודה	מ ו ד ה
מוהל	מ ו ה ל
מוז	מ ו ז
מוזט	מ ו ז ט
מוזינקע	מ ו ז י נ ק ע
מוזיק	מ ו ז י ק
מוזן	מ ו ז ן
מוח	מ ו ח
מוחות	מ ו ח ו ת
מוחל	מ ו ח ל
מוטער	מ ו ט ע ר
מוטערס	מ ו ט ע ר ס
מוטשעט	מ ו ט ש ע ט
מוכיח	מ ו כ י ח
מוכר־ספֿרים	מ ו כ ר ־ ס פֿ ר י ם
מוכר־ספֿרימניק	מ ו כ ר ־ ס פֿ ר י מ נ י ק
מולטערס	מ ו ל ט ע ר ס
מומע	מ ו מ ע
מוסף	מ ו ס ף
מוסר	מ ו ס ר
מוסר־ספרים	מ ו ס ר ־ ס פ ר י ם
מוסרט	מ ו ס ר ט
מוקצה	מ ו ק צ ה
מורא	מ ו ר א
מוראדיק	מ ו ר א ד י ק
מוראדיקער	מ ו ר א ד י ק ע ר
מורה־הוראה	מ ו ר ה ־ ה ו ר א ה
מורמל	מ ו ר מ ל
מורמלט	מ ו ר מ ל ט
מופֿט	מ ו פֿ ט
מזג־טובֿ	מ ז ג ־ ט ו בֿ
מזוזה	מ ז ו ז ה
מזומנים	מ ז ו מ נ י ם
מזל	מ ז ל
מזל־טוב	מ ז ל ־ ט ו ב
מזל־טובֿ	מ ז ל ־ ט ו בֿ
מזלדיק	מ ז ל ד י ק
מזלדיקע	מ ז ל ד י ק ע
מזלדיקער	מ ז ל ד י ק ע ר
מזרח־װאַנט	מ ז ר ח ־ װ אַ נ ט
מחבר	מ ח ב ר
מחדש	מ ח ד ש
מחותּן	מ ח ו תּ ן
מחותּנים	מ ח ו תּ נ י ם
מחיה	מ ח י ה
מחיהדיקער	מ ח י ה ד י ק ע ר
מחילה	מ ח י ל ה
מחמת	מ ח מ ת
מחנה	מ ח נ ה
מחנות	מ ח נ ו ת
מחשבות	מ ח ש ב ו ת
מחױב	מ ח ױ ב
מחױבֿ	מ ח ױ בֿ
מטבע	מ ט ב ע
מטופּל	מ ט ו פּ ל
מטמון	מ ט מ ו ן
מטריח	מ ט ר י ח
מי	מ י
מי־יודע	מ י ־ י ו ד ע
מיאוס	מ י א ו ס
מיאוסן	מ י א ו ס ן
מיאוסע	מ י א ו ס ע
מיאוסער	מ י א ו ס ע ר
מיאש	מ י א ש
מיד	מ י ד
מידה	מ י ד ה
מידע	מ י ד ע
מידער	מ י ד ע ר
מיוחס	מ י ו ח ס
מיוחסים	מ י ו ח ס י ם
מיזרח	מ י ז ר ח
מיט	מ י ט
מיטגעגעבן	מ י ט ג ע ג ע ב ן
מיטגעלאַכט	מ י ט ג ע ל אַ כ ט
מיטגענומען	מ י ט ג ע נ ו מ ע ן
מיטגעפֿאַסט	מ י ט ג ע פֿ אַ ס ט
מיטה	מ י ט ה
מיטינג	מ י ט י נ ג
מיטל־יאָריקער	מ י ט ל ־ י אָ ר י ק ע ר
מיטל־װוּקסיק	מ י ט ל ־ װ וּ ק ס י ק
מיטלסטן	מ י ט ל ס ט ן
מיטן	מ י ט ן
מיטנעמען	מ י ט נ ע מ ע ן
מיטצוגעבן	מ י ט צ ו ג ע ב ן
מיטשװײַגן	מ י ט ש װ ײַ ג ן
מיטאָג	מ י ט אָ ג
מיך	מ י ך
מיל	מ י ל
מילא	מ י ל א
מיליאָן	מ י ל י אָ ן
מיליאָנען	מ י ל י אָ נ ע ן
מילך	מ י ל ך
מילכיקס	מ י ל כ י ק ס
מילן	מ י ל ן
מילנער	מ י ל נ ע ר
מים	מ י ם
מין	מ י ן
מינוט	מ י נ ו ט
מינחה	מ י נ ח ה
מינטערט	מ י נ ט ע ר ט
מינע	מ י נ ע
מיסחר	מ י ס ח ר
מיסחרים	מ י ס ח ר י ם
מיצקע	מ י צ ק ע
מיצװה	מ י צ װ ה
מיצװה־טענצל	מ י צ װ ה ־ ט ע נ צ ל
מיקװאות	מ י ק װ א ו ת
מיר	מ י ר
מיר'ן	מ י ר ' ן
מירן	מ י ר ן
מישט	מ י ש ט
מישטײנס	מ י ש ט ײ נ ס
מישן	מ י ש ן
מישענינע	מ י ש ע נ י נ ע
מישפּט	מ י ש פּ ט
מישפּטן	מ י ש פּ ט ן
מישבֿ	מ י ש בֿ
מיתה	מ י ת ה
מיתה־משונה	מ י ת ה ־ מ ש ו נ ה
מכבד	מ כ ב ד
מכתבֿ	מ כ ת בֿ
מל	מ ל
מלא	מ ל א
מלא־טעם	מ ל א ־ ט ע ם
מלאך	מ ל א ך
מלאך־מליץ	מ ל א ך ־ מ ל י ץ
מלאכה	מ ל א כ ה
מלאכות	מ ל א כ ו ת
מלאכים	מ ל א כ י ם
מלבוש	מ ל ב ו ש
מלבושים	מ ל ב ו ש י ם
מלוכה	מ ל ו כ ה
מלחמה	מ ל ח מ ה
מלחמות	מ ל ח מ ו ת
מליץ	מ ל י ץ
מליץ־יושר	מ ל י ץ ־ י ו ש ר
מלך	מ ל ך
מלמד	מ ל מ ד
מלמדות	מ ל מ ד ו ת
מלמדים	מ ל מ ד י ם
מלקות	מ ל ק ו ת
מלאָכה	מ ל אָ כ ה
מלאָכים	מ ל אָ כ י ם
מלאָכימלעך	מ ל אָ כ י מ ל ע ך
מלאָכימס	מ ל אָ כ י מ ס
מלכּה	מ ל כּ ה
ממה	מ מ ה
ממזריש	מ מ ז ר י ש
ממלא־מקומו	מ מ ל א ־ מ ק ו מ ו
ממש	מ מ ש
ממשות	מ מ ש ו ת
ממשלה	מ מ ש ל ה
מן	מ ן
מן־הסתּם	מ ן ־ ה ס תּ ם
מנהג־ישׂראל	מ נ ה ג ־ י שׂ ר א ל
מנורה	מ נ ו ר ה
מנחה	מ נ ח ה
מנחה'לע	מ נ ח ה ' ל ע
מנחת	מ נ ח ת
מנין	מ נ י ן
מנינים	מ נ י נ י ם
מניעה	מ נ י ע ה
מניעות	מ נ י ע ו ת
מסוגל	מ ס ו ג ל
מסופּק	מ ס ו פּ ק
מסחר	מ ס ח ר
מסחרים	מ ס ח ר י ם
מסירהלע	מ ס י ר ה ל ע
מסירות־נפֿש	מ ס י ר ו ת ־ נ פֿ ש
מסכתּא	מ ס כ תּ א
מסלק	מ ס ל ק
מסרט	מ ס ר ט
מסכּים	מ ס כּ י ם
מספּיד	מ ס פּ י ד
מסתּמא	מ ס תּ מ א
מסתּמה	מ ס תּ מ ה
מע	מ ע
מעג	מ ע ג
מעגט	מ ע ג ט
מעגלעך	מ ע ג ל ע ך
מעגלעכקײַט	מ ע ג ל ע כ ק ײַ ט
מעגן	מ ע ג ן
מעדיצין	מ ע ד י צ י ן
מעטאַל	מ ע ט אַ ל
מעיו	מ ע י ו
מעיר	מ ע י ר
מעכטיקע	מ ע כ ט י ק ע
מעל	מ ע ל
מעל־געשעפֿט	מ ע ל ־ ג ע ש ע פֿ ט
מעלה	מ ע ל ה
מעלה־גירהן	מ ע ל ה ־ ג י ר ה ן
מעלות	מ ע ל ו ת
מען	מ ע ן
מענדל	מ ע נ ד ל
מענדעלע	מ ע נ ד ע ל ע
מענדעלען	מ ע נ ד ע ל ע ן
מענטש	מ ע נ ט ש
מענטשל	מ ע נ ט ש ל
מענטשלעך	מ ע נ ט ש ל ע ך
מענטשלעכער	מ ע נ ט ש ל ע כ ע ר
מענטשן	מ ע נ ט ש ן
מעסט	מ ע ס ט
מעסער	מ ע ס ע ר
מעקלער	מ ע ק ל ע ר
מעקסיקע	מ ע ק ס י ק ע
מער	מ ע ר
מעריבֿ	מ ע ר י בֿ
מערן	מ ע ר ן
מערסטן	מ ע ר ס ט ן
מערצעשעם	מ ע ר צ ע ש ע ם
מערקט	מ ע ר ק ט
מערבֿ־װאַנט	מ ע ר בֿ ־ װ אַ נ ט
מעש	מ ע ש
מעשה	מ ע ש ה
מעשענע	מ ע ש ע נ ע
מעת־לעת	מ ע ת ־ ל ע ת
מעשׂה	מ ע שׂ ה
מעשׂה־ביכל	מ ע שׂ ה ־ ב י כ ל
מעשׂה־ביכלעך	מ ע שׂ ה ־ ב י כ ל ע ך
מעשׂה־דאָקטאָר	מ ע שׂ ה ־ ד אָ ק ט אָ ר
מעשׂה־חוזק	מ ע שׂ ה ־ ח ו ז ק
מעשׂה־שרײַבער	מ ע שׂ ה ־ ש ר ײַ ב ע ר
מעשׂהלעך	מ ע שׂ ה ל ע ך
מעשׂיות	מ ע שׂ י ו ת
מעשׂים	מ ע שׂ י ם
מעבֿיר	מ ע בֿ י ר
מעבֿר	מ ע בֿ ר
מצה־שמורה	מ צ ה ־ ש מ ו ר ה
מצה־װאַסער	מ צ ה ־ װ אַ ס ע ר
מצוה	מ צ ו ה
מציאה	מ צ י א ה
מציאות	מ צ י א ו ת
מציל	מ צ י ל
מצרים	מ צ ר י ם
מצװה	מ צ װ ה
מצבֿה	מ צ בֿ ה
מקבל	מ ק ב ל
מקובל	מ ק ו ב ל
מקום	מ ק ו ם
מקום־מנוחה	מ ק ו ם ־ מ נ ו ח ה
מקום־קדוש	מ ק ו ם ־ ק ד ו ש
מקנא	מ ק נ א
מקײם	מ ק ײ ם
מרבין	מ ר ב י ן
מרה־שחורה	מ ר ה ־ ש ח ו ר ה
מרושע	מ ר ו ש ע
מרחם	מ ר ח ם
מרחץ	מ ר ח ץ
מרשעת	מ ר ש ע ת
משבת	מ ש ב ת
משגיח	מ ש ג י ח
משה	מ ש ה
משה־װעלװל	מ ש ה ־ װ ע ל װ ל
משה־װעלװלען	מ ש ה ־ װ ע ל װ ל ע ן
משוגע	מ ש ו ג ע
משוגעים	מ ש ו ג ע י ם
משוגענע	מ ש ו ג ע נ ע
משוגענער	מ ש ו ג ע נ ע ר
משוגעת	מ ש ו ג ע ת
משוגעתן	מ ש ו ג ע ת ן
משולח	מ ש ו ל ח
משומד	מ ש ו מ ד
משונה	מ ש ו נ ה
משונהדיקער	מ ש ו נ ה ד י ק ע ר
משוררים	מ ש ו ר ר י ם
משטײנס	מ ש ט ײ נ ס
משיח	מ ש י ח
משיחו	מ ש י ח ו
משיחן	מ ש י ח ן
משל	מ ש ל
משלים	מ ש ל י ם
משלים־שרײַבערס	מ ש ל י ם ־ ש ר ײַ ב ע ר ס
משמש	מ ש מ ש
משניות	מ ש נ י ו ת
משקה	מ ש ק ה
משרת	מ ש ר ת
מששת	מ ש ש ת
משפּחה	מ ש פּ ח ה
משפּט	מ ש פּ ט
מת	מ ת
מתוקן	מ ת ו ק ן
מתיקות	מ ת י ק ו ת
מתנגד	מ ת נ ג ד
מתנגדים	מ ת נ ג ד י ם
מתנגדישע	מ ת נ ג ד י ש ע
מתעסק	מ ת ע ס ק
מתפּלל	מ ת פּ ל ל
מױד	מ ױ ד
מױדן	מ ױ ד ן
מױל	מ ױ ל
מױער	מ ױ ע ר
מױערל	מ ױ ע ר ל
מױערן	מ ױ ע ר ן
מײדל	מ ײ ד ל
מײדלס	מ ײ ד ל ס
מײדלעך	מ ײ ד ל ע ך
מײדן	מ ײ ד ן
מײדעלע	מ ײ ד ע ל ע
מײטשיק	מ ײ ט ש י ק
מײן	מ ײ ן
מײנונג	מ ײ נ ו נ ג
מײנט	מ ײ נ ט
מײנסט	מ ײ נ ס ט
מײנען	מ ײ נ ע ן
מײעץ	מ ײ ע ץ
מײק	מ ײ ק
מײשבֿ	מ ײ ש בֿ
מײַז	מ ײַ ז
מײַל	מ ײַ ל
מײַלן	מ ײַ ל ן
מײַלער	מ ײַ ל ע ר
מײַן	מ ײַ ן
מײַנס	מ ײַ נ ס
מײַנע	מ ײַ נ ע
מײַנעם	מ ײַ נ ע ם
מײַנער	מ ײַ נ ע ר
מײַסטערס	מ ײַ ס ט ע ר ס
משׂא	מ שׂ א
משׂמח	מ שׂ מ ח
מאַטערניש	מ אַ ט ע ר נ י ש
מאַך	מ אַ ך
מאַכט	מ אַ כ ט
מאַכן	מ אַ כ ן
מאַכאָרקע	מ אַ כ אָ ר ק ע
מאַלע	מ אַ ל ע
מאַלאָרוסיש	מ אַ ל אָ ר ו ס י ש
מאַמע	מ אַ מ ע
מאַמע־לשון	מ אַ מ ע ־ ל ש ו ן
מאַמען	מ אַ מ ע ן
מאַמעס	מ אַ מ ע ס
מאַן	מ אַ ן
מאַנוסקריפּט	מ אַ נ ו ס ק ר י פּ ט
מאַנופֿאַקטור־סוחר	מ אַ נ ו פֿ אַ ק ט ו ר ־ ס ו ח ר
מאַניפֿאָרגע	מ אַ נ י פֿ אָ ר ג ע
מאַנס	מ אַ נ ס
מאַנסביל	מ אַ נ ס ב י ל
מאַנסלײַט	מ אַ נ ס ל ײַ ט
מאַנעװרעס	מ אַ נ ע װ ר ע ס
מאַסקװיטעריש	מ אַ ס ק װ י ט ע ר י ש
מאַסאַזש	מ אַ ס אַ ז ש
מאַרך־בײן	מ אַ ר ך ־ ב ײ ן
מאַרצעפּאַנעס	מ אַ ר צ ע פּ אַ נ ע ס
מאַרק	מ אַ ר ק
מאַרקאָװיטש	מ אַ ר ק אָ װ י ט ש
מאַרקאָװיטשן	מ אַ ר ק אָ װ י ט ש ן
מאַרשירט	מ אַ ר ש י ר ט
מאַשין	מ אַ ש י ן
מאַשינעס	מ אַ ש י נ ע ס
מאָגן	מ אָ ג ן
מאָגן־שטערונג	מ אָ ג ן ־ ש ט ע ר ו נ ג
מאָגער	מ אָ ג ע ר
מאָדנע	מ אָ ד נ ע
מאָדנעם	מ אָ ד נ ע ם
מאָדנער	מ אָ ד נ ע ר
מאָדע	מ אָ ד ע
מאָטיװן	מ אָ ט י װ ן
מאָל	מ אָ ל
מאָלט	מ אָ ל ט
מאָלן	מ אָ ל ן
מאָנט	מ אָ נ ט
מאָנטיק	מ אָ נ ט י ק
מאָנען	מ אָ נ ע ן
מאָנענדיק	מ אָ נ ע נ ד י ק
מאָנאָלאָג	מ אָ נ אָ ל אָ ג
מאָס	מ אָ ס
מאָסקװע	מ אָ ס ק װ ע
מאָרגן	מ אָ ר ג ן
מאָרגנס	מ אָ ר ג נ ס
מאָרגנשטערן	מ אָ ר ג נ ש ט ע ר ן
מאָרדע	מ אָ ר ד ע
מאָראַל	מ אָ ר אַ ל
מכּה	מ כּ ה
מכּות	מ כּ ו ת
מכּח	מ כּ ח
מכּשפֿה	מ כּ ש פֿ ה
מפּי	מ פּ י
מפּלה	מ פּ ל ה
מפּני	מ פּ נ י
מתּנה	מ תּ נ ה
מתּנות	מ תּ נ ו ת
מבֿולבלער	מ בֿ ו ל ב ל ע ר
מבֿטיח	מ בֿ ט י ח
מבֿינות	מ בֿ י נ ו ת
מבֿינים	מ בֿ י נ י ם
מפֿטיר	מ פֿ ט י ר
מפֿקיר	מ פֿ ק י ר
מפֿרשים	מ פֿ ר ש י ם
ן	ן
נ־א־מ־ן	נ ־ א ־ מ ־ ן
נאמן	נ א מ ן
נגיד	נ ג י ד
נגידים	נ ג י ד י ם
נגידס	נ ג י ד ס
נדן	נ ד ן
נדרים	נ ד ר י ם
נדבֿה	נ ד בֿ ה
נדבֿות	נ ד בֿ ו ת
נו	נ ו
נודנע	נ ו ד נ ע
נודעט	נ ו ד ע ט
נוהג	נ ו ה ג
נון	נ ו ן
נוצלעכקײט	נ ו צ ל ע כ ק ײ ט
נור	נ ו ר
נוראים	נ ו ר א י ם
נח	נ ח
נחת	נ ח ת
ניגון	נ י ג ו ן
ניגונים	נ י ג ו נ י ם
נידער	נ י ד ע ר
ניונקעלע	נ י ו נ ק ע ל ע
ניט	נ י ט
ניט־פֿאַר	נ י ט ־ פֿ אַ ר
ניטאָ	נ י ט אָ
ניכטער	נ י כ ט ע ר
נימאַנד	נ י מ אַ נ ד
ניס	נ י ס
ניסן	נ י ס ן
ניסתּר	נ י ס תּ ר
ניקעלסבורג	נ י ק ע ל ס ב ו ר ג
ניקעלסבורגער	נ י ק ע ל ס ב ו ר ג ע ר
ניקאָלײַעװסקער	נ י ק אָ ל ײַ ע װ ס ק ע ר
ניר	נ י ר
נישט	נ י ש ט
נישט־גוטע	נ י ש ט ־ ג ו ט ע
נישט־גוטער	נ י ש ט ־ ג ו ט ע ר
נישט־געשטױגענע	נ י ש ט ־ ג ע ש ט ױ ג ע נ ע
נישט־טױט	נ י ש ט ־ ט ױ ט
נישט־לעבעדיק	נ י ש ט ־ ל ע ב ע ד י ק
נישט־פֿאַרגינערס	נ י ש ט ־ פֿ אַ ר ג י נ ע ר ס
נישטאָ	נ י ש ט אָ
נישמער	נ י ש מ ע ר
נישקשה	נ י ש ק ש ה
נישקשהדיק	נ י ש ק ש ה ד י ק
נישקשהדיקע	נ י ש ק ש ה ד י ק ע
ניבֿהל	נ י בֿ ה ל
ניפֿטר	נ י פֿ ט ר
נכבדים	נ כ ב ד י ם
נמלט	נ מ ל ט
ננתּקה	נ נ תּ ק ה
נס	נ ס
נסים	נ ס י ם
נסיעה	נ ס י ע ה
נע	נ ע
נע־ונד	נ ע ־ ו נ ד
נעבן	נ ע ב ן
נעבעך	נ ע ב ע ך
נעגל	נ ע ג ל
נעגל־	נ ע ג ל ־
נעגעלעך	נ ע ג ע ל ע ך
נעדאָיעד	נ ע ד אָ י ע ד
נעז	נ ע ז
נעילה	נ ע י ל ה
נעכט	נ ע כ ט
נעכטיקן	נ ע כ ט י ק ן
נעכטיקער	נ ע כ ט י ק ע ר
נעכטן	נ ע כ ט ן
נעכע	נ ע כ ע
נעלם	נ ע ל ם
נעלסאָן	נ ע ל ס אָ ן
נעם	נ ע ם
נעמט	נ ע מ ט
נעמיראָװער	נ ע מ י ר אָ װ ע ר
נעמסט	נ ע מ ס ט
נעמען	נ ע מ ע ן
נענטער	נ ע נ ט ע ר
נעץ	נ ע ץ
נעקסטן	נ ע ק ס ט ן
נערװן	נ ע ר װ ן
נערװען	נ ע ר װ ע ן
נצחון	נ צ ח ו ן
נקמה	נ ק מ ה
נקבֿה	נ ק בֿ ה
נשמה	נ ש מ ה
נשמתו	נ ש מ ת ו
נתבקש	נ ת ב ק ש
נױט	נ ױ ט
נױטיקן	נ ױ ט י ק ן
נױטיקע	נ ױ ט י ק ע
נױטן	נ ױ ט ן
נײ	נ ײ
נײט	נ ײ ט
נײטיק	נ ײ ט י ק
נײטיקע	נ ײ ט י ק ע
נײטיקערע	נ ײ ט י ק ע ר ע
נײטאָרין	נ ײ ט אָ ר י ן
נײן	נ ײ ן
נײען	נ ײ ע ן
ניִט	נ יִ ט
נײַ	נ ײַ
נײַ־געבױרענעם	נ ײַ ־ ג ע ב ױ ר ע נ ע ם
נײַגעריק	נ ײַ ג ע ר י ק
נײַן	נ ײַ ן
נײַס	נ ײַ ס
נײַע	נ ײַ ע
נײַעם	נ ײַ ע ם
נײַער	נ ײַ ע ר
נײַערט	נ ײַ ע ר ט
נאַ	נ אַ
נאַט	נ אַ ט
נאַטור	נ אַ ט ו ר
נאַיס	נ אַ י ס
נאַכט	נ אַ כ ט
נאַכטייִדן	נ אַ כ ט י יִ ד ן
נאַכטיִיד	נ אַ כ ט יִ י ד
נאַכטיִידן	נ אַ כ ט יִ י ד ן
נאַס	נ אַ ס
נאַסער	נ אַ ס ע ר
נאַציאָן	נ אַ צ י אָ ן
נאַקידקע	נ אַ ק י ד ק ע
נאַקעט	נ אַ ק ע ט
נאַקעטן	נ אַ ק ע ט ן
נאַרישע	נ אַ ר י ש ע
נאַרישער	נ אַ ר י ש ע ר
נאַרישקײט	נ אַ ר י ש ק ײ ט
נאַרישקײטן	נ אַ ר י ש ק ײ ט ן
נאַראָנים	נ אַ ר אָ נ י ם
נאַפֿטלעמפּל	נ אַ פֿ ט ל ע מ פּ ל
נאָגנדיק	נ אָ ג נ ד י ק
נאָדל	נ אָ ד ל
נאָדל־פֿאָדים	נ אָ ד ל ־ פֿ אָ ד י ם
נאָדלען	נ אָ ד ל ע ן
נאָז	נ אָ ז
נאָטיץ־ביכל	נ אָ ט י ץ ־ ב י כ ל
נאָטע	נ אָ ט ע
נאָטעס	נ אָ ט ע ס
נאָך	נ אָ ך
נאָכגעבן	נ אָ כ ג ע ב ן
נאָכגעגעבן	נ אָ כ ג ע ג ע ב ן
נאָכגעזאָגט	נ אָ כ ג ע ז אָ ג ט
נאָכגעטראַכט	נ אָ כ ג ע ט ר אַ כ ט
נאָכגעלאָפֿן	נ אָ כ ג ע ל אָ פֿ ן
נאָכגעקוקט	נ אָ כ ג ע ק ו ק ט
נאָכטאָן	נ אָ כ ט אָ ן
נאָכלױפֿן	נ אָ כ ל ױ פֿ ן
נאָכמיטאָג	נ אָ כ מ י ט אָ ג
נאָכן	נ אָ כ ן
נאָמור	נ אָ מ ו ר
נאָמען	נ אָ מ ע ן
נאָס	נ אָ ס
נאָסיק	נ אָ ס י ק
נאָענטע	נ אָ ע נ ט ע
נאָענסטע	נ אָ ע נ ס ט ע
נאָר	נ אָ ר
נאָר־װאָס	נ אָ ר ־ װ אָ ס
נאָװינע	נ אָ װ י נ ע
נבֿלה	נ בֿ ל ה
נפֿלאה	נ פֿ ל א ה
נפֿש	נ פֿ ש
נפֿשות	נ פֿ ש ו ת
נפֿשך	נ פֿ ש ך
ס	ס
ס'איז	ס ' א י ז
ס'אײגענע	ס ' א ײ ג ע נ ע
ס'געלינגט	ס ' ג ע ל י נ ג ט
ס'גײט	ס ' ג ײ ט
ס'גאַנצע	ס ' ג אַ נ צ ע
ס'דאַרף	ס ' ד אַ ר ף
ס'הױז	ס ' ה ױ ז
ס'האַלט	ס ' ה אַ ל ט
ס'האָבן	ס ' ה אָ ב ן
ס'האָט	ס ' ה אָ ט
ס'זענען	ס ' ז ע נ ע ן
ס'זאָל	ס ' ז אָ ל
ס'טוט	ס ' ט ו ט
ס'טרעפֿט	ס ' ט ר ע פֿ ט
ס'טראָגט	ס ' ט ר אָ ג ט
ס'טאָגט	ס ' ט אָ ג ט
ס'ליגט	ס ' ל י ג ט
ס'מוזן	ס ' מ ו ז ן
ס'מאַכן	ס ' מ אַ כ ן
ס'קומט	ס ' ק ו מ ט
ס'קינד	ס ' ק י נ ד
ס'קלינגט	ס ' ק ל י נ ג ט
ס'קלעמט	ס ' ק ל ע מ ט
ס'קאָן	ס ' ק אָ ן
ס'קאָצל	ס ' ק אָ צ ל
ס'רופֿט	ס ' ר ו פֿ ט
ס'רעקל	ס ' ר ע ק ל
ס'שטעכט	ס ' ש ט ע כ ט
ס'שטײט	ס ' ש ט ײ ט
ס'שאַדט	ס ' ש אַ ד ט
ס'װעט	ס ' װ ע ט
ס'װערט	ס ' װ ע ר ט
ס'װױנט	ס ' װ ױ נ ט
ס'װאָלט	ס ' װ אָ ל ט
ס'װאָרט	ס ' װ אָ ר ט
ס'אַ	ס ' אַ
ס'אַרט	ס ' אַ ר ט
ס'אַראַ	ס ' אַ ר אַ
ס'פּנים	ס ' פּ נ י ם
ס'פּאָמעשאַף	ס ' פּ אָ מ ע ש אַ ף
ס'פֿלעגט	ס ' פֿ ל ע ג ט
סביבה	ס ב י ב ה
סדום	ס ד ו ם
סדור	ס ד ו ר
סדר	ס ד ר
סדר־העולם	ס ד ר ־ ה ע ו ל ם
סדרה	ס ד ר ה
סוד	ס ו ד
סוחר	ס ו ח ר
סוחרטע	ס ו ח ר ט ע
סוחרטעס	ס ו ח ר ט ע ס
סוחרים	ס ו ח ר י ם
סומע	ס ו מ ע
סוסים	ס ו ס י ם
סוף	ס ו ף
סוכּות	ס ו כּ ו ת
סחורה	ס ח ו ר ה
סחורות	ס ח ו ר ו ת
סחירות	ס ח י ר ו ת
סטיל	ס ט י ל
סטענגעס	ס ט ע נ ג ע ס
סטרא־אחראַ	ס ט ר א ־ א ח ר אַ
סטרונע	ס ט ר ו נ ע
סטראַשידלעס	ס ט ר אַ ש י ד ל ע ס
סטראַשן	ס ט ר אַ ש ן
סטראָזש	ס ט ר אָ ז ש
סטײשאָנערי	ס ט ײ ש אָ נ ע ר י
סטאַך	ס ט אַ ך
סטאַמבול	ס ט אַ מ ב ו ל
סטאַנציע	ס ט אַ נ צ י ע
סטאַר	ס ט אַ ר
סטאָדאָלע	ס ט אָ ד אָ ל ע
סיבה	ס י ב ה
סידור	ס י ד ו ר
סיז	ס י ז
סילוק	ס י ל ו ק
סילוקן	ס י ל ו ק ן
סימביר	ס י מ ב י ר
סימן	ס י מ ן
סימנים	ס י מ נ י ם
סימע	ס י מ ע
סימעס	ס י מ ע ס
סיני	ס י נ י
סינאַגאָגע	ס י נ אַ ג אָ ג ע
סיערמענגע	ס י ע ר מ ע נ ג ע
סירחה	ס י ר ח ה
סך	ס ך
סך־הכּל	ס ך ־ ה כּ ל
סכך	ס כ ך
סכסוך	ס כ ס ו ך
סלה	ס ל ה
סליחות	ס ל י ח ו ת
סליחות־צײַט	ס ל י ח ו ת ־ צ ײַ ט
סלעדאָװאַטל	ס ל ע ד אָ װ אַ ט ל
סם	ס ם
סמיכות	ס מ י כ ו ת
סמעטענע	ס מ ע ט ע נ ע
סמאָלע	ס מ אָ ל ע
סנאַסט	ס נ אַ ס ט
סע	ס ע
סעדעכע	ס ע ד ע כ ע
סעודה	ס ע ו ד ה
סעמעטערי	ס ע מ ע ט ע ר י
סענאַט	ס ע נ אַ ט
סענאַטאָרן	ס ע נ אַ ט אָ ר ן
סערל	ס ע ר ל
סערקעלע	ס ע ר ק ע ל ע
סצענע	ס צ ע נ ע
סקיצן	ס ק י צ ן
סקנער	ס ק נ ע ר
סקעפּטיציזם	ס ק ע פּ ט י צ י ז ם
סקעפּטיקערין	ס ק ע פּ ט י ק ע ר י ן
סקריפּען	ס ק ר י פּ ע ן
סױן	ס ױ ן
ס׳איז	ס ׳ א י ז
ס׳װעט	ס ׳ װ ע ט
סײַ	ס ײַ
סײַדן	ס ײַ ד ן
סאַליע	ס אַ ל י ע
סאַלאָן	ס אַ ל אָ ן
סאַמע	ס אַ מ ע
סאַמעט	ס אַ מ ע ט
סאַמעטענעם	ס אַ מ ע ט ע נ ע ם
סאַמעראָדנער	ס אַ מ ע ר אָ ד נ ע ר
סאַמאָװאַר	ס אַ מ אָ װ אַ ר
סאַנדאַלן	ס אַ נ ד אַ ל ן
סאַראַ	ס אַ ר אַ
סאָבראַניע	ס אָ ב ר אַ נ י ע
סאָבראַניעס	ס אָ ב ר אַ נ י ע ס
סאָלדאַט	ס אָ ל ד אַ ט
סאָלדאַטן	ס אָ ל ד אַ ט ן
סאָלדאַטסקע	ס אָ ל ד אַ ט ס ק ע
סאָלאָװײטשיק	ס אָ ל אָ װ ײ ט ש י ק
סאָרט	ס אָ ר ט
סאָרטירט	ס אָ ר ט י ר ט
סאָרטן	ס אָ ר ט ן
סכּנה	ס כּ נ ה
סכּנת־נפֿשות	ס כּ נ ת ־ נ פֿ ש ו ת
ספּעציאַליסט	ס פּ ע צ י אַ ל י ס ט
ספּעציאַלנאָסט	ס פּ ע צ י אַ ל נ אָ ס ט
ספּאָדיק־דרײער	ס פּ אָ ד י ק ־ ד ר ײ ע ר
סתּם	ס תּ ם
סבֿרא	ס בֿ ר א
סבֿרה	ס בֿ ר ה
ספֿר	ס פֿ ר
ספֿרדישע	ס פֿ ר ד י ש ע
ספֿרים	ס פֿ ר י ם
ספֿרים־שאַנק	ס פֿ ר י ם ־ ש אַ נ ק
ספֿרימלעך	ס פֿ ר י מ ל ע ך
ע	ע
עבר	ע ב ר
עברי־טײַטש	ע ב ר י ־ ט ײַ ט ש
עגונה	ע ג ו נ ה
עגלה	ע ג ל ה
עגמת־נפֿש	ע ג מ ת ־ נ פֿ ש
עד	ע ד
עד־היום	ע ד ־ ה י ו ם
עדה	ע ד ה
עדות	ע ד ו ת
עול	ע ו ל
עולם	ע ו ל ם
עולם־האמת	ע ו ל ם ־ ה א מ ת
עולם־הבא	ע ו ל ם ־ ה ב א
עולם־הזה	ע ו ל ם ־ ה ז ה
עולם־השקר	ע ו ל ם ־ ה ש ק ר
עוף	ע ו ף
עוקר	ע ו ק ר
עושר	ע ו ש ר
עופֿות	ע ו פֿ ו ת
עז	ע ז
עזות	ע ז ו ת
עזות־פּנים	ע ז ו ת ־ פּ נ י ם
עזות־פּנימער	ע ז ו ת ־ פּ נ י מ ע ר
עט	ע ט
עטינגער	ע ט י נ ג ע ר
עטינגערס	ע ט י נ ג ע ר ס
עטלעכן	ע ט ל ע כ ן
עטלעכע	ע ט ל ע כ ע
עטרות	ע ט ר ו ת
עין־הרע	ע י ן ־ ה ר ע
עיקר	ע י ק ר
עיר	ע י ר
עך	ע ך
על	ע ל
על־חטא	ע ל ־ ח ט א
על־פּי	ע ל ־ פּ י
עלטסטן	ע ל ט ס ט ן
עלטער	ע ל ט ע ר
עלטער־עלטער־זײדעס	ע ל ט ע ר ־ ע ל ט ע ר ־ ז ײ ד ע ס
עלטערזײדן	ע ל ט ע ר ז ײ ד ן
עלטערזײדנס	ע ל ט ע ר ז ײ ד נ ס
עלטערזײדע	ע ל ט ע ר ז ײ ד ע
עלטערן	ע ל ט ע ר ן
עלטערע	ע ל ט ע ר ע
עלטערער	ע ל ט ע ר ע ר
עליה	ע ל י ה
עליהם	ע ל י ה ם
עליכם	ע ל י כ ם
עלנבױגנס	ע ל נ ב ױ ג נ ס
עלנט	ע ל נ ט
עלנטע	ע ל נ ט ע
עלנטער	ע ל נ ט ע ר
עלעהײ	ע ל ע ה ײ
עלף	ע ל ף
עם	ע ם
עם־הארץ	ע ם ־ ה א ר ץ
עמבלעם	ע מ ב ל ע ם
עמוד	ע מ ו ד
עמיל	ע מ י ל
עמיץ	ע מ י ץ
עמיצן	ע מ י צ ן
עמיצער	ע מ י צ ע ר
עמעץ	ע מ ע ץ
עמעצן	ע מ ע צ ן
עמעצער	ע מ ע צ ע ר
עמער	ע מ ע ר
ענג	ע נ ג
ענגלישן	ע נ ג ל י ש ן
ענגלען	ע נ ג ל ע ן
ענגלענדער	ע נ ג ל ע נ ד ע ר
ענדיק	ע נ ד י ק
ענדיקט	ע נ ד י ק ט
ענדיקן	ע נ ד י ק ן
ענדלעך	ע נ ד ל ע ך
ענדערונג	ע נ ד ע ר ו נ ג
ענדערונגען	ע נ ד ע ר ו נ ג ע ן
ענדערט	ע נ ד ע ר ט
ענטפֿער	ע נ ט פֿ ע ר
ענטפֿערט	ע נ ט פֿ ע ר ט
ענטפֿערן	ע נ ט פֿ ע ר ן
עני	ע נ י
עניו	ע נ י ו
ענין	ע נ י ן
ענלעכער	ע נ ל ע כ ע ר
עס	ע ס
עסט	ע ס ט
עסן	ע ס ן
עסק	ע ס ק
עסקים	ע ס ק י ם
עץ	ע ץ
עצה	ע צ ה
עצות	ע צ ו ת
עצבֿות	ע צ בֿ ו ת
עק	ע ק
עקדעשן	ע ק ד ע ש ן
עקזיסטירסט	ע ק ז י ס ט י ר ס ט
עקזאַמענס	ע ק ז אַ מ ע נ ס
עקל	ע ק ל
עקן	ע ק ן
עקרות	ע ק ר ו ת
עקשן	ע ק ש ן
עקשנות	ע ק ש נ ו ת
עקשנען	ע ק ש נ ע ן
ער	ע ר
ער'ט	ע ר ' ט
ערב־פּסח	ע ר ב ־ פּ ס ח
ערגעץ	ע ר ג ע ץ
ערגעץ־װוּ	ע ר ג ע ץ ־ װ וּ
ערגער	ע ר ג ע ר
ערגערע	ע ר ג ע ר ע
ערד	ע ר ד
ערופֿה	ע ר ו פֿ ה
ערטעלע	ע ר ט ע ל ע
ערטער	ע ר ט ע ר
ערך	ע ר ך
ערל	ע ר ל
ערלעך	ע ר ל ע ך
ערלעכע	ע ר ל ע כ ע
ערלעכער	ע ר ל ע כ ע ר
ערנסט	ע ר נ ס ט
ערשט	ע ר ש ט
ערשטן	ע ר ש ט ן
ערשטנס	ע ר ש ט נ ס
ערשטע	ע ר ש ט ע
ערשטער	ע ר ש ט ע ר
ערבֿ	ע ר בֿ
ערבֿ־פּסח	ע ר בֿ ־ פּ ס ח
עשירות	ע ש י ר ו ת
עװלה	ע װ ל ה
עפּיגראַמען	ע פּ י ג ר אַ מ ע ן
עפּל	ע פּ ל
עפּעס	ע פּ ע ס
עתּיק	ע תּ י ק
עבֿודה	ע בֿ ו ד ה
עבֿירה	ע בֿ י ר ה
עבֿירות	ע בֿ י ר ו ת
עבֿרי	ע בֿ ר י
עבֿרי־טײַטש	ע בֿ ר י ־ ט ײַ ט ש
עפֿן	ע פֿ ן
עפֿן־אױס	ע פֿ ן ־ א ױ ס
עפֿנט	ע פֿ נ ט
עפֿענען	ע פֿ ע נ ע ן
פיקאַנטע	פ י ק אַ נ ט ע
ץ	ץ
צאינה	צ א י נ ה
צאן־קדשים	צ א ן ־ ק ד ש י ם
צד	צ ד
צדוק	צ ד ו ק
צדוקס	צ ד ו ק ס
צדיק	צ ד י ק
צדיקים	צ ד י ק י ם
צדקה־טעלער	צ ד ק ה ־ ט ע ל ע ר
צהלה	צ ה ל ה
צו	צ ו
צו־להכעסניק	צ ו ־ ל ה כ ע ס נ י ק
צוביסלעך	צ ו ב י ס ל ע ך
צוג	צ ו ג
צוגעבן	צ ו ג ע ב ן
צוגעבױגן	צ ו ג ע ב ױ ג ן
צוגעגעבן	צ ו ג ע ג ע ב ן
צוגעגאַנגען	צ ו ג ע ג אַ נ ג ע ן
צוגעהערט	צ ו ג ע ה ע ר ט
צוגעהאַלטן	צ ו ג ע ה אַ ל ט ן
צוגעהאָלפֿן	צ ו ג ע ה אָ ל פֿ ן
צוגעזעצט	צ ו ג ע ז ע צ ט
צוגעזאָגט	צ ו ג ע ז אָ ג ט
צוגעזאָגטע	צ ו ג ע ז אָ ג ט ע
צוגעטראַכט	צ ו ג ע ט ר אַ כ ט
צוגעטראָגן	צ ו ג ע ט ר אָ ג ן
צוגעלעגערט	צ ו ג ע ל ע ג ע ר ט
צוגעלײגט	צ ו ג ע ל ײ ג ט
צוגעלאָזט	צ ו ג ע ל אָ ז ט
צוגעלאָפֿן	צ ו ג ע ל אָ פֿ ן
צוגעמאַכטע	צ ו ג ע מ אַ כ ט ע
צוגענומען	צ ו ג ע נ ו מ ע ן
צוגעקומען	צ ו ג ע ק ו מ ע ן
צוגעקראָגן	צ ו ג ע ק ר אָ ג ן
צוגעקראָכן	צ ו ג ע ק ר אָ כ ן
צוגערירט	צ ו ג ע ר י ר ט
צוגעשטעלט	צ ו ג ע ש ט ע ל ט
צוגעשיקט	צ ו ג ע ש י ק ט
צוגעשלאָסן	צ ו ג ע ש ל אָ ס ן
צוגעשמײכלט	צ ו ג ע ש מ ײ כ ל ט
צוגעשניטן	צ ו ג ע ש נ י ט ן
צוגעשאָקלט	צ ו ג ע ש אָ ק ל ט
צוגרײטן	צ ו ג ר ײ ט ן
צוגײן	צ ו ג ײ ן
צוגײענדיק	צ ו ג ײ ע נ ד י ק
צוגאָב	צ ו ג אָ ב
צוזעצן	צ ו ז ע צ ן
צוזאַמען	צ ו ז אַ מ ע ן
צוזאַמענגעדריקט	צ ו ז אַ מ ע נ ג ע ד ר י ק ט
צוזאַמענלױפֿן	צ ו ז אַ מ ע נ ל ױ פֿ ן
צוזאָג	צ ו ז אָ ג
צולהכעיס	צ ו ל ה כ ע י ס
צוליב	צ ו ל י ב
צולײגן	צ ו ל ײ ג ן
צולאָג	צ ו ל אָ ג
צולאָזן	צ ו ל אָ ז ן
צום	צ ו ם
צומאַכן	צ ו מ אַ כ ן
צון	צ ו ן
צונג	צ ו נ ג
צונוץ	צ ו נ ו ץ
צונעמען	צ ו נ ע מ ע ן
צונױף	צ ו נ ױ ף
צונױפֿגעלאָפֿן	צ ו נ ױ פֿ ג ע ל אָ פֿ ן
צונױפֿגעמישט	צ ו נ ױ פֿ ג ע מ י ש ט
צונױפֿגענומען	צ ו נ ױ פֿ ג ע נ ו מ ע ן
צונױפֿנעמען	צ ו נ ױ פֿ נ ע מ ע ן
צונאָמען	צ ו נ אָ מ ע ן
צוצוהערן	צ ו צ ו ה ע ר ן
צוצומאַכן	צ ו צ ו מ אַ כ ן
צוקומען	צ ו ק ו מ ע ן
צוקער	צ ו ק ע ר
צוקערזיס	צ ו ק ע ר ז י ס
צוקאָפּנס	צ ו ק אָ פּ נ ס
צורוקן	צ ו ר ו ק ן
צוריק	צ ו ר י ק
צוריקגעבן	צ ו ר י ק ג ע ב ן
צוריקגעגעבן	צ ו ר י ק ג ע ג ע ב ן
צוריקגעקומען	צ ו ר י ק ג ע ק ו מ ע ן
צוריקגעשמועסט	צ ו ר י ק ג ע ש מ ו ע ס ט
צוריקגײן	צ ו ר י ק ג ײ ן
צוריקצוקומען	צ ו ר י ק צ ו ק ו מ ע ן
צוריקקומענדיק	צ ו ר י ק ק ו מ ע נ ד י ק
צוריקפֿאָרנדיק	צ ו ר י ק פֿ אָ ר נ ד י ק
צורעכט	צ ו ר ע כ ט
צורעכטגעמאַכט	צ ו ר ע כ ט ג ע מ אַ כ ט
צורעכטצומאַכן	צ ו ר ע כ ט צ ו מ אַ כ ן
צורת־אות	צ ו ר ת ־ א ו ת
צושטימונג	צ ו ש ט י מ ו נ ג
צושטעלן	צ ו ש ט ע ל ן
צושטאַנדקומען	צ ו ש ט אַ נ ד ק ו מ ע ן
צושיקן	צ ו ש י ק ן
צופֿירן	צ ו פֿ י ר ן
צופֿליען	צ ו פֿ ל י ע ן
צופֿעליק	צ ו פֿ ע ל י ק
צופֿרידן	צ ו פֿ ר י ד ן
צופֿרידנקײט	צ ו פֿ ר י ד נ ק ײ ט
צופֿרידענער	צ ו פֿ ר י ד ע נ ע ר
צופֿאַרדינט	צ ו פֿ אַ ר ד י נ ט
צופֿאָרן	צ ו פֿ אָ ר ן
צי	צ י
ציבעלע	צ י ב ע ל ע
ציגל	צ י ג ל
ציגעלע	צ י ג ע ל ע
ציגאַנעשט	צ י ג אַ נ ע ש ט
ציגאַר	צ י ג אַ ר
ציגאַרן	צ י ג אַ ר ן
ציוניסט	צ י ו נ י ס ט
ציט	צ י ט
ציטערט	צ י ט ע ר ט
ציטערן	צ י ט ע ר ן
צימבל	צ י מ ב ל
צימוקים־װײַן	צ י מ ו ק י ם ־ װ ײַ ן
צימער	צ י מ ע ר
צינגער	צ י נ ג ע ר
צינד	צ י נ ד
צינדט	צ י נ ד ט
ציציליסט	צ י צ י ל י ס ט
ציצענעם	צ י צ ע נ ע ם
ציקלט	צ י ק ל ט
צירונג	צ י ר ו נ ג
צנועה	צ נ ו ע ה
צעבושעװעט	צ ע ב ו ש ע װ ע ט
צעבריקעט	צ ע ב ר י ק ע ט
צעבראָכענע	צ ע ב ר אָ כ ע נ ע
צעגײט	צ ע ג ײ ט
צעגײן	צ ע ג ײ ן
צעגײען	צ ע ג ײ ע ן
צעגאַנגען	צ ע ג אַ נ ג ע ן
צעגאַרטלט	צ ע ג אַ ר ט ל ט
צעדרײט	צ ע ד ר ײ ט
צעזונגען	צ ע ז ו נ ג ע ן
צעטומלט	צ ע ט ו מ ל ט
צעטרײסלט	צ ע ט ר ײ ס ל ט
צעטײלט	צ ע ט ײ ל ט
צעטײלן	צ ע ט ײ ל ן
צעלניק	צ ע ל נ י ק
צעלײגט	צ ע ל ײ ג ט
צעלאַכט	צ ע ל אַ כ ט
צעלאַכן	צ ע ל אַ כ ן
צעלאָזט	צ ע ל אָ ז ט
צעמישט	צ ע מ י ש ט
צעמישן	צ ע מ י ש ן
צען	צ ע ן
צענדליק	צ ע נ ד ל י ק
צענומען	צ ע נ ו מ ע ן
צענטן	צ ע נ ט ן
צענױף	צ ע נ ױ ף
צענױפֿגעלײגט	צ ע נ ױ פֿ ג ע ל ײ ג ט
צעקריגט	צ ע ק ר י ג ט
צעקרײעט	צ ע ק ר ײ ע ט
צער	צ ע ר
צער־בעלי־חײמניקעס	צ ע ר ־ ב ע ל י ־ ח ײ מ נ י ק ע ס
צער־גדול־בנים	צ ע ר ־ ג ד ו ל ־ ב נ י ם
צערבעלי	צ ע ר ב ע ל י
צערודערט	צ ע ר ו ד ע ר ט
צערודערן	צ ע ר ו ד ע ר ן
צערונען	צ ע ר ו נ ע ן
צעריסן	צ ע ר י ס ן
צעריסן־צעפּיצלט	צ ע ר י ס ן ־ צ ע פּ י צ ל ט
צעריסענע	צ ע ר י ס ע נ ע
צערײַס	צ ע ר ײַ ס
צערײַסן	צ ע ר ײַ ס ן
צעראַטע	צ ע ר אַ ט ע
צעשלאָגענע	צ ע ש ל אָ ג ע נ ע
צעשמײכלט	צ ע ש מ ײ כ ל ט
צעשריגן	צ ע ש ר י ג ן
צעשױבערט	צ ע ש ױ ב ע ר ט
צעשױבערטע	צ ע ש ױ ב ע ר ט ע
צעשײט	צ ע ש ײ ט
צעשפּילן	צ ע ש פּ י ל ן
צעשפּרײט	צ ע ש פּ ר ײ ט
צעשפּאָלטענעם	צ ע ש פּ אָ ל ט ע נ ע ם
צעװײנט	צ ע װ ײ נ ט
צעאַמפּערט	צ ע אַ מ פּ ע ר ט
צעפּיקעניש	צ ע פּ י ק ע נ י ש
צעפּלעצטע	צ ע פּ ל ע צ ט ע
צעפּלאָשעטע	צ ע פּ ל אָ ש ע ט ע
צעפֿלאַמט	צ ע פֿ ל אַ מ ט
צעפֿלאַמטן	צ ע פֿ ל אַ מ ט ן
צרה	צ ר ה
צרות	צ ר ו ת
צװישן	צ װ י ש ן
צװעלף	צ װ ע ל ף
צװײ	צ װ ײ
צװײט	צ װ ײ ט
צװײטן	צ װ ײ ט ן
צװײטנס	צ װ ײ ט נ ס
צװײטע	צ װ ײ ט ע
צװײטער	צ װ ײ ט ע ר
צװאַנציק	צ װ אַ נ צ י ק
צװאָנציק	צ װ אָ נ צ י ק
צײכן	צ ײ כ ן
צײכנס	צ ײ כ נ ס
צײן	צ ײ ן
צײן־דאָקטער	צ ײ ן ־ ד אָ ק ט ע ר
צײנדאָקטאָרקע	צ ײ נ ד אָ ק ט אָ ר ק ע
צײַ	צ ײַ
צײַג	צ ײַ ג
צײַגענעם	צ ײַ ג ע נ ע ם
צײַט	צ ײַ ט
צײַטונגען	צ ײַ ט ו נ ג ע ן
צײַטיק	צ ײַ ט י ק
צײַטן	צ ײַ ט ן
צײַטנס	צ ײַ ט נ ס
צאַנקט	צ אַ נ ק ט
צאַנקען	צ אַ נ ק ע ן
צאַצקע	צ אַ צ ק ע
צאַצקעלע	צ אַ צ ק ע ל ע
צאַרט	צ אַ ר ט
צאַפּט	צ אַ פּ ט
צאָלט	צ אָ ל ט
צאָלן	צ אָ ל ן
צאָן	צ אָ ן
צאָנדאָקטאָרקע	צ אָ נ ד אָ ק ט אָ ר ק ע
צאָרן	צ אָ ר ן
צוּװיגן	צ וּ װ י ג ן
צוּװאַרעמט	צ וּ װ אַ ר ע מ ט
צוּװאָרפֿן	צ וּ װ אָ ר פֿ ן
צפֿירה	צ פֿ י ר ה
ק־ד־ל־תּ	ק ־ ד ־ ל ־ תּ
ק־ד־ש־ת	ק ־ ד ־ ש ־ ת
ק־ד־ש־תּ	ק ־ ד ־ ש ־ תּ
קבלת	ק ב ל ת
קבלת־פּנים	ק ב ל ת ־ פּ נ י ם
קבצן	ק ב צ ן
קבצנים	ק ב צ נ י ם
קברן	ק ב ר ן
קדוש	ק ד ו ש
קדושת	ק ד ו ש ת
קדחת	ק ד ח ת
קדיש	ק ד י ש
קדלתּ	ק ד ל תּ
קדשתּ	ק ד ש תּ
קהילה	ק ה י ל ה
קהל	ק ה ל
קהלישן	ק ה ל י ש ן
קהלס	ק ה ל ס
קוגל	ק ו ג ל
קודם	ק ו ד ם
קודש	ק ו ד ש
קוטשער	ק ו ט ש ע ר
קול	ק ו ל
קולות	ק ו ל ו ת
קולי־קולות	ק ו ל י ־ ק ו ל ו ת
קוליע	ק ו ל י ע
קולכל	ק ו ל כ ל
קולעכל	ק ו ל ע כ ל
קום	ק ו ם
קומט	ק ו מ ט
קומסט	ק ו מ ס ט
קומען	ק ו מ ע ן
קונדסים	ק ו נ ד ס י ם
קונה	ק ו נ ה
קונהטעס	ק ו נ ה ט ע ס
קונים	ק ו נ י ם
קונסט	ק ו נ ס ט
קונסט־טעמפּל	ק ו נ ס ט ־ ט ע מ פּ ל
קונציק	ק ו נ צ י ק
קוק	ק ו ק
קוק־טון	ק ו ק ־ ט ו ן
קוקט	ק ו ק ט
קוקן	ק ו ק ן
קוקנדיק	ק ו ק נ ד י ק
קוקסטו	ק ו ק ס ט ו
קורירן	ק ו ר י ר ן
קורץ	ק ו ר ץ
קורצזיכטיקע	ק ו ר צ ז י כ ט י ק ע
קורצע	ק ו ר צ ע
קוש	ק ו ש
קושן	ק ו ש ן
קושעטקע	ק ו ש ע ט ק ע
קופּאָנעס	ק ו פּ אָ נ ע ס
קטיגור	ק ט י ג ו ר
קידוש	ק י ד ו ש
קיטל	ק י ט ל
קיטשן	ק י ט ש ן
קיטײַ	ק י ט ײַ
קיך	ק י ך
קיכטיש	ק י כ ט י ש
קיכל	ק י כ ל
קיכן	ק י כ ן
קימפּעט	ק י מ פּ ע ט
קין	ק י ן
קינאה	ק י נ א ה
קינד	ק י נ ד
קינדל	ק י נ ד ל
קינדלט	ק י נ ד ל ט
קינדלען	ק י נ ד ל ע ן
קינדעלעך	ק י נ ד ע ל ע ך
קינדער	ק י נ ד ע ר
קינדערלעך	ק י נ ד ע ר ל ע ך
קינדערס	ק י נ ד ע ר ס
קינדערסװעגן	ק י נ ד ע ר ס װ ע ג ן
קינדערשע	ק י נ ד ע ר ש ע
קינדװײַז	ק י נ ד װ ײַ ז
קינות	ק י נ ו ת
קינסטלעריש	ק י נ ס ט ל ע ר י ש
קינסטלערישן	ק י נ ס ט ל ע ר י ש ן
קיעװ	ק י ע װ
קיעװער	ק י ע װ ע ר
קירך	ק י ר ך
קישנס	ק י ש נ ס
קל	ק ל
קלוג	ק ל ו ג
קלוגן	ק ל ו ג ן
קלוגע	ק ל ו ג ע
קליגער	ק ל י ג ע ר
קלינגט	ק ל י נ ג ט
קלינגענדיקע	ק ל י נ ג ע נ ד י ק ע
קליענט	ק ל י ע נ ט
קליענטן	ק ל י ע נ ט ן
קליענטען	ק ל י ע נ ט ע ן
קללה	ק ל ל ה
קללות	ק ל ל ו ת
קלענסטן	ק ל ע נ ס ט ן
קלענערן	ק ל ע נ ע ר ן
קלעצלעך	ק ל ע צ ל ע ך
קלעצער	ק ל ע צ ע ר
קלערט	ק ל ע ר ט
קלערן	ק ל ע ר ן
קלערנדיק	ק ל ע ר נ ד י ק
קלעפּ	ק ל ע פּ
קלעפּן	ק ל ע פּ ן
קלױבט	ק ל ױ ב ט
קלױז	ק ל ױ ז
קלױסטער	ק ל ױ ס ט ע ר
קלײד	ק ל ײ ד
קלײדער	ק ל ײ ד ע ר
קלײדער־אַלמער	ק ל ײ ד ע ר ־ אַ ל מ ע ר
קלײט	ק ל ײ ט
קלײטן	ק ל ײ ט ן
קלײן	ק ל ײ ן
קלײניקײט	ק ל ײ נ י ק ײ ט
קלײנע	ק ל ײ נ ע
קלײנעם	ק ל ײ נ ע ם
קלײנער	ק ל ײ נ ע ר
קלײנװאַרג	ק ל ײ נ װ אַ ר ג
קלײַב	ק ל ײַ ב
קלײַבט	ק ל ײַ ב ט
קלײַבן	ק ל ײַ ב ן
קלאַנג	ק ל אַ נ ג
קלאַסן	ק ל אַ ס ן
קלאַװישן	ק ל אַ װ י ש ן
קלאַפּ	ק ל אַ פּ
קלאַפּ־קלאַפּ	ק ל אַ פּ ־ ק ל אַ פּ
קלאַפּט	ק ל אַ פּ ט
קלאַפּט־אָן	ק ל אַ פּ ט ־ אָ ן
קלאַפּן	ק ל אַ פּ ן
קלאָג	ק ל אָ ג
קלאָגן	ק ל אָ ג ן
קלאָץ	ק ל אָ ץ
קלאָר	ק ל אָ ר
קלאָרע	ק ל אָ ר ע
קלאָרער	ק ל אָ ר ע ר
קלאָפּן	ק ל אָ פּ ן
קלאָפּסט	ק ל אָ פּ ס ט
קמץ	ק מ ץ
קנה	ק נ ה
קנופּ	ק נ ו פּ
קניפּ	ק נ י פּ
קניפּל	ק נ י פּ ל
קנעט	ק נ ע ט
קנעטן	ק נ ע ט ן
קנעכל	ק נ ע כ ל
קנעפּל	ק נ ע פּ ל
קנױל	ק נ ױ ל
קנײדלעך	ק נ ײ ד ל ע ך
קנײע	ק נ ײ ע
קנײַפּט	ק נ ײַ פּ ט
קנײַפּן	ק נ ײַ פּ ן
קנאַקט	ק נ אַ ק ט
קנאַקן	ק נ אַ ק ן
קנאַקניסל	ק נ אַ ק נ י ס ל
קנאָבל	ק נ אָ ב ל
קנאָפֿלען	ק נ אָ פֿ ל ע ן
קעגן	ק ע ג ן
קעגנאיבער	ק ע ג נ א י ב ע ר
קעגניבער	ק ע ג נ י ב ע ר
קעז	ק ע ז
קעכין	ק ע כ י ן
קעכינס	ק ע כ י נ ס
קעכלען	ק ע כ ל ע ן
קעכנע	ק ע כ נ ע
קעלבל	ק ע ל ב ל
קעלבערנע	ק ע ל ב ע ר נ ע
קעלט	ק ע ל ט
קעלער	ק ע ל ע ר
קעלערס	ק ע ל ע ר ס
קען	ק ע ן
קענט	ק ע נ ט
קענטלעכער	ק ע נ ט ל ע כ ע ר
קענטשאַפֿט	ק ע נ ט ש אַ פֿ ט
קענסט	ק ע נ ס ט
קענען	ק ע נ ע ן
קענער	ק ע נ ע ר
קענערס	ק ע נ ע ר ס
קעסל	ק ע ס ל
קער	ק ע ר
קערבל	ק ע ר ב ל
קערבלעך	ק ע ר ב ל ע ך
קערט	ק ע ר ט
קערלעך	ק ע ר ל ע ך
קערמעשלעך	ק ע ר מ ע ש ל ע ך
קערן	ק ע ר ן
קערנדל	ק ע ר נ ד ל
קערנער	ק ע ר נ ע ר
קערנערס	ק ע ר נ ע ר ס
קעשענע	ק ע ש ע נ ע
קעשענעס	ק ע ש ע נ ע ס
קעשענעװער	ק ע ש ע נ ע װ ע ר
קעפּ	ק ע פּ
קעפּל	ק ע פּ ל
קעפּלעך	ק ע פּ ל ע ך
קצין	ק צ י ן
קצבֿה	ק צ בֿ ה
קרובים	ק ר ו ב י ם
קרוטין	ק ר ו ט י ן
קרום	ק ר ו ם
קרומע	ק ר ו מ ע
קרומער	ק ר ו מ ע ר
קרובֿ	ק ר ו בֿ
קרובֿים	ק ר ו בֿ י ם
קריאת	ק ר י א ת
קריאת־שמע	ק ר י א ת ־ ש מ ע
קריג	ק ר י ג
קריגט	ק ר י ג ט
קריגן	ק ר י ג ן
קריך	ק ר י ך
קריכט	ק ר י כ ט
קריכט־אַרײַן	ק ר י כ ט ־ אַ ר ײַ ן
קריכן	ק ר י כ ן
קרימעטאַרטע	ק ר י מ ע ט אַ ר ט ע
קריסטלעכער	ק ר י ס ט ל ע כ ע ר
קריצן	ק ר י צ ן
קרן	ק ר ן
קרעדיט	ק ר ע ד י ט
קרעטשמע	ק ר ע ט ש מ ע
קרעכץ	ק ר ע כ ץ
קרעכצט	ק ר ע כ צ ט
קרעכצן	ק ר ע כ צ ן
קרעמער	ק ר ע מ ע ר
קרענק	ק ר ע נ ק
קרענקט	ק ר ע נ ק ט
קרענקען	ק ר ע נ ק ע ן
קרױן	ק ר ױ ן
קרױנען	ק ר ױ נ ע ן
קרײ	ק ר ײ
קרײד	ק ר ײ ד
קרײען	ק ר ײ ע ן
קרײַזלען	ק ר ײַ ז ל ע ן
קרײַטעכצער	ק ר ײַ ט ע כ צ ע ר
קרײַטער	ק ר ײַ ט ע ר
קראַנץ	ק ר אַ נ ץ
קראַנק	ק ר אַ נ ק
קראַנקן	ק ר אַ נ ק ן
קראַנקע	ק ר אַ נ ק ע
קראַנקער	ק ר אַ נ ק ע ר
קראַסניסטאָװ	ק ר אַ ס נ י ס ט אָ װ
קראַצט	ק ר אַ צ ט
קראַצמיך	ק ר אַ צ מ י ך
קראַצן	ק ר אַ צ ן
קראָם	ק ר אָ ם
קראָקע	ק ר אָ ק ע
קשיא	ק ש י א
קשיה	ק ש י ה
קװיטש	ק װ י ט ש
קװיטשעט	ק װ י ט ש ע ט
קװינט	ק װ י נ ט
קװיקן	ק װ י ק ן
קװעטשט	ק װ ע ט ש ט
קװעטשן	ק װ ע ט ש ן
קװעטשקען	ק װ ע ט ש ק ע ן
קװאַרס	ק װ אַ ר ס
קװאָרט	ק װ אָ ר ט
קױבער	ק ױ ב ע ר
קױל	ק ױ ל
קױלן	ק ױ ל ן
קױלן־ברענער	ק ױ ל ן ־ ב ר ע נ ע ר
קױלעטש	ק ױ ל ע ט ש
קױלען	ק ױ ל ע ן
קױם	ק ױ ם
קױם־קױם	ק ױ ם ־ ק ױ ם
קױמען	ק ױ מ ע ן
קױפֿט	ק ױ פֿ ט
קױפֿן	ק ױ פֿ ן
קײט	ק ײ ט
קײן	ק ײ ן
קײנמאָל	ק ײ נ מ אָ ל
קײנעם	ק ײ נ ע ם
קײנער	ק ײ נ ע ר
קײַ	ק ײַ
קײַבערל	ק ײַ ב ע ר ל
קײַמא־לן	ק ײַ מ א ־ ל ן
קאַ'	ק אַ '
קאַבינעט	ק אַ ב י נ ע ט
קאַבצאַנסק	ק אַ ב צ אַ נ ס ק
קאַדיק	ק אַ ד י ק
קאַהאַל	ק אַ ה אַ ל
קאַטשקי	ק אַ ט ש ק י
קאַטאַיען	ק אַ ט אַ י ע ן
קאַטאָרי	ק אַ ט אָ ר י
קאַטאָװעסל	ק אַ ט אָ װ ע ס ל
קאַטאָװעסלעך	ק אַ ט אָ װ ע ס ל ע ך
קאַלב	ק אַ ל ב
קאַלוזשעס	ק אַ ל ו ז ש ע ס
קאַלושקער	ק אַ ל ו ש ק ע ר
קאַלט	ק אַ ל ט
קאַלטונעװאַטער	ק אַ ל ט ו נ ע װ אַ ט ע ר
קאַלטן	ק אַ ל ט ן
קאַלטע	ק אַ ל ט ע
קאַלטער	ק אַ ל ט ע ר
קאַליע	ק אַ ל י ע
קאַליקע	ק אַ ל י ק ע
קאַליקעס	ק אַ ל י ק ע ס
קאַמינסקי	ק אַ מ י נ ס ק י
קאַמינסקיס	ק אַ מ י נ ס ק י ס
קאַמעניץ	ק אַ מ ע נ י ץ
קאַמעניצער	ק אַ מ ע נ י צ ע ר
קאַמער	ק אַ מ ע ר
קאַמעראַד	ק אַ מ ע ר אַ ד
קאַמף	ק אַ מ ף
קאַנטן	ק אַ נ ט ן
קאַנטשיק	ק אַ נ ט ש י ק
קאַנטאָר	ק אַ נ ט אָ ר
קאַנען	ק אַ נ ע ן
קאַנװע	ק אַ נ װ ע
קאַנאַפּע	ק אַ נ אַ פּ ע
קאַסטן	ק אַ ס ט ן
קאַסירער	ק אַ ס י ר ע ר
קאַסריליװקער	ק אַ ס ר י ל י װ ק ע ר
קאַסרילעקעס	ק אַ ס ר י ל ע ק ע ס
קאַסרילעװקע	ק אַ ס ר י ל ע װ ק ע
קאַסרילעװקער	ק אַ ס ר י ל ע װ ק ע ר
קאַץ	ק אַ ץ
קאַר	ק אַ ר
קאַרב	ק אַ ר ב
קאַרבן	ק אַ ר ב ן
קאַרבען	ק אַ ר ב ע ן
קאַרג	ק אַ ר ג
קאַרגן	ק אַ ר ג ן
קאַרטאָפֿל	ק אַ ר ט אָ פֿ ל
קאַרטאָפֿליעס	ק אַ ר ט אָ פֿ ל י ע ס
קאַריק	ק אַ ר י ק
קאַרעטן	ק אַ ר ע ט ן
קאַרעטע	ק אַ ר ע ט ע
קאַרשן	ק אַ ר ש ן
קאַרשנבױם	ק אַ ר ש נ ב ױ ם
קאַרשנסאָד	ק אַ ר ש נ ס אָ ד
קאַראַסיק	ק אַ ר אַ ס י ק
קאַשע	ק אַ ש ע
קאַװע	ק אַ װ ע
קאַפּיטל	ק אַ פּ י ט ל
קאַפּיטאַל	ק אַ פּ י ט אַ ל
קאַפּיטאַן	ק אַ פּ י ט אַ ן
קאַפּל	ק אַ פּ ל
קאַפּלעך	ק אַ פּ ל ע ך
קאַפּן	ק אַ פּ ן
קאַפּעלושל	ק אַ פּ ע ל ו ש ל
קאַפּריז	ק אַ פּ ר י ז
קאַפּױער	ק אַ פּ ױ ע ר
קאַפּױר	ק אַ פּ ױ ר
קאַפּאָטע	ק אַ פּ אָ ט ע
קאַפּאָטקעלע	ק אַ פּ אָ ט ק ע ל ע
קאָזשעניצער	ק אָ ז ש ע נ י צ ע ר
קאָזאַק	ק אָ ז אַ ק
קאָטער	ק אָ ט ע ר
קאָטש	ק אָ ט ש
קאָטשערע	ק אָ ט ש ע ר ע
קאָכט	ק אָ כ ט
קאָכעניש	ק אָ כ ע נ י ש
קאָלושקער	ק אָ ל ו ש ק ע ר
קאָלושקערס	ק אָ ל ו ש ק ע ר ס
קאָלנער	ק אָ ל נ ע ר
קאָמינסקיס	ק אָ מ י נ ס ק י ס
קאָמיסיאָנער	ק אָ מ י ס י אָ נ ע ר
קאָמעדיע	ק אָ מ ע ד י ע
קאָמאַ	ק אָ מ אַ
קאָמפּלימענטן	ק אָ מ פּ ל י מ ע נ ט ן
קאָמפּליצירטער	ק אָ מ פּ ל י צ י ר ט ע ר
קאָמפּראָמיס	ק אָ מ פּ ר אָ מ י ס
קאָן	ק אָ ן
קאָנגרעס־לײַט	ק אָ נ ג ר ע ס ־ ל ײַ ט
קאָנט	ק אָ נ ט
קאָנטראַקט	ק אָ נ ט ר אַ ק ט
קאָנסט	ק אָ נ ס ט
קאָנסטיטוציע	ק אָ נ ס ט י ט ו צ י ע
קאָנען	ק אָ נ ע ן
קאָנװערט	ק אָ נ װ ע ר ט
קאָנפֿערענץ	ק אָ נ פֿ ע ר ע נ ץ
קאָסט	ק אָ ס ט
קאָסטן	ק אָ ס ט ן
קאָצק	ק אָ צ ק
קאָרט	ק אָ ר ט
קאָרטן	ק אָ ר ט ן
קאָריק	ק אָ ר י ק
קאָרע	ק אָ ר ע
קאָפּ	ק אָ פּ
קאָפּ־דרײעניש	ק אָ פּ ־ ד ר ײ ע נ י ש
קאָפּטיכל	ק אָ פּ ט י כ ל
קאָפּטיכלעך	ק אָ פּ ט י כ ל ע ך
קאָפּיקעס	ק אָ פּ י ק ע ס
קאָפּנס	ק אָ פּ נ ס
קאָפּעקעס	ק אָ פּ ע ק ע ס
קאָפּװײטיק	ק אָ פּ װ ײ ט י ק
קאָפֿטעל	ק אָ פֿ ט ע ל
קבֿורה	ק בֿ ו ר ה
קבֿר	ק בֿ ר
קבֿרים	ק בֿ ר י ם
ר	ר
ר'	ר '
ר'האָט	ר ' ה אָ ט
ראיה	ר א י ה
ראיות	ר א י ו ת
ראש	ר א ש
ראש־השנה	ר א ש ־ ה ש נ ה
ראש־חודש	ר א ש ־ ח ו ד ש
רב	ר ב
רבונו	ר ב ו נ ו
רבונו־של־עולם	ר ב ו נ ו ־ ש ל ־ ע ו ל ם
רבי	ר ב י
רבין	ר ב י ן
רבינו	ר ב י נ ו
רבינס	ר ב י נ ס
רביצין	ר ב י צ י ן
רבנו	ר ב נ ו
רבנים	ר ב נ י ם
רגע	ר ג ע
רו	ר ו
רובל	ר ו ב ל
רוגזה	ר ו ג ז ה
רודער	ר ו ד ע ר
רוח	ר ו ח
רוחות	ר ו ח ו ת
רוחניות	ר ו ח נ י ו ת
רוט	ר ו ט
רוסיש	ר ו ס י ש
רועט	ר ו ע ט
רוען	ר ו ע ן
רוף	ר ו ף
רוקט	ר ו ק ט
רוקן	ר ו ק ן
רובֿ	ר ו בֿ
רופֿא	ר ו פֿ א
רופֿט	ר ו פֿ ט
רופֿן	ר ו פֿ ן
רחבותדיק	ר ח ב ו ת ד י ק
רחל	ר ח ל
רחמים	ר ח מ י ם
רחמנא	ר ח מ נ א
רחמנות	ר ח מ נ ו ת
ריזיק	ר י ז י ק
ריזן־קאָפ	ר י ז ן ־ ק אָ פ
ריטם	ר י ט ם
ריטער	ר י ט ע ר
ריכטיק	ר י כ ט י ק
ריכטער	ר י כ ט ע ר
רימען	ר י מ ע ן
רינד	ר י נ ד
רינט	ר י נ ט
ריר	ר י ר
רירט	ר י ר ט
רירן	ר י ר ן
ריפּ	ר י פּ
רמה	ר מ ה
רעגן	ר ע ג ן
רעגנטרערן	ר ע ג נ ט ר ע ר ן
רעגענען	ר ע ג ע נ ע ן
רעדט	ר ע ד ט
רעדי	ר ע ד י
רעדל	ר ע ד ל
רעדלט	ר ע ד ל ט
רעדלעך	ר ע ד ל ע ך
רעדן	ר ע ד ן
רעדעלעך	ר ע ד ע ל ע ך
רעדער	ר ע ד ע ר
רעזשיסאָר	ר ע ז ש י ס אָ ר
רעטאָריק	ר ע ט אָ ר י ק
רעכט	ר ע כ ט
רעכטן	ר ע כ ט ן
רעכטער	ר ע כ ט ע ר
רעכן	ר ע כ ן
רעכנט	ר ע כ נ ט
רעכץ	ר ע כ ץ
רעצעפּט	ר ע צ ע פּ ט
רערל	ר ע ר ל
רעש	ר ע ש
רעשט	ר ע ש ט
רעשטל	ר ע ש ט ל
רעװאָלוציע	ר ע װ אָ ל ו צ י ע
רעװאָלוציעס	ר ע װ אָ ל ו צ י ע ס
רעאַביליטירן	ר ע אַ ב י ל י ט י ר ן
רעאַליזם	ר ע אַ ל י ז ם
רעפּובליקאַנישע	ר ע פּ ו ב ל י ק אַ נ י ש ע
רעפֿערענדום	ר ע פֿ ע ר ע נ ד ו ם
רעפֿרײן	ר ע פֿ ר ײ ן
רציחה	ר צ י ח ה
רק	ר ק
רשות	ר ש ו ת
רשע	ר ש ע
רשעים	ר ש ע י ם
רױזע	ר ױ ז ע
רױזעס	ר ױ ז ע ס
רױט	ר ױ ט
רױטבאַקיקן	ר ױ ט ב אַ ק י ק ן
רױטבאַקיקער	ר ױ ט ב אַ ק י ק ע ר
רױטלען	ר ױ ט ל ע ן
רױטן	ר ױ ט ן
רױטע	ר ױ ט ע
רױטער	ר ױ ט ע ר
רױטשילד	ר ױ ט ש י ל ד
רױטשילדס	ר ױ ט ש י ל ד ס
רױך	ר ױ ך
רױכערט	ר ױ כ ע ר ט
רױכערן	ר ױ כ ע ר ן
רױמט	ר ױ מ ט
רױשט	ר ױ ש ט
רײד	ר ײ ד
רײכערן	ר ײ כ ע ר ן
רײן	ר ײ ן
רײן־קינדעריש־בלױע	ר ײ ן ־ ק י נ ד ע ר י ש ־ ב ל ױ ע
רײניקײט	ר ײ נ י ק ײ ט
רײנע	ר ײ נ ע
רײצע	ר ײ צ ע
רײַ	ר ײַ
רײַך	ר ײַ ך
רײַכן	ר ײַ כ ן
רײַכע	ר ײַ כ ע
רײַסט	ר ײַ ס ט
רײַסן	ר ײַ ס ן
רײַסעניש	ר ײַ ס ע נ י ש
ראַבינאָװיטש	ר אַ ב י נ אָ װ י ט ש
ראַדאָמישל	ר אַ ד אָ מ י ש ל
ראַדאָשיץ	ר אַ ד אָ ש י ץ
ראַטע	ר אַ ט ע
ראַטעװען	ר אַ ט ע װ ע ן
ראַיעל	ר אַ י ע ל
ראַכמיסטריװקע	ר אַ כ מ י ס ט ר י װ ק ע
ראַנגלט	ר אַ נ ג ל ט
ראַספּוטין	ר אַ ס פּ ו ט י ן
ראַציאָנאַליסט	ר אַ צ י אָ נ אַ ל י ס ט
ראַפּטים	ר אַ פּ ט י ם
ראָגזשע	ר אָ ג ז ש ע
ראָד	ר אָ ד
ראָוז	ר אָ ו ז
ראָזשינקעס	ר אָ ז ש י נ ק ע ס
ראָזשינקעס־װײַן	ר אָ ז ש י נ ק ע ס ־ װ ײַ ן
ראָט	ר אָ ט
ראָטע	ר אָ ט ע
ראָלע	ר אָ ל ע
ראָמס	ר אָ מ ס
ראָמאַנען	ר אָ מ אַ נ ע ן
רבֿ	ר בֿ
רבֿס	ר בֿ ס
רפֿאל	ר פֿ א ל
רפֿואה	ר פֿ ו א ה
רפֿואות	ר פֿ ו א ו ת
רפֿעדט	ר פֿ ע ד ט
שאול	ש א ו ל
שאלה	ש א ל ה
שאלות	ש א ל ו ת
שאלת־נשים	ש א ל ת ־ נ ש י ם
שבבלאָטע	ש ב ב ל אָ ט ע
שבחים	ש ב ח י ם
שבת	ש ב ת
שבת־הגדול	ש ב ת ־ ה ג ד ו ל
שדוך	ש ד ו ך
שדים	ש ד י ם
שדכן	ש ד כ ן
שדכנות־געלט	ש ד כ נ ו ת ־ ג ע ל ט
שדכנים	ש ד כ נ י ם
שדכנען	ש ד כ נ ע ן
שהיה	ש ה י ה
שהיות	ש ה י ו ת
שובע	ש ו ב ע
שוטה	ש ו ט ה
שול	ש ו ל
שולגעסל	ש ו ל ג ע ס ל
שולד	ש ו ל ד
שולדיק	ש ו ל ד י ק
שולדיקן	ש ו ל ד י ק ן
שולהױף	ש ו ל ה ױ ף
שולחן	ש ו ל ח ן
שולן	ש ו ל ן
שום	ש ו ם
שומר	ש ו מ ר
שוסטער	ש ו ס ט ע ר
שורהבר	ש ו ר ה ב ר
שורש	ש ו ר ש
שושן־הבירה	ש ו ש ן ־ ה ב י ר ה
שושנת	ש ו ש נ ת
שושקערײַ	ש ו ש ק ע ר ײַ
שותּף	ש ו תּ ף
שופֿלאָד	ש ו פֿ ל אָ ד
שטוב	ש ט ו ב
שטוב־זיצערין	ש ט ו ב ־ ז י צ ע ר י ן
שטובמענטשן	ש ט ו ב מ ע נ ט ש ן
שטודירט	ש ט ו ד י ר ט
שטודירן	ש ט ו ד י ר ן
שטול	ש ט ו ל
שטום	ש ט ו ם
שטומע	ש ט ו מ ע
שטומען	ש ט ו מ ע ן
שטומפּיק	ש ט ו מ פּ י ק
שטונדע	ש ט ו נ ד ע
שטורקאַצן	ש ט ו ר ק אַ צ ן
שטופּט	ש ט ו פּ ט
שטופּן	ש ט ו פּ ן
שטופּען	ש ט ו פּ ע ן
שטיבל	ש ט י ב ל
שטיבעלע	ש ט י ב ע ל ע
שטיל	ש ט י ל
שטילע	ש ט י ל ע
שטילער	ש ט י ל ע ר
שטילערהײט	ש ט י ל ע ר ה ײ ט
שטים	ש ט י ם
שטימונג	ש ט י מ ו נ ג
שטימען	ש ט י מ ע ן
שטיק	ש ט י ק
שטיקט	ש ט י ק ט
שטיקל	ש ט י ק ל
שטיקלעך	ש ט י ק ל ע ך
שטיקעלע	ש ט י ק ע ל ע
שטיקען	ש ט י ק ע ן
שטיװל	ש ט י װ ל
שטיװלעטן	ש ט י װ ל ע ט ן
שטיװעלעך	ש ט י װ ע ל ע ך
שטיפֿמאַמע	ש ט י פֿ מ אַ מ ע
שטיפֿמאַמען	ש ט י פֿ מ אַ מ ע ן
שטיפֿער	ש ט י פֿ ע ר
שטעגן	ש ט ע ג ן
שטעט	ש ט ע ט
שטעטל	ש ט ע ט ל
שטעטלעך	ש ט ע ט ל ע ך
שטעכיק	ש ט ע כ י ק
שטעכן	ש ט ע כ ן
שטעכװערטלעך	ש ט ע כ װ ע ר ט ל ע ך
שטעל	ש ט ע ל
שטעלט	ש ט ע ל ט
שטעלן	ש ט ע ל ן
שטענדיק	ש ט ע נ ד י ק
שטענדער	ש ט ע נ ד ע ר
שטענדערל	ש ט ע נ ד ע ר ל
שטעקט	ש ט ע ק ט
שטעקן	ש ט ע ק ן
שטעקען	ש ט ע ק ע ן
שטערן	ש ט ע ר ן
שטערננעכט	ש ט ע ר נ נ ע כ ט
שטערנפּיקער	ש ט ע ר נ פּ י ק ע ר
שטרודלען	ש ט ר ו ד ל ע ן
שטריק	ש ט ר י ק
שטריקן	ש ט ר י ק ן
שטרעק	ש ט ר ע ק
שטרעקט	ש ט ר ע ק ט
שטרױ	ש ט ר ױ
שטראַלט	ש ט ר אַ ל ט
שטראַלן	ש ט ר אַ ל ן
שטראָף	ש ט ר אָ ף
שטראָפֿן	ש ט ר אָ פֿ ן
שטױביקער	ש ט ױ ב י ק ע ר
שטױבעלע	ש ט ױ ב ע ל ע
שטױס	ש ט ױ ס
שטױסן	ש ט ױ ס ן
שטײ	ש ט ײ
שטײגער	ש ט ײ ג ע ר
שטײגערס	ש ט ײ ג ע ר ס
שטײט	ש ט ײ ט
שטײט־אױף	ש ט ײ ט ־ א ױ ף
שטײן	ש ט ײ ן
שטײנער	ש ט ײ נ ע ר
שטײען	ש ט ײ ע ן
שטײענדיק	ש ט ײ ע נ ד י ק
שטײענדיקע	ש ט ײ ע נ ד י ק ע
שטאַט	ש ט אַ ט
שטאַמט	ש ט אַ מ ט
שטאַמען	ש ט אַ מ ע ן
שטאַרבט	ש ט אַ ר ב ט
שטאַרבן	ש ט אַ ר ב ן
שטאַרט	ש ט אַ ר ט
שטאַרק	ש ט אַ ר ק
שטאַרקן	ש ט אַ ר ק ן
שטאַרקער	ש ט אַ ר ק ע ר
שטאַרקערער	ש ט אַ ר ק ע ר ע ר
שטאָט	ש ט אָ ט
שטאָט־רבֿ	ש ט אָ ט ־ ר בֿ
שטאָט־שקצים	ש ט אָ ט ־ ש ק צ י ם
שטאָטישע	ש ט אָ ט י ש ע
שטאָך	ש ט אָ ך
שטאָלץ	ש ט אָ ל ץ
שטאָק	ש ט אָ ק
שטאָפּן	ש ט אָ פּ ן
שיבוש	ש י ב ו ש
שידוך	ש י ד ו ך
שידוכים	ש י ד ו כ י ם
שיט	ש י ט
שיטן	ש י ט ן
שיטערער	ש י ט ע ר ע ר
שיך	ש י ך
שילדערן	ש י ל ד ע ר ן
שילערס	ש י ל ע ר ס
שין	ש י ן
שיסל	ש י ס ל
שיסן	ש י ס ן
שיסער	ש י ס ע ר
שיע	ש י ע
שיעור	ש י ע ו ר
שיעלע	ש י ע ל ע
שיער	ש י ע ר
שיף	ש י ף
שיצט	ש י צ ט
שיק	ש י ק
שיקט	ש י ק ט
שיקט־אַרײַן	ש י ק ט ־ אַ ר ײַ ן
שיקן	ש י ק ן
שיר	ש י ר
שיכּור	ש י כּ ו ר
שיכּורים	ש י כּ ו ר י ם
שיפּער	ש י פּ ע ר
שכיח	ש כ י ח
שכנות	ש כ נ ו ת
שכנים	ש כ נ י ם
שכר	ש כ ר
של	ש ל
שלום	ש ל ו ם
שלום־עליכם	ש ל ו ם ־ ע ל י כ ם
שלום־עליכמען	ש ל ו ם ־ ע ל י כ מ ע ן
שלומקע	ש ל ו מ ק ע
שלוק	ש ל ו ק
שלח־מנות	ש ל ח ־ מ נ ו ת
שלחן	ש ל ח ן
שלחן־ערוך	ש ל ח ן ־ ע ר ו ך
שלי	ש ל י
שליחות	ש ל י ח ו ת
שליחים	ש ל י ח י ם
שליטן	ש ל י ט ן
שליטנס	ש ל י ט נ ס
שלים־שלים־מזל	ש ל י ם ־ ש ל י ם ־ מ ז ל
שלימזל	ש ל י מ ז ל
שלינג	ש ל י נ ג
שלינגען	ש ל י נ ג ע ן
שליסל	ש ל י ס ל
שליץ	ש ל י ץ
שליאַך	ש ל י אַ ך
שלל	ש ל ל
שלמה	ש ל מ ה
שלעכט	ש ל ע כ ט
שלעכטיקײט	ש ל ע כ ט י ק ײ ט
שלעכטס	ש ל ע כ ט ס
שלעכטער	ש ל ע כ ט ע ר
שלעק	ש ל ע ק
שלעפּט	ש ל ע פּ ט
שלעפּן	ש ל ע פּ ן
שלעפּערס	ש ל ע פּ ע ר ס
שלײער	ש ל ײ ע ר
שלײפֿן	ש ל ײ פֿ ן
שלײַדער	ש ל ײַ ד ע ר
שלײַדערט	ש ל ײַ ד ע ר ט
שלײַדערנדיק	ש ל ײַ ד ע ר נ ד י ק
שלאַבאָדאַ	ש ל אַ ב אָ ד אַ
שלאַנג	ש ל אַ נ ג
שלאַנגען	ש ל אַ נ ג ע ן
שלאַפֿקײטן	ש ל אַ פֿ ק ײ ט ן
שלאָגט	ש ל אָ ג ט
שלאָגן	ש ל אָ ג ן
שלאָס	ש ל אָ ס
שלאָף	ש ל אָ ף
שלאָפֿגעטראַנק	ש ל אָ פֿ ג ע ט ר אַ נ ק
שלאָפֿט	ש ל אָ פֿ ט
שלאָפֿן	ש ל אָ פֿ ן
שלאָפֿנדיקן	ש ל אָ פֿ נ ד י ק ן
שם	ש ם
שמו	ש מ ו
שמונה־עשרה	ש מ ו נ ה ־ ע ש ר ה
שמוסט	ש מ ו ס ט
שמועל	ש מ ו ע ל
שמועס	ש מ ו ע ס
שמועסט	ש מ ו ע ס ט
שמועסן	ש מ ו ע ס ן
שמועסנדיק	ש מ ו ע ס נ ד י ק
שמות	ש מ ו ת
שמחה	ש מ ח ה
שמיעה	ש מ י ע ה
שמיץ	ש מ י ץ
שמירעכץ	ש מ י ר ע כ ץ
שמע	ש מ ע
שמעו	ש מ ע ו
שמעון	ש מ ע ו ן
שמעלקע	ש מ ע ל ק ע
שמעלקען	ש מ ע ל ק ע ן
שמעק	ש מ ע ק
שמעקט	ש מ ע ק ט
שמעקן	ש מ ע ק ן
שמעקנדיקער	ש מ ע ק נ ד י ק ע ר
שמערל	ש מ ע ר ל
שמש	ש מ ש
שמשים	ש מ ש י ם
שמױגער	ש מ ױ ג ע ר
שמײכל	ש מ ײ כ ל
שמײכלט	ש מ ײ כ ל ט
שמײכלען	ש מ ײ כ ל ע ן
שמײכלענדיקע	ש מ ײ כ ל ע נ ד י ק ע
שמײכעלע	ש מ ײ כ ע ל ע
שמײַסן	ש מ ײַ ס ן
שמײַסער	ש מ ײַ ס ע ר
שמשׂ	ש מ שׂ
שמאַטעס	ש מ אַ ט ע ס
שמאָכטעס	ש מ אָ כ ט ע ס
שנור	ש נ ו ר
שני־בשלישי	ש נ י ־ ב ש ל י ש י
שניט	ש נ י ט
שניט־סחורה	ש נ י ט ־ ס ח ו ר ה
שניר	ש נ י ר
שנעל	ש נ ע ל
שנײ	ש נ ײ
שנײ־דעקע	ש נ ײ ־ ד ע ק ע
שנײ־װײַסן	ש נ ײ ־ װ ײַ ס ן
שנײט	ש נ ײ ט
שנײַדט	ש נ ײַ ד ט
שנײַדן	ש נ ײַ ד ן
שנײַדער	ש נ ײַ ד ע ר
שנײַדערוק	ש נ ײַ ד ע ר ו ק
שנײַדערס	ש נ ײַ ד ע ר ס
שנײַדערײַ	ש נ ײַ ד ע ר ײַ
שנאָרכט	ש נ אָ ר כ ט
שנאָרכנדיקן	ש נ אָ ר כ נ ד י ק ן
שנאָרער	ש נ אָ ר ע ר
שעה	ש ע ה
שעיהס	ש ע י ה ס
שעלט	ש ע ל ט
שעלטן	ש ע ל ט ן
שעם	ש ע ם
שעמען	ש ע מ ע ן
שעמערירט	ש ע מ ע ר י ר ט
שענסטע	ש ע נ ס ט ע
שענסטער	ש ע נ ס ט ע ר
שענער	ש ע נ ע ר
שענק	ש ע נ ק
שענקען	ש ע נ ק ע ן
שענקער	ש ע נ ק ע ר
שענקערס	ש ע נ ק ע ר ס
שענקערקע	ש ע נ ק ע ר ק ע
שער־און־אַײזן	ש ע ר ־ א ו ן ־ אַ ײ ז ן
שער־בלאַט	ש ע ר ־ ב ל אַ ט
שעפּ	ש ע פּ
שעפּן	ש ע פּ ן
שעפּסן	ש ע פּ ס ן
שעפֿעלעך	ש ע פֿ ע ל ע ך
שקצים	ש ק צ י ם
שקר־וכּזבֿ	ש ק ר ־ ו כּ ז בֿ
שקאָלאַ	ש ק אָ ל אַ
שריפֿטן	ש ר י פֿ ט ן
שרעק	ש ר ע ק
שרץ	ש ר ץ
שרצים	ש ר צ י ם
שרױפֿן	ש ר ױ פֿ ן
שרײַ	ש ר ײַ
שרײַבט	ש ר ײַ ב ט
שרײַבטיש	ש ר ײַ ב ט י ש
שרײַבן	ש ר ײַ ב ן
שרײַבער	ש ר ײַ ב ע ר
שרײַט	ש ר ײַ ט
שרײַען	ש ר ײַ ע ן
ששים	ש ש י ם
שששאַ	ש ש ש אַ
ששת	ש ש ת
שװימט	ש װ י מ ט
שװימען	ש װ י מ ע ן
שװינדלט	ש װ י נ ד ל ט
שװינדלענדיקער	ש װ י נ ד ל ע נ ד י ק ע ר
שװינדלער	ש װ י נ ד ל ע ר
שװיצט	ש װ י צ ט
שװיצן	ש װ י צ ן
שװעב	ש װ ע ב
שװעבל	ש װ ע ב ל
שװעבעלעך	ש װ ע ב ע ל ע ך
שװעגערין	ש װ ע ג ע ר י ן
שװעל	ש װ ע ל
שװעסטער	ש װ ע ס ט ע ר
שװעסטערלעך	ש װ ע ס ט ע ר ל ע ך
שװער	ש װ ע ר
שװערלעך	ש װ ע ר ל ע ך
שװערן	ש װ ע ר ן
שװערס	ש װ ע ר ס
שװערסטע	ש װ ע ר ס ט ע
שװערסטער	ש װ ע ר ס ט ע ר
שװערע	ש װ ע ר ע
שװערער	ש װ ע ר ע ר
שװײס	ש װ ײ ס
שװײַג	ש װ ײַ ג
שװײַגט	ש װ ײַ ג ט
שװײַגן	ש װ ײַ ג ן
שװײַגער	ש װ ײַ ג ע ר
שװײַגערין	ש װ ײַ ג ע ר י ן
שװײַגערנס	ש װ ײַ ג ע ר נ ס
שװאַך	ש װ אַ ך
שװאַכע	ש װ אַ כ ע
שװאַכער	ש װ אַ כ ע ר
שװאַרץ	ש װ אַ ר ץ
שװאַרצלעך	ש װ אַ ר צ ל ע ך
שװאַרצן	ש װ אַ ר צ ן
שװאַרצע	ש װ אַ ר צ ע
שװאַרצער	ש װ אַ ר צ ע ר
שװאַרצקײט	ש װ אַ ר צ ק ײ ט
שװאָגער	ש װ אָ ג ע ר
שװאָגערס	ש װ אָ ג ע ר ס
שװאָם	ש װ אָ ם
שױב	ש ױ ב
שױם	ש ױ ם
שױן	ש ױ ן
שײטל	ש ײ ט ל
שײכות	ש ײ כ ו ת
שײן	ש ײ ן
שײנס	ש ײ נ ס
שײנע	ש ײ נ ע
שײנעם	ש ײ נ ע ם
שײנער	ש ײ נ ע ר
שײנקײט	ש ײ נ ק ײ ט
שײַך	ש ײַ ך
שײַכות	ש ײַ כ ו ת
שײַנט	ש ײַ נ ט
שײַנען	ש ײַ נ ע ן
שײַעס	ש ײַ ע ס
שאַ	ש אַ
שאַד	ש אַ ד
שאַט	ש אַ ט
שאַך	ש אַ ך
שאַכטל	ש אַ כ ט ל
שאַכטלעך	ש אַ כ ט ל ע ך
שאַכערמאַכערי	ש אַ כ ע ר מ אַ כ ע ר י
שאַל	ש אַ ל
שאַלקע	ש אַ ל ק ע
שאַנד	ש אַ נ ד
שאַרט	ש אַ ר ט
שאַרן	ש אַ ר ן
שאַרף	ש אַ ר ף
שאַרפֿן	ש אַ ר פֿ ן
שאַרפֿע	ש אַ ר פֿ ע
שאַרפֿער	ש אַ ר פֿ ע ר
שאַפֿונגען	ש אַ פֿ ו נ ג ע ן
שאַפֿט	ש אַ פֿ ט
שאַפֿן	ש אַ פֿ ן
שאָד	ש אָ ד
שאָדן	ש אָ ד ן
שאָטן	ש אָ ט ן
שאָס	ש אָ ס
שאָקלט	ש אָ ק ל ט
שאָקלען	ש אָ ק ל ע ן
שאָפּ	ש אָ פּ
שפּיטאָל	ש פּ י ט אָ ל
שפּיטאָל־בעט	ש פּ י ט אָ ל ־ ב ע ט
שפּיל	ש פּ י ל
שפּילט	ש פּ י ל ט
שפּילן	ש פּ י ל ן
שפּילסט	ש פּ י ל ס ט
שפּילסטו	ש פּ י ל ס ט ו
שפּילשליװער	ש פּ י ל ש ל י װ ע ר
שפּינען	ש פּ י נ ע ן
שפּיץ	ש פּ י ץ
שפּיציק	ש פּ י צ י ק
שפּיצל	ש פּ י צ ל
שפּיצלעך	ש פּ י צ ל ע ך
שפּיצעכיקע	ש פּ י צ ע כ י ק ע
שפּירט	ש פּ י ר ט
שפּעט	ש פּ ע ט
שפּעטע	ש פּ ע ט ע
שפּעטער	ש פּ ע ט ע ר
שפּעטערדיקע	ש פּ ע ט ע ר ד י ק ע
שפּענדל	ש פּ ע נ ד ל
שפּענער	ש פּ ע נ ע ר
שפּענצטער	ש פּ ע נ צ ט ע ר
שפּענצער	ש פּ ע נ צ ע ר
שפּרוך	ש פּ ר ו ך
שפּרינצע	ש פּ ר י נ צ ע
שפּריצט	ש פּ ר י צ ט
שפּרעכט	ש פּ ר ע כ ט
שפּרעכערין	ש פּ ר ע כ ע ר י ן
שפּרײט	ש פּ ר ײ ט
שפּרײַזט	ש פּ ר ײַ ז ט
שפּראַך	ש פּ ר אַ ך
שפּראָך	ש פּ ר אָ ך
שפּראָצן	ש פּ ר אָ צ ן
שפּײַ	ש פּ ײַ
שפּײַז־געװעלבל	ש פּ ײַ ז ־ ג ע װ ע ל ב ל
שפּײַען	ש פּ ײַ ע ן
שפּאַלט	ש פּ אַ ל ט
שפּאַניען	ש פּ אַ נ י ע ן
שפּאַנען	ש פּ אַ נ ע ן
שפּאַס	ש פּ אַ ס
שפּאַקולן	ש פּ אַ ק ו ל ן
שפּאַר	ש פּ אַ ר
שפּאַרט	ש פּ אַ ר ט
שפּאַרן	ש פּ אַ ר ן
שפּאַרעניש	ש פּ אַ ר ע נ י ש
שפּאָגל	ש פּ אָ ג ל
שפּאָלע	ש פּ אָ ל ע
שתּחיה	ש תּ ח י ה
שבֿועה	ש בֿ ו ע ה
שבֿועות	ש בֿ ו ע ו ת
שבֿח	ש בֿ ח
שבֿט	ש בֿ ט
שבֿת	ש בֿ ת
תהילום	ת ה י ל ו ם
תוך	ת ו ך
תורה	ת ו ר ה
תלמידי־הכמים	ת ל מ י ד י ־ ה כ מ י ם
תענית	ת ע נ י ת
תשובה	ת ש ו ב ה
תבֿואה	ת בֿ ו א ה
תפֿילה	ת פֿ י ל ה
װי	װ י
װיג	װ י ג
װיגט	װ י ג ט
װיגל	װ י ג ל
װיגן	װ י ג ן
װיגקינד	װ י ג ק י נ ד
װידער	װ י ד ע ר
װידערװילן	װ י ד ע ר װ י ל ן
װידעראַנאַנד	װ י ד ע ר אַ נ אַ נ ד
װיזיט	װ י ז י ט
װיטע	װ י ט ע
װיכטיק	װ י כ ט י ק
װיכטיקן	װ י כ ט י ק ן
װיכטיקס	װ י כ ט י ק ס
װיל	װ י ל
װילד	װ י ל ד
װילט	װ י ל ט
װילן	װ י ל ן
װילנדיק	װ י ל נ ד י ק
װילנער	װ י ל נ ע ר
װילסט	װ י ל ס ט
װילסטו	װ י ל ס ט ו
װילעדזש	װ י ל ע ד ז ש
װילעדזש־ייִדן	װ י ל ע ד ז ש ־ י יִ ד ן
װימאָראָזיג	װ י מ אָ ר אָ ז י ג
װין	װ י ן
װינד	װ י נ ד
װינט	װ י נ ט
װינטמיל	װ י נ ט מ י ל
װינטן	װ י נ ט ן
װינטער	װ י נ ט ע ר
װינטערדיקע	װ י נ ט ע ר ד י ק ע
װינטש	װ י נ ט ש
װינטשט	װ י נ ט ש ט
װינטשן	װ י נ ט ש ן
װינטשנדיק	װ י נ ט ש נ ד י ק
װינציקער	װ י נ צ י ק ע ר
װינקט	װ י נ ק ט
װינקל	װ י נ ק ל
װינקלען	װ י נ ק ל ע ן
װינקען	װ י נ ק ע ן
װיסט	װ י ס ט
װיסטע	װ י ס ט ע
װיסן	װ י ס ן
װיסנדיק	װ י ס נ ד י ק
װיסאָצקין	װ י ס אָ צ ק י ן
װיץ	װ י ץ
װיציק	װ י צ י ק
װירובאָװאַ	װ י ר ו ב אָ װ אַ
װירקלעך	װ י ר ק ל ע ך
װישט	װ י ש ט
װישניצער	װ י ש נ י צ ע ר
װישניק	װ י ש נ י ק
װיפֿל	װ י פֿ ל
װעג	װ ע ג
װעגן	װ ע ג ן
װעגס	װ ע ג ס
װעגעלע	װ ע ג ע ל ע
װעדליק	װ ע ד ל י ק
װעט	װ ע ט
װעטעניש	װ ע ט ע נ י ש
װעטשערע	װ ע ט ש ע ר ע
װעכטער	װ ע כ ט ע ר
װעל	װ ע ל
װעלדל	װ ע ל ד ל
װעלדער	װ ע ל ד ע ר
װעלט	װ ע ל ט
װעלטזאַכן	װ ע ל ט ז אַ כ ן
װעלטן	װ ע ל ט ן
װעלכן	װ ע ל כ ן
װעלכע	װ ע ל כ ע
װעלכער	װ ע ל כ ע ר
װעלן	װ ע ל ן
װעלעדער	װ ע ל ע ד ע ר
װעלף	װ ע ל ף
װעלװעלער	װ ע ל װ ע ל ע ר
װעם	װ ע ם
װעמען	װ ע מ ע ן
װען	װ ע ן
װענדט	װ ע נ ד ט
װענדן	װ ע נ ד ן
װענט	װ ע נ ט
װעסט	װ ע ס ט
װעסטו	װ ע ס ט ו
װעקט	װ ע ק ט
װעקן	װ ע ק ן
װעקסל	װ ע ק ס ל
װעקסן	װ ע ק ס ן
װער	װ ע ר
װערט	װ ע ר ט
װערטל	װ ע ר ט ל
װערטלזאָגער	װ ע ר ט ל ז אָ ג ע ר
װערטעלע	װ ע ר ט ע ל ע
װערטער	װ ע ר ט ע ר
װערי	װ ע ר י
װערים	װ ע ר י ם
װערן	װ ע ר ן
װערסט	װ ע ר ס ט
װערק	װ ע ר ק
װערקע	װ ע ר ק ע
װעש	װ ע ש
װױל	װ ױ ל
װױלטאָן	װ ױ ל ט אָ ן
װױלע	װ ױ ל ע
װױנט	װ ױ נ ט
װױנען	װ ױ נ ע ן
װײ	װ ײ
װײדל	װ ײ ד ל
װײדלען	װ ײ ד ל ע ן
װײטיק	װ ײ ט י ק
װײך	װ ײ ך
װײכע	װ ײ כ ע
װײכער	װ ײ כ ע ר
װײנט	װ ײ נ ט
װײניק	װ ײ נ י ק
װײניקער	װ ײ נ י ק ע ר
װײנען	װ ײ נ ע ן
װײנענדיקע	װ ײ נ ע נ ד י ק ע
װײס	װ ײ ס
װײסט	װ ײ ס ט
װײסטו	װ ײ ס ט ו
װײסן	װ ײ ס ן
װײסער	װ ײ ס ע ר
װײץ	װ ײ ץ
װיִ	װ יִ
װײַ	װ ײַ
װײַב	װ ײַ ב
װײַבל	װ ײַ ב ל
װײַבער	װ ײַ ב ע ר
װײַבעריש	װ ײַ ב ע ר י ש
װײַבערישע	װ ײַ ב ע ר י ש ע
װײַבערישער	װ ײַ ב ע ר י ש ע ר
װײַבערשול	װ ײַ ב ע ר ש ו ל
װײַבערשע	װ ײַ ב ע ר ש ע
װײַז	װ ײַ ז
װײַזט	װ ײַ ז ט
װײַזט־אָן	װ ײַ ז ט ־ אָ ן
װײַזן	װ ײַ ז ן
װײַזערס	װ ײַ ז ע ר ס
װײַט	װ ײַ ט
װײַט־געעפֿנטע	װ ײַ ט ־ ג ע ע פֿ נ ט ע
װײַטנס	װ ײַ ט נ ס
װײַטע	װ ײַ ט ע
װײַטער	װ ײַ ט ע ר
װײַל	װ ײַ ל
װײַלע	װ ײַ ל ע
װײַן	װ ײַ ן
װײַנגאָרטן	װ ײַ נ ג אָ ר ט ן
װײַס	װ ײַ ס
װײַסל	װ ײַ ס ל
װײַסלעכער	װ ײַ ס ל ע כ ע ר
װײַסן	װ ײַ ס ן
װײַסע	װ ײַ ס ע
װײַסע־חברהניקעס	װ ײַ ס ע ־ ח ב ר ה נ י ק ע ס
װײַסע־חבֿרה'ניקעס	װ ײַ ס ע ־ ח בֿ ר ה ' נ י ק ע ס
װאַגמײַסטער	װ אַ ג מ ײַ ס ט ע ר
װאַגאָן	װ אַ ג אָ ן
װאַגאָן־אָפּטײלונג	װ אַ ג אָ ן ־ אָ פּ ט ײ ל ו נ ג
װאַזשנע	װ אַ ז ש נ ע
װאַכנדיקן	װ אַ כ נ ד י ק ן
װאַל	װ אַ ל
װאַלגערן	װ אַ ל ג ע ר ן
װאַלד	װ אַ ל ד
װאַלד־אױס	װ אַ ל ד ־ א ױ ס
װאַליזקע	װ אַ ל י ז ק ע
װאַלעהײד	װ אַ ל ע ה ײ ד
װאַנדערונגען	װ אַ נ ד ע ר ו נ ג ע ן
װאַנדערט	װ אַ נ ד ע ר ט
װאַנדערן	װ אַ נ ד ע ר ן
װאַנט	װ אַ נ ט
װאַנטוך	װ אַ נ ט ו ך
װאַנטזײגער	װ אַ נ ט ז ײ ג ע ר
װאַנען	װ אַ נ ע ן
װאַנצן	װ אַ נ צ ן
װאַנאַן	װ אַ נ אַ ן
װאַסיל	װ אַ ס י ל
װאַסילקאָװ	װ אַ ס י ל ק אָ װ
װאַסער	װ אַ ס ע ר
װאַסער־טרעגער	װ אַ ס ע ר ־ ט ר ע ג ע ר
װאַסער־ליליען	װ אַ ס ע ר ־ ל י ל י ע ן
װאַסער־פֿירערס	װ אַ ס ע ר ־ פֿ י ר ע ר ס
װאַסערדיקע	װ אַ ס ע ר ד י ק ע
װאַסערלעך	װ אַ ס ע ר ל ע ך
װאַסערן	װ אַ ס ע ר ן
װאַקסט	װ אַ ק ס ט
װאַקסן	װ אַ ק ס ן
װאַקסענע	װ אַ ק ס ע נ ע
װאַר	װ אַ ר
װאַרום	װ אַ ר ו ם
װאַרט	װ אַ ר ט
װאַרטן	װ אַ ר ט ן
װאַרטנדיק	װ אַ ר ט נ ד י ק
װאַרע	װ אַ ר ע
װאַרעם	װ אַ ר ע ם
װאַרעמס	װ אַ ר ע מ ס
װאַרעמע	װ אַ ר ע מ ע
װאַרעמער	װ אַ ר ע מ ע ר
װאַרף	װ אַ ר ף
װאַרשע	װ אַ ר ש ע
װאַרשאַװסקי	װ אַ ר ש אַ װ ס ק י
װאַרשאַװסקין	װ אַ ר ש אַ װ ס ק י ן
װאַרשאַװסקיס	װ אַ ר ש אַ װ ס ק י ס
װאַרפֿט	װ אַ ר פֿ ט
װאַרפֿן	װ אַ ר פֿ ן
װאַשט	װ אַ ש ט
װאַשי	װ אַ ש י
װאַשן	װ אַ ש ן
װאָגן	װ אָ ג ן
װאָיטעק	װ אָ י ט ע ק
װאָך	װ אָ ך
װאָכן	װ אָ כ ן
װאָכנס	װ אָ כ נ ס
װאָכעדיקן	װ אָ כ ע ד י ק ן
װאָכערער	װ אָ כ ע ר ע ר
װאָלט	װ אָ ל ט
װאָלטן	װ אָ ל ט ן
װאָלן	װ אָ ל ן
װאָלקן	װ אָ ל ק ן
װאָלקנס	װ אָ ל ק נ ס
װאָנצעס	װ אָ נ צ ע ס
װאָס	װ אָ ס
װאָס־זשע	װ אָ ס ־ ז ש ע
װאָסער	װ אָ ס ע ר
װאָרום	װ אָ ר ו ם
װאָרט	װ אָ ר ט
װאָרעם	װ אָ ר ע ם
װאָרף	װ אָ ר ף
װאָרצלען	װ אָ ר צ ל ע ן
װאָש	װ אָ ש
װוּ	װ וּ
װוּהין	װ וּ ה י ן
װוּנד	װ וּ נ ד
װוּנדער	װ וּ נ ד ע ר
װוּנדער־שײן	װ וּ נ ד ע ר ־ ש ײ ן
װוּנדערבאַרן	װ וּ נ ד ע ר ב אַ ר ן
װוּנדערלעכע	װ וּ נ ד ע ר ל ע כ ע
װוּנק	װ וּ נ ק
װוּקס	װ וּ ק ס
ױדױ	ױ ד ױ
ױהי	ױ ה י
ױהמו	ױ ה מ ו
ױחיו	ױ ח י ו
ױטבֿוּ	ױ ט בֿ וּ
ױלנע	ױ ל נ ע
ױסע	ױ ס ע
ױעשׂו	ױ ע שׂ ו
ױתן	ױ ת ן
ײדן	ײ ד ן
יִיד	יִ י ד
יִידינע	יִ י ד י נ ע
יִידיש	יִ י ד י ש
יִידישיסטן	יִ י ד י ש י ס ט ן
יִידישן	יִ י ד י ש ן
יִידישע	יִ י ד י ש ע
יִידישער	יִ י ד י ש ע ר
יִידישקײט	יִ י ד י ש ק ײ ט
יִידל	יִ י ד ל
יִידן	יִ י ד ן
יִידעלע	יִ י ד ע ל ע
יִידעלעך	יִ י ד ע ל ע ך
יִידענע	יִ י ד ע נ ע
יִידענעס	יִ י ד ע נ ע ס
יִינגל	יִ י נ ג ל
יִינגלעך	יִ י נ ג ל ע ך
יִינגערע	יִ י נ ג ע ר ע
יִישובֿ־הדעת	יִ י ש ו בֿ ־ ה ד ע ת
שׂוטה	שׂ ו ט ה
שׂונא	שׂ ו נ א
שׂונאים	שׂ ו נ א י ם
שׂונה־ישׂראל	שׂ ו נ ה ־ י שׂ ר א ל
שׂטן	שׂ ט ן
שׂימחה	שׂ י מ ח ה
שׂימחתנו	שׂ י מ ח ת נ ו
שׂין	שׂ י ן
שׂכירות	שׂ כ י ר ו ת
שׂכל	שׂ כ ל
שׂמחה	שׂ מ ח ה
שׂמחות	שׂ מ ח ו ת
שׂמחת	שׂ מ ח ת
שׂמחת־תּורה	שׂ מ ח ת ־ תּ ו ר ה
שׂרה	שׂ ר ה
שׂררה	שׂ ר ר ה
שׂררות	שׂ ר ר ו ת
שׂרפֿה	שׂ ר פֿ ה
אַ	אַ
אַ'	אַ '
אַ־אין	אַ ־ א י ן
אַבי	אַ ב י
אַברהם	אַ ב ר ה ם
אַבראַקאַדאַבראַ	אַ ב ר אַ ק אַ ד אַ ב ר אַ
אַגרעס	אַ ג ר ע ס
אַגבֿ	אַ ג בֿ
אַדורך	אַ ד ו ר ך
אַדורכגעשפּאַרט	אַ ד ו ר כ ג ע ש פּ אַ ר ט
אַדרעס	אַ ד ר ע ס
אַדװאָקאַט	אַ ד װ אָ ק אַ ט
אַדװאָקאַטן	אַ ד װ אָ ק אַ ט ן
אַהין	אַ ה י ן
אַהינגעקומען	אַ ה י נ ג ע ק ו מ ע ן
אַהער	אַ ה ע ר
אַהערפֿאָרנדיק	אַ ה ע ר פֿ אָ ר נ ד י ק
אַהײם	אַ ה ײ ם
אַהײמגעגאַנגען	אַ ה ײ מ ג ע ג אַ נ ג ע ן
אַהײמגעקומען	אַ ה ײ מ ג ע ק ו מ ע ן
אַהײמגעשיקט	אַ ה ײ מ ג ע ש י ק ט
אַהײמגײן	אַ ה ײ מ ג ײ ן
אַהײמצוגײן	אַ ה ײ מ צ ו ג ײ ן
אַהײמצוקומען	אַ ה ײ מ צ ו ק ו מ ע ן
אַהאַ	אַ ה אַ
אַהבֿת	אַ ה בֿ ת
אַודאי	אַ ו ד א י
אַז	אַ ז
אַזדוביסטאַן	אַ ז ד ו ב י ס ט אַ ן
אַזעלכע	אַ ז ע ל כ ע
אַזעלכענע	אַ ז ע ל כ ע נ ע
אַזעלכער	אַ ז ע ל כ ע ר
אַזש	אַ ז ש
אַזױ	אַ ז ױ
אַזױנס	אַ ז ױ נ ס
אַזױנע	אַ ז ױ נ ע
אַזױנעם	אַ ז ױ נ ע ם
אַזױנער	אַ ז ױ נ ע ר
אַזאַ	אַ ז אַ
אַחדות	אַ ח ד ו ת
אַחוץ	אַ ח ו ץ
אַחר	אַ ח ר
אַטעסטאַט	אַ ט ע ס ט אַ ט
אַכט	אַ כ ט
אַכטונג	אַ כ ט ו נ ג
אַכילה	אַ כ י ל ה
אַכסניא	אַ כ ס נ י א
אַכסניה	אַ כ ס נ י ה
אַכציק	אַ כ צ י ק
אַכצן	אַ כ צ ן
אַכצנהונדערט	אַ כ צ נ ה ו נ ד ע ר ט
אַל	אַ ל
אַל־פּי	אַ ל ־ פּ י
אַלדי	אַ ל ד י
אַלט	אַ ל ט
אַלט־אַלט	אַ ל ט ־ אַ ל ט
אַלטבאַקאָנטער	אַ ל ט ב אַ ק אָ נ ט ע ר
אַלטן	אַ ל ט ן
אַלטס	אַ ל ט ס
אַלטע	אַ ל ט ע
אַלטעלע	אַ ל ט ע ל ע
אַלטער	אַ ל ט ע ר
אַלטערטום־פֿאָרשער	אַ ל ט ע ר ט ו ם ־ פֿ אָ ר ש ע ר
אַלמן	אַ ל מ ן
אַלמנה	אַ ל מ נ ה
אַלס	אַ ל ס
אַלסדינג	אַ ל ס ד י נ ג
אַלע	אַ ל ע
אַלעם	אַ ל ע ם
אַלעמען	אַ ל ע מ ע ן
אַלעמענס	אַ ל ע מ ע נ ס
אַלעס	אַ ל ע ס
אַלעקסאַנדער	אַ ל ע ק ס אַ נ ד ע ר
אַלערלײ	אַ ל ע ר ל ײ
אַלף־בית	אַ ל ף ־ ב י ת
אַלץ	אַ ל ץ
אַלצדינג	אַ ל צ ד י נ ג
אַלשיך	אַ ל ש י ך
אַלײן	אַ ל ײ ן
אַלאַבאַסטער	אַ ל אַ ב אַ ס ט ע ר
אַם	אַ ם
אַמער	אַ מ ע ר
אַמעריקע	אַ מ ע ר י ק ע
אַמעריקאַניזירט	אַ מ ע ר י ק אַ נ י ז י ר ט
אַמעריקאַניזירן	אַ מ ע ר י ק אַ נ י ז י ר ן
אַמעריקאַניזם	אַ מ ע ר י ק אַ נ י ז ם
אַמעריקאַנער	אַ מ ע ר י ק אַ נ ע ר
אַמאָל	אַ מ אָ ל
אַמאָליקע	אַ מ אָ ל י ק ע
אַן	אַ ן
אַנדער	אַ נ ד ע ר
אַנדערטהאַלבן	אַ נ ד ע ר ט ה אַ ל ב ן
אַנדערן	אַ נ ד ע ר ן
אַנדערע	אַ נ ד ע ר ע
אַנדערער	אַ נ ד ע ר ע ר
אַנדערש	אַ נ ד ע ר ש
אַנומלט	אַ נ ו מ ל ט
אַנומלטן	אַ נ ו מ ל ט ן
אַנטגאַנגען	אַ נ ט ג אַ נ ג ע ן
אַנטדרעמלט	אַ נ ט ד ר ע מ ל ט
אַנטיסעמיט	אַ נ ט י ס ע מ י ט
אַנטיק	אַ נ ט י ק
אַנטיקלעך	אַ נ ט י ק ל ע ך
אַנטלױף	אַ נ ט ל ױ ף
אַנטלױפֿט	אַ נ ט ל ױ פֿ ט
אַנטלױפֿן	אַ נ ט ל ױ פֿ ן
אַנטלױפֿנדיק	אַ נ ט ל ױ פֿ נ ד י ק
אַנטלאָפֿן	אַ נ ט ל אָ פֿ ן
אַנטקעגן	אַ נ ט ק ע ג ן
אַנטקעגנגעשטעלט	אַ נ ט ק ע ג נ ג ע ש ט ע ל ט
אַנטשליסן	אַ נ ט ש ל י ס ן
אַנטשלאָפֿן	אַ נ ט ש ל אָ פֿ ן
אַנטפּלעקט	אַ נ ט פּ ל ע ק ט
אַנידער	אַ נ י ד ע ר
אַנידערגעלײגט	אַ נ י ד ע ר ג ע ל ײ ג ט
אַנידערלײגן	אַ נ י ד ע ר ל ײ ג ן
אַניט	אַ נ י ט
אַנעקדאָטן	אַ נ ע ק ד אָ ט ן
אַנשטאַלט	אַ נ ש ט אַ ל ט
אַנשטאָט	אַ נ ש ט אָ ט
אַנשל	אַ נ ש ל
אַנשלן	אַ נ ש ל ן
אַנשלס	אַ נ ש ל ס
אַנאַנד	אַ נ אַ נ ד
אַנאַרכיסט	אַ נ אַ ר כ י ס ט
אַסנע	אַ ס נ ע
אַסרן	אַ ס ר ן
אַצונד	אַ צ ו נ ד
אַצינד	אַ צ י נ ד
אַקוראַט	אַ ק ו ר אַ ט
אַקט	אַ ק ט
אַקטיאָר	אַ ק ט י אָ ר
אַקטיאָרן	אַ ק ט י אָ ר ן
אַקטן	אַ ק ט ן
אַקס	אַ ק ס
אַקסל	אַ ק ס ל
אַקסן	אַ ק ס ן
אַקעגן	אַ ק ע ג ן
אַקעגניבער	אַ ק ע ג נ י ב ע ר
אַקציע	אַ ק צ י ע
אַר	אַ ר
אַרבע־כּנפֿות	אַ ר ב ע ־ כּ נ פֿ ו ת
אַרבעט	אַ ר ב ע ט
אַרבעטן	אַ ר ב ע ט ן
אַרבעטסט	אַ ר ב ע ט ס ט
אַרום	אַ ר ו ם
אַרומגעגאַנגען	אַ ר ו מ ג ע ג אַ נ ג ע ן
אַרומגעדרײט	אַ ר ו מ ג ע ד ר ײ ט
אַרומגעכאַפּט	אַ ר ו מ ג ע כ אַ פּ ט
אַרומגעלאָפֿן	אַ ר ו מ ג ע ל אָ פֿ ן
אַרומגעקוקט	אַ ר ו מ ג ע ק ו ק ט
אַרומגעשטעקט	אַ ר ו מ ג ע ש ט ע ק ט
אַרומגעשװעבט	אַ ר ו מ ג ע ש װ ע ב ט
אַרומגעװיקלט	אַ ר ו מ ג ע װ י ק ל ט
אַרומגעװאַלגערט	אַ ר ו מ ג ע װ אַ ל ג ע ר ט
אַרומגעפּלאָנטערט	אַ ר ו מ ג ע פּ ל אָ נ ט ע ר ט
אַרומגײן	אַ ר ו מ ג ײ ן
אַרומזען	אַ ר ו מ ז ע ן
אַרומלױפֿן	אַ ר ו מ ל ױ פֿ ן
אַרומװאַלגערן	אַ ר ו מ װ אַ ל ג ע ר ן
אַרומפֿאָרן	אַ ר ו מ פֿ אָ ר ן
אַרט	אַ ר ט
אַרטיסטן	אַ ר ט י ס ט ן
אַריבער	אַ ר י ב ע ר
אַריבערגעצױגן	אַ ר י ב ע ר ג ע צ ױ ג ן
אַריבערגעשפּאַנט	אַ ר י ב ע ר ג ע ש פּ אַ נ ט
אַריבערטראָגן	אַ ר י ב ע ר ט ר אָ ג ן
אַריבערפֿירן	אַ ר י ב ע ר פֿ י ר ן
אַרן	אַ ר ן
אַרענדע	אַ ר ע נ ד ע
אַרעסט	אַ ר ע ס ט
אַרױס	אַ ר ױ ס
אַרױסגעבן	אַ ר ױ ס ג ע ב ן
אַרױסגעגעבן	אַ ר ױ ס ג ע ג ע ב ן
אַרױסגעגאַנגען	אַ ר ױ ס ג ע ג אַ נ ג ע ן
אַרױסגעדרונגען	אַ ר ױ ס ג ע ד ר ו נ ג ע ן
אַרױסגעזאָגט	אַ ר ױ ס ג ע ז אָ ג ט
אַרױסגעטריבן	אַ ר ױ ס ג ע ט ר י ב ן
אַרױסגעכאַפּט	אַ ר ױ ס ג ע כ אַ פּ ט
אַרױסגעלאָזט	אַ ר ױ ס ג ע ל אָ ז ט
אַרױסגעלאָזן	אַ ר ױ ס ג ע ל אָ ז ן
אַרױסגעלאָפֿן	אַ ר ױ ס ג ע ל אָ פֿ ן
אַרױסגעמשלחט	אַ ר ױ ס ג ע מ ש ל ח ט
אַרױסגענומען	אַ ר ױ ס ג ע נ ו מ ע ן
אַרױסגעקומען	אַ ר ױ ס ג ע ק ו מ ע ן
אַרױסגעקוקט	אַ ר ױ ס ג ע ק ו ק ט
אַרױסגעקראָכן	אַ ר ױ ס ג ע ק ר אָ כ ן
אַרױסגעריסן	אַ ר ױ ס ג ע ר י ס ן
אַרױסגערעדט	אַ ר ױ ס ג ע ר ע ד ט
אַרױסגערױטלט	אַ ר ױ ס ג ע ר ױ ט ל ט
אַרױסגעשטעלט	אַ ר ױ ס ג ע ש ט ע ל ט
אַרױסגעשטעקט	אַ ר ױ ס ג ע ש ט ע ק ט
אַרױסגעשטרעקטער	אַ ר ױ ס ג ע ש ט ר ע ק ט ע ר
אַרױסגעשלעפּט	אַ ר ױ ס ג ע ש ל ע פּ ט
אַרױסגעװיזן	אַ ר ױ ס ג ע װ י ז ן
אַרױסגעװאָרפֿן	אַ ר ױ ס ג ע װ אָ ר פֿ ן
אַרױסגעפֿאָרן	אַ ר ױ ס ג ע פֿ אָ ר ן
אַרױסגײן	אַ ר ױ ס ג ײ ן
אַרױסדרײען	אַ ר ױ ס ד ר ײ ע ן
אַרױסזען	אַ ר ױ ס ז ע ן
אַרױסזעצן	אַ ר ױ ס ז ע צ ן
אַרױסטרעטן	אַ ר ױ ס ט ר ע ט ן
אַרױסטראָגן	אַ ר ױ ס ט ר אָ ג ן
אַרױסלאָזן	אַ ר ױ ס ל אָ ז ן
אַרױסנעמען	אַ ר ױ ס נ ע מ ע ן
אַרױסצולױפֿן	אַ ר ױ ס צ ו ל ױ פֿ ן
אַרױסצולאָזן	אַ ר ױ ס צ ו ל אָ ז ן
אַרױסצוּװאַרפֿן	אַ ר ױ ס צ וּ װ אַ ר פֿ ן
אַרױסרײַסן	אַ ר ױ ס ר ײַ ס ן
אַרױסװאַרפֿן	אַ ר ױ ס װ אַ ר פֿ ן
אַרױף	אַ ר ױ ף
אַרױפֿגעזעצט	אַ ר ױ פֿ ג ע ז ע צ ט
אַרױפֿגעלײגט	אַ ר ױ פֿ ג ע ל ײ ג ט
אַרױפֿגענומען	אַ ר ױ פֿ ג ע נ ו מ ע ן
אַרױפֿגעקראָכן	אַ ר ױ פֿ ג ע ק ר אָ כ ן
אַרױפֿגערוקטן	אַ ר ױ פֿ ג ע ר ו ק ט ן
אַרױפֿגעפֿלאַטערט	אַ ר ױ פֿ ג ע פֿ ל אַ ט ע ר ט
אַרױפֿגײן	אַ ר ױ פֿ ג ײ ן
אַרױפֿלײגן	אַ ר ױ פֿ ל ײ ג ן
אַרױפֿקומען	אַ ר ױ פֿ ק ו מ ע ן
אַרױפֿאַרבעטן	אַ ר ױ פֿ אַ ר ב ע ט ן
אַרײנדזשמענטס	אַ ר ײ נ ד ז ש מ ע נ ט ס
אַרײַן	אַ ר ײַ ן
אַרײַנברענגען	אַ ר ײַ נ ב ר ע נ ג ע ן
אַרײַנגעבן	אַ ר ײַ נ ג ע ב ן
אַרײַנגעבראָקט	אַ ר ײַ נ ג ע ב ר אָ ק ט
אַרײַנגעדרײט	אַ ר ײַ נ ג ע ד ר ײ ט
אַרײַנגעטראָגן	אַ ר ײַ נ ג ע ט ר אָ ג ן
אַרײַנגעטאָן	אַ ר ײַ נ ג ע ט אָ ן
אַרײַנגעכאַפּט	אַ ר ײַ נ ג ע כ אַ פּ ט
אַרײַנגעלײגט	אַ ר ײַ נ ג ע ל ײ ג ט
אַרײַנגעלאָפֿן	אַ ר ײַ נ ג ע ל אָ פֿ ן
אַרײַנגענומען	אַ ר ײַ נ ג ע נ ו מ ע ן
אַרײַנגעקומען	אַ ר ײַ נ ג ע ק ו מ ע ן
אַרײַנגעקוקט	אַ ר ײַ נ ג ע ק ו ק ט
אַרײַנגערעכנט	אַ ר ײַ נ ג ע ר ע כ נ ט
אַרײַנגעשטעלט	אַ ר ײַ נ ג ע ש ט ע ל ט
אַרײַנגעשריִען	אַ ר ײַ נ ג ע ש ר יִ ע ן
אַרײַנגעװאָרצלט	אַ ר ײַ נ ג ע װ אָ ר צ ל ט
אַרײַנגעװאָרפֿן	אַ ר ײַ נ ג ע װ אָ ר פֿ ן
אַרײַנגעפּלאָנטערט	אַ ר ײַ נ ג ע פּ ל אָ נ ט ע ר ט
אַרײַנגעפֿאַלן	אַ ר ײַ נ ג ע פֿ אַ ל ן
אַרײַנלײגנדיק	אַ ר ײַ נ ל ײ ג נ ד י ק
אַרײַנלאָזן	אַ ר ײַ נ ל אָ ז ן
אַרײַנקוקן	אַ ר ײַ נ ק ו ק ן
אַרײַנװאַרפֿן	אַ ר ײַ נ װ אַ ר פֿ ן
אַרײַנפֿאַלן	אַ ר ײַ נ פֿ אַ ל ן
אַראָפּ	אַ ר אָ פּ
אַראָפּבײגן	אַ ר אָ פּ ב ײ ג ן
אַראָפּגעבראַכט	אַ ר אָ פּ ג ע ב ר אַ כ ט
אַראָפּגעגנבֿעט	אַ ר אָ פּ ג ע ג נ בֿ ע ט
אַראָפּגעכאַפּט	אַ ר אָ פּ ג ע כ אַ פּ ט
אַראָפּגעלאָזט	אַ ר אָ פּ ג ע ל אָ ז ט
אַראָפּגעלאָזטן	אַ ר אָ פּ ג ע ל אָ ז ט ן
אַראָפּגעלאָזטע	אַ ר אָ פּ ג ע ל אָ ז ט ע
אַראָפּגעלאָזטער	אַ ר אָ פּ ג ע ל אָ ז ט ע ר
אַראָפּגענומען	אַ ר אָ פּ ג ע נ ו מ ע ן
אַראָפּגעקוקט	אַ ר אָ פּ ג ע ק ו ק ט
אַראָפּגערוקט	אַ ר אָ פּ ג ע ר ו ק ט
אַראָפּגעשלונגען	אַ ר אָ פּ ג ע ש ל ו נ ג ע ן
אַראָפּגעשריגן	אַ ר אָ פּ ג ע ש ר י ג ן
אַראָפּגעשפּרונגען	אַ ר אָ פּ ג ע ש פּ ר ו נ ג ע ן
אַראָפּגעװאָרפֿן	אַ ר אָ פּ ג ע װ אָ ר פֿ ן
אַראָפּגעװוּנקען	אַ ר אָ פּ ג ע װ וּ נ ק ע ן
אַראָפּגעפֿאַלן	אַ ר אָ פּ ג ע פֿ אַ ל ן
אַראָפּפֿאָרן	אַ ר אָ פּ פֿ אָ ר ן
אַש	אַ ש
אַשר	אַ ש ר
אַשרי	אַ ש ר י
אַװדאי	אַ װ ד א י
אַװעק	אַ װ ע ק
אַװעקגעבן	אַ װ ע ק ג ע ב ן
אַװעקגעגעבן	אַ װ ע ק ג ע ג ע ב ן
אַװעקגעגאַנגען	אַ װ ע ק ג ע ג אַ נ ג ע ן
אַװעקגעזעצט	אַ װ ע ק ג ע ז ע צ ט
אַװעקגעחלשט	אַ װ ע ק ג ע ח ל ש ט
אַװעקגעלײגט	אַ װ ע ק ג ע ל ײ ג ט
אַװעקגענומען	אַ װ ע ק ג ע נ ו מ ע ן
אַװעקגערופֿן	אַ װ ע ק ג ע ר ו פֿ ן
אַװעקגעשטעלט	אַ װ ע ק ג ע ש ט ע ל ט
אַװעקגעפֿירט	אַ װ ע ק ג ע פֿ י ר ט
אַװעקגעפֿאַלן	אַ װ ע ק ג ע פֿ אַ ל ן
אַװעקגײן	אַ װ ע ק ג ײ ן
אַװעקזעצן	אַ װ ע ק ז ע צ ן
אַװעקיאָגן	אַ װ ע ק י אָ ג ן
אַװעקלאָזן	אַ װ ע ק ל אָ ז ן
אַװעקמאַכן	אַ װ ע ק מ אַ כ ן
אַװעקצוגײן	אַ װ ע ק צ ו ג ײ ן
אַװעקצורוקן	אַ װ ע ק צ ו ר ו ק ן
אַװעקצורײַסן	אַ װ ע ק צ ו ר ײַ ס ן
אַװעקשלײַדערן	אַ װ ע ק ש ל ײַ ד ע ר ן
אַװעקפֿליען	אַ װ ע ק פֿ ל י ע ן
אַײ	אַ ײ
אַײז	אַ ײ ז
אַײזיק	אַ ײ ז י ק
אַײזיק־מאיר	אַ ײ ז י ק ־ מ א י ר
אַײך	אַ ײ ך
אַײלן	אַ ײ ל ן
אַײלעניש	אַ ײ ל ע נ י ש
אַײן	אַ ײ ן
אַײנגעגעסענע	אַ ײ נ ג ע ג ע ס ע נ ע
אַײנגעהערט	אַ ײ נ ג ע ה ע ר ט
אַײנגעזונקען	אַ ײ נ ג ע ז ו נ ק ע ן
אַײנגעלאָדן	אַ ײ נ ג ע ל אָ ד ן
אַײנגעשטימט	אַ ײ נ ג ע ש ט י מ ט
אַײנגעשריבן	אַ ײ נ ג ע ש ר י ב ן
אַײנגעשפּאַנט	אַ ײ נ ג ע ש פּ אַ נ ט
אַײנגעװיגט	אַ ײ נ ג ע װ י ג ט
אַײנגעװיקלט	אַ ײ נ ג ע װ י ק ל ט
אַײנגעאָרדנט	אַ ײ נ ג ע אָ ר ד נ ט
אַײננעמען	אַ ײ נ נ ע מ ע ן
אַײנעסן	אַ ײ נ ע ס ן
אַײנפֿעדעמען	אַ ײ נ פֿ ע ד ע מ ע ן
אַײנפֿאַלן	אַ ײ נ פֿ אַ ל ן
אַײער	אַ ײ ע ר
אַײערס	אַ ײ ע ר ס
אַײערע	אַ ײ ע ר ע
אַײערער	אַ ײ ע ר ע ר
אַיִיאושדיקער	אַ יִ י א ו ש ד י ק ע ר
אַפּיקורס	אַ פּ י ק ו ר ס
אַפּיקורסים	אַ פּ י ק ו ר ס י ם
אַפּלאָדיסמענטן	אַ פּ ל אָ ד י ס מ ע נ ט ן
אַפּעטיט	אַ פּ ע ט י ט
אַבֿ־בית־דין	אַ בֿ ־ ב י ת ־ ד י ן
אַבֿן־טובֿ	אַ בֿ ן ־ ט ו בֿ
אַבֿרהם	אַ בֿ ר ה ם
אַפֿילו	אַ פֿ י ל ו
אַפֿיר	אַ פֿ י ר
אַפֿער	אַ פֿ ע ר
אָ	אָ
אָביסק	אָ ב י ס ק
אָבער	אָ ב ע ר
אָדון	אָ ד ו ן
אָדער	אָ ד ע ר
אָט	אָ ט
אָט־דאָ	אָ ט ־ ד אָ
אָטבער	אָ ט ב ע ר
אָטעם	אָ ט ע ם
אָטעמט	אָ ט ע מ ט
אָטעמען	אָ ט ע מ ע ן
אָטשערעדע	אָ ט ש ע ר ע ד ע
אָך	אָ ך
אָמן	אָ מ ן
אָן	אָ ן
אָנבײַסן	אָ נ ב ײַ ס ן
אָנבאַלאַנגט	אָ נ ב אַ ל אַ נ ג ט
אָנבאָטן	אָ נ ב אָ ט ן
אָנגעביסן	אָ נ ג ע ב י ס ן
אָנגעבױגן	אָ נ ג ע ב ױ ג ן
אָנגעבאַקן	אָ נ ג ע ב אַ ק ן
אָנגעגרײט	אָ נ ג ע ג ר ײ ט
אָנגעגאַנגען	אָ נ ג ע ג אַ נ ג ע ן
אָנגעגאָסן	אָ נ ג ע ג אָ ס ן
אָנגעדרײט	אָ נ ג ע ד ר ײ ט
אָנגעדראָלענע	אָ נ ג ע ד ר אָ ל ע נ ע
אָנגעהױבן	אָ נ ג ע ה ױ ב ן
אָנגעהױיבן	אָ נ ג ע ה ױ י ב ן
אָנגעזליאָקעט	אָ נ ג ע ז ל י אָ ק ע ט
אָנגעזען	אָ נ ג ע ז ע ן
אָנגעזאָגט	אָ נ ג ע ז אָ ג ט
אָנגעזאָלעט	אָ נ ג ע ז אָ ל ע ט
אָנגעטוענער	אָ נ ג ע ט ו ע נ ע ר
אָנגעטראָגן	אָ נ ג ע ט ר אָ ג ן
אָנגעטראָפֿן	אָ נ ג ע ט ר אָ פֿ ן
אָנגעטאָן	אָ נ ג ע ט אָ ן
אָנגעכאַפּט	אָ נ ג ע כ אַ פּ ט
אָנגעלענט	אָ נ ג ע ל ע נ ט
אָנגעלײגט	אָ נ ג ע ל ײ ג ט
אָנגעמאַכט	אָ נ ג ע מ אַ כ ט
אָנגענומען	אָ נ ג ע נ ו מ ע ן
אָנגעצונדן	אָ נ ג ע צ ו נ ד ן
אָנגעקומען	אָ נ ג ע ק ו מ ע ן
אָנגעקליבן	אָ נ ג ע ק ל י ב ן
אָנגעקלעפּט	אָ נ ג ע ק ל ע פּ ט
אָנגעקלאַפּט	אָ נ ג ע ק ל אַ פּ ט
אָנגעקערט	אָ נ ג ע ק ע ר ט
אָנגערופֿן	אָ נ ג ע ר ו פֿ ן
אָנגערירט	אָ נ ג ע ר י ר ט
אָנגעשטױסן	אָ נ ג ע ש ט ױ ס ן
אָנגעשטאָפּט	אָ נ ג ע ש ט אָ פּ ט
אָנגעשמירטע	אָ נ ג ע ש מ י ר ט ע
אָנגעשמעקט	אָ נ ג ע ש מ ע ק ט
אָנגעשריבן	אָ נ ג ע ש ר י ב ן
אָנגעשװאָלענע	אָ נ ג ע ש װ אָ ל ע נ ע
אָנגעשפּיגן	אָ נ ג ע ש פּ י ג ן
אָנגעשפּאַרט	אָ נ ג ע ש פּ אַ ר ט
אָנגעװיזן	אָ נ ג ע װ י ז ן
אָנגעפּעלצטע	אָ נ ג ע פּ ע ל צ ט ע
אָנגעפּראָפּט	אָ נ ג ע פּ ר אָ פּ ט
אָנגעפּאַקט	אָ נ ג ע פּ אַ ק ט
אָנגעפֿלױגן	אָ נ ג ע פֿ ל ױ ג ן
אָנגעפֿאַלן	אָ נ ג ע פֿ אַ ל ן
אָנגעפֿאָרן	אָ נ ג ע פֿ אָ ר ן
אָנגײן	אָ נ ג ײ ן
אָנהײב	אָ נ ה ײ ב
אָנהײצן	אָ נ ה ײ צ ן
אָנזעצער	אָ נ ז ע צ ע ר
אָנחידושן	אָ נ ח י ד ו ש ן
אָנטרױען	אָ נ ט ר ױ ע ן
אָנטאָן	אָ נ ט אָ ן
אָנכאַפּן	אָ נ כ אַ פּ ן
אָנלײגן	אָ נ ל ײ ג ן
אָנמעסטן	אָ נ מ ע ס ט ן
אָננעמען	אָ נ נ ע מ ע ן
אָננײען	אָ נ נ ײ ע ן
אָנערקענען	אָ נ ע ר ק ע נ ע ן
אָנצוג	אָ נ צ ו ג
אָנצוהערענישן	אָ נ צ ו ה ע ר ע נ י ש ן
אָנצוהױבן	אָ נ צ ו ה ױ ב ן
אָנצוזאָגן	אָ נ צ ו ז אָ ג ן
אָנצוטאַפּן	אָ נ צ ו ט אַ פּ ן
אָנצוטאָן	אָ נ צ ו ט אָ ן
אָנצוקומען	אָ נ צ ו ק ו מ ע ן
אָנצוקוקן	אָ נ צ ו ק ו ק ן
אָנצורופֿן	אָ נ צ ו ר ו פֿ ן
אָנצינדן	אָ נ צ י נ ד ן
אָנציען	אָ נ צ י ע ן
אָנקומען	אָ נ ק ו מ ע ן
אָנקוקן	אָ נ ק ו ק ן
אָנקװעלן	אָ נ ק װ ע ל ן
אָנשטאָט	אָ נ ש ט אָ ט
אָנשיקעניש	אָ נ ש י ק ע נ י ש
אָנשיקענישן	אָ נ ש י ק ע נ י ש ן
אָנשלאָגן	אָ נ ש ל אָ ג ן
אָנשרײַבן	אָ נ ש ר ײַ ב ן
אָנװינטשעװען	אָ נ װ י נ ט ש ע װ ע ן
אָנװעזנדיקע	אָ נ װ ע ז נ ד י ק ע
אָנװעזנדע	אָ נ װ ע ז נ ד ע
אָנװענדן	אָ נ װ ע נ ד ן
אָנװערן	אָ נ װ ע ר ן
אָנפֿאַנג	אָ נ פֿ אַ נ ג
אָסור	אָ ס ו ר
אָסטראַ	אָ ס ט ר אַ
אָקסן	אָ ק ס ן
אָקעװיט	אָ ק ע װ י ט
אָקאָרשט	אָ ק אָ ר ש ט
אָרגיע	אָ ר ג י ע
אָרדענונג	אָ ר ד ע נ ו נ ג
אָרון	אָ ר ו ן
אָרט	אָ ר ט
אָרימער	אָ ר י מ ע ר
אָרימאַן	אָ ר י מ אַ ן
אָרעם	אָ ר ע ם
אָרעמס	אָ ר ע מ ס
אָרעמע	אָ ר ע מ ע
אָרעמע־לײַט	אָ ר ע מ ע ־ ל ײַ ט
אָרעמער	אָ ר ע מ ע ר
אָרעמקײט	אָ ר ע מ ק ײ ט
אָרעמאַן	אָ ר ע מ אַ ן
אָװנט	אָ װ נ ט
אָװנט־װינטל	אָ װ נ ט ־ װ י נ ט ל
אָװנטן	אָ װ נ ט ן
אָפּ	אָ פּ
אָפּבענטשן	אָ פּ ב ע נ ט ש ן
אָפּבײַטן	אָ פּ ב ײַ ט ן
אָפּגעבן	אָ פּ ג ע ב ן
אָפּגעברענט	אָ פּ ג ע ב ר ע נ ט
אָפּגעגילדטע	אָ פּ ג ע ג י ל ד ט ע
אָפּגעגעסן	אָ פּ ג ע ג ע ס ן
אָפּגעגריזשעטע	אָ פּ ג ע ג ר י ז ש ע ט ע
אָפּגעגאַנגען	אָ פּ ג ע ג אַ נ ג ע ן
אָפּגעגאָסן	אָ פּ ג ע ג אָ ס ן
אָפּגעדאַװנט	אָ פּ ג ע ד אַ װ נ ט
אָפּגעהאַקטע	אָ פּ ג ע ה אַ ק ט ע
אָפּגעהאָרעװעטער	אָ פּ ג ע ה אָ ר ע װ ע ט ע ר
אָפּגעזעגנט	אָ פּ ג ע ז ע ג נ ט
אָפּגעזאָגט	אָ פּ ג ע ז אָ ג ט
אָפּגעטרונקען	אָ פּ ג ע ט ר ו נ ק ע ן
אָפּגעטרײסלט	אָ פּ ג ע ט ר ײ ס ל ט
אָפּגעטראָטן	אָ פּ ג ע ט ר אָ ט ן
אָפּגעטאָן	אָ פּ ג ע ט אָ ן
אָפּגעכאַפּט	אָ פּ ג ע כ אַ פּ ט
אָפּגעלײגט	אָ פּ ג ע ל ײ ג ט
אָפּגעלײזט	אָ פּ ג ע ל ײ ז ט
אָפּגעלײקנט	אָ פּ ג ע ל ײ ק נ ט
אָפּגעלאָזט	אָ פּ ג ע ל אָ ז ט
אָפּגעלאָפֿן	אָ פּ ג ע ל אָ פֿ ן
אָפּגעמישפּט	אָ פּ ג ע מ י ש פּ ט
אָפּגעמאָסטן	אָ פּ ג ע מ אָ ס ט ן
אָפּגענאַרט	אָ פּ ג ע נ אַ ר ט
אָפּגעענטפֿערט	אָ פּ ג ע ע נ ט פֿ ע ר ט
אָפּגעצײכנט	אָ פּ ג ע צ ײ כ נ ט
אָפּגעקומען	אָ פּ ג ע ק ו מ ע ן
אָפּגעקינדלט	אָ פּ ג ע ק י נ ד ל ט
אָפּגעקלונגען	אָ פּ ג ע ק ל ו נ ג ע ן
אָפּגעקערט	אָ פּ ג ע ק ע ר ט
אָפּגעקאָסט	אָ פּ ג ע ק אָ ס ט
אָפּגערופֿן	אָ פּ ג ע ר ו פֿ ן
אָפּגעריבענע	אָ פּ ג ע ר י ב ע נ ע
אָפּגעריבענעם	אָ פּ ג ע ר י ב ע נ ע ם
אָפּגעריסן	אָ פּ ג ע ר י ס ן
אָפּגעריסענע	אָ פּ ג ע ר י ס ע נ ע
אָפּגערעדטער	אָ פּ ג ע ר ע ד ט ע ר
אָפּגעשטעלט	אָ פּ ג ע ש ט ע ל ט
אָפּגעשטאַנען	אָ פּ ג ע ש ט אַ נ ע ן
אָפּגעשיקט	אָ פּ ג ע ש י ק ט
אָפּגעשלעפּט	אָ פּ ג ע ש ל ע פּ ט
אָפּגעשלאָפֿן	אָ פּ ג ע ש ל אָ פֿ ן
אָפּגעשמועסט	אָ פּ ג ע ש מ ו ע ס ט
אָפּגעשניטן	אָ פּ ג ע ש נ י ט ן
אָפּגעשניטענע	אָ פּ ג ע ש נ י ט ע נ ע
אָפּגעשריבן	אָ פּ ג ע ש ר י ב ן
אָפּגעװישט	אָ פּ ג ע װ י ש ט
אָפּגעװײנען	אָ פּ ג ע װ ײ נ ע ן
אָפּגעאָטעמט	אָ פּ ג ע אָ ט ע מ ט
אָפּגעפּוצטע	אָ פּ ג ע פּ ו צ ט ע
אָפּגעפֿרױרן	אָ פּ ג ע פֿ ר ױ ר ן
אָפּגעפֿאַלענע	אָ פּ ג ע פֿ אַ ל ע נ ע
אָפּגעפֿאַרטיקט	אָ פּ ג ע פֿ אַ ר ט י ק ט
אָפּגעפֿאָנפֿעט	אָ פּ ג ע פֿ אָ נ פֿ ע ט
אָפּגעפֿאָרן	אָ פּ ג ע פֿ אָ ר ן
אָפּגרונט	אָ פּ ג ר ו נ ט
אָפּדרוקן	אָ פּ ד ר ו ק ן
אָפּדרײען	אָ פּ ד ר ײ ע ן
אָפּזיצן	אָ פּ ז י צ ן
אָפּטשעפּען	אָ פּ ט ש ע פּ ע ן
אָפּטײלן	אָ פּ ט ײ ל ן
אָפּטאָן	אָ פּ ט אָ ן
אָפּלױבן	אָ פּ ל ױ ב ן
אָפּמעקן	אָ פּ מ ע ק ן
אָפּנעמען	אָ פּ נ ע מ ע ן
אָפּעראַציע	אָ פּ ע ר אַ צ י ע
אָפּעראַציעס	אָ פּ ע ר אַ צ י ע ס
אָפּצודאַנקען	אָ פּ צ ו ד אַ נ ק ע ן
אָפּצולױבן	אָ פּ צ ו ל ױ ב ן
אָפּצונעמען	אָ פּ צ ו נ ע מ ע ן
אָפּקערן	אָ פּ ק ע ר ן
אָפּקאָסטן	אָ פּ ק אָ ס ט ן
אָפּרוען	אָ פּ ר ו ע ן
אָפּריכטן	אָ פּ ר י כ ט ן
אָפּשלאָפֿן	אָ פּ ש ל אָ פֿ ן
אָפּשרעקען	אָ פּ ש ר ע ק ע ן
אָפּשײד	אָ פּ ש ײ ד
אָפּװאַרטן	אָ פּ װ אַ ר ט ן
אָפּװאַרטנדיק	אָ פּ װ אַ ר ט נ ד י ק
אָפּאָטעמען	אָ פּ אָ ט ע מ ע ן
אָפּפֿירן	אָ פּ פֿ י ר ן
אָפּפֿאַסטן	אָ פּ פֿ אַ ס ט ן
אָפּפֿאָרן	אָ פּ פֿ אָ ר ן
אָבֿות־אַבֿותינו	אָ בֿ ו ת ־ אַ בֿ ו ת י נ ו
אָבֿינו	אָ בֿ י נ ו
אָפֿט	אָ פֿ ט
אָפֿן	אָ פֿ ן
אָפֿענע	אָ פֿ ע נ ע
אָפֿענער	אָ פֿ ע נ ע ר
כּאשר	כּ א ש ר
כּבוד	כּ ב ו ד
כּדאי	כּ ד א י
כּדי	כּ ד י
כּוח	כּ ו ח
כּוחות	כּ ו ח ו ת
כּוסות	כּ ו ס ו ת
כּורעים	כּ ו ר ע י ם
כּח	כּ ח
כּיד־המלך	כּ י ד ־ ה מ ל ך
כּישוף	כּ י ש ו ף
כּישוף־מעשׂהלע	כּ י ש ו ף ־ מ ע שׂ ה ל ע
כּישוף־מאַכער	כּ י ש ו ף ־ מ אַ כ ע ר
כּך	כּ ך
כּל	כּ ל
כּל־זמן	כּ ל ־ ז מ ן
כּל־נדרי	כּ ל ־ נ ד ר י
כּלה	כּ ל ה
כּלה־מײדלעך	כּ ל ה ־ מ ײ ד ל ע ך
כּלהס	כּ ל ה ס
כּלי־בית	כּ ל י ־ ב י ת
כּלי־זמר	כּ ל י ־ ז מ ר
כּלים	כּ ל י ם
כּלל	כּ ל ל
כּמה	כּ מ ה
כּמו	כּ מ ו
כּמעט	כּ מ ע ט
כּן	כּ ן
כּסדר	כּ ס ד ר
כּסרילעװקע	כּ ס ר י ל ע װ ק ע
כּעני	כּ ע נ י
כּעס	כּ ע ס
כּעסן	כּ ע ס ן
כּף	כּ ף
כּף־הקל	כּ ף ־ ה ק ל
כּשר	כּ ש ר
כּשרה	כּ ש ר ה
כּשרן	כּ ש ר ן
כּשרע	כּ ש ר ע
כּשרער	כּ ש ר ע ר
כּתב־רבאַ	כּ ת ב ־ ר ב אַ
כּתובֿה	כּ ת ו בֿ ה
כּתרילעװקע	כּ ת ר י ל ע װ ק ע
כּתרילעװקער	כּ ת ר י ל ע װ ק ע ר
כּתבֿ	כּ ת בֿ
כּתבֿים	כּ ת בֿ י ם
כּװנה	כּ װ נ ה
כּפּור	כּ פּ ו ר
כּפּרה	כּ פּ ר ה
כּפּרות	כּ פּ ר ו ת
כּבֿוא	כּ בֿ ו א
כּבֿוד	כּ בֿ ו ד
כּבֿיכול	כּ בֿ י כ ו ל
כּפֿתּור־ופֿרח	כּ פֿ תּ ו ר ־ ו פֿ ר ח
פּ	פּ
פּאה	פּ א ה
פּאות	פּ א ו ת
פּגימה	פּ ג י מ ה
פּגרען	פּ ג ר ע ן
פּדיון־הבן	פּ ד י ו ן ־ ה ב ן
פּדיון־הבנס	פּ ד י ו ן ־ ה ב נ ס
פּוד	פּ ו ד
פּוטער	פּ ו ט ע ר
פּוכענע	פּ ו כ ע נ ע
פּולקע	פּ ו ל ק ע
פּולקעס	פּ ו ל ק ע ס
פּונקט	פּ ו נ ק ט
פּוסט	פּ ו ס ט
פּועל	פּ ו ע ל
פּועלן	פּ ו ע ל ן
פּורים	פּ ו ר י ם
פּורים־קױלעטש	פּ ו ר י ם ־ ק ױ ל ע ט ש
פּורים־שפּילער	פּ ו ר י ם ־ ש פּ י ל ע ר
פּוריק	פּ ו ר י ק
פּושע־ישׂראל	פּ ו ש ע ־ י שׂ ר א ל
פּושקעלעך	פּ ו ש ק ע ל ע ך
פּחד	פּ ח ד
פּטום	פּ ט ו ם
פּטור	פּ ט ו ר
פּיזם	פּ י ז ם
פּיזמון	פּ י ז מ ו ן
פּינכאַסיק	פּ י נ כ אַ ס י ק
פּיסק	פּ י ס ק
פּיעסנעס	פּ י ע ס נ ע ס
פּיעסע	פּ י ע ס ע
פּיצל	פּ י צ ל
פּיצלעך	פּ י צ ל ע ך
פּיק	פּ י ק
פּיקהאָלץ	פּ י ק ה אָ ל ץ
פּיקט	פּ י ק ט
פּיקטשורס	פּ י ק ט ש ו ר ס
פּיקן	פּ י ק ן
פּיקאַנטע	פּ י ק אַ נ ט ע
פּירוש	פּ י ר ו ש
פּישטשען	פּ י ש ט ש ע ן
פּיאַנע	פּ י אַ נ ע
פּיפּערנאָטער	פּ י פּ ע ר נ אָ ט ע ר
פּיפּקע	פּ י פּ ק ע
פּיפּקעט	פּ י פּ ק ע ט
פּלאי־פּלאים	פּ ל א י ־ פּ ל א י ם
פּלודערן	פּ ל ו ד ע ר ן
פּלומפּל	פּ ל ו מ פּ ל
פּלוניתטע	פּ ל ו נ י ת ט ע
פּלוצים	פּ ל ו צ י ם
פּלוצלונג	פּ ל ו צ ל ו נ ג
פּלוצלינג	פּ ל ו צ ל י נ ג
פּלוצעם	פּ ל ו צ ע ם
פּליאות	פּ ל י א ו ת
פּליושקען	פּ ל י ו ש ק ע ן
פּלעװע	פּ ל ע װ ע
פּלױט	פּ ל ױ ט
פּלײצע	פּ ל ײ צ ע
פּלײצעס	פּ ל ײ צ ע ס
פּלאַטשיקער	פּ ל אַ ט ש י ק ע ר
פּלאַכטע	פּ ל אַ כ ט ע
פּלאַן	פּ ל אַ ן
פּלאַץ	פּ ל אַ ץ
פּנים	פּ נ י ם
פּנימל	פּ נ י מ ל
פּנימער	פּ נ י מ ע ר
פּנקס	פּ נ ק ס
פּסולע	פּ ס ו ל ע
פּסוק	פּ ס ו ק
פּסוקים	פּ ס ו ק י ם
פּסח	פּ ס ח
פּסחדיקער	פּ ס ח ד י ק ע ר
פּסיכאָלאָגישע	פּ ס י כ אָ ל אָ ג י ש ע
פּסק	פּ ס ק
פּסקענען	פּ ס ק ע נ ע ן
פּעטש	פּ ע ט ש
פּעך	פּ ע ך
פּעך־שװאַרצע	פּ ע ך ־ ש װ אַ ר צ ע
פּעל	פּ ע ל
פּעלערינע	פּ ע ל ע ר י נ ע
פּען	פּ ע ן
פּענע	פּ ע נ ע
פּעקל	פּ ע ק ל
פּעקלעך	פּ ע ק ל ע ך
פּערזאָנען	פּ ע ר ז אָ נ ע ן
פּערל	פּ ע ר ל
פּערעלע	פּ ע ר ע ל ע
פּערעלעך	פּ ע ר ע ל ע ך
פּקדון	פּ ק ד ו ן
פּרוטה	פּ ר ו ט ה
פּרוכת	פּ ר ו כ ת
פּרטים	פּ ר ט י ם
פּריזבע	פּ ר י ז ב ע
פּריזיװ	פּ ר י ז י װ
פּריטשמעליעט	פּ ר י ט ש מ ע ל י ע ט
פּרימע	פּ ר י מ ע
פּרינציפּיעלער	פּ ר י נ צ י פּ י ע ל ע ר
פּריץ	פּ ר י ץ
פּריצים	פּ ר י צ י ם
פּריצס	פּ ר י צ ס
פּריקאַזטשיק	פּ ר י ק אַ ז ט ש י ק
פּרישטשיקלעך	פּ ר י ש ט ש י ק ל ע ך
פּריפּעטשיק	פּ ר י פּ ע ט ש י ק
פּרנסה	פּ ר נ ס ה
פּרנסים	פּ ר נ ס י ם
פּרעזידענט	פּ ר ע ז י ד ע נ ט
פּרעזעס	פּ ר ע ז ע ס
פּרעטענזיע	פּ ר ע ט ע נ ז י ע
פּרעמיערע	פּ ר ע מ י ע ר ע
פּרק	פּ ר ק
פּראַקטיקע	פּ ר אַ ק ט י ק ע
פּראַװעט	פּ ר אַ װ ע ט
פּראָבן	פּ ר אָ ב ן
פּראָגראַמען	פּ ר אָ ג ר אַ מ ע ן
פּראָטעסט	פּ ר אָ ט ע ס ט
פּראָסט	פּ ר אָ ס ט
פּראָסטן	פּ ר אָ ס ט ן
פּראָסטע	פּ ר אָ ס ט ע
פּראָסטער	פּ ר אָ ס ט ע ר
פּראָסטאַק	פּ ר אָ ס ט אַ ק
פּראָצענט	פּ ר אָ צ ע נ ט
פּראָצענטניק	פּ ר אָ צ ע נ ט נ י ק
פּראָצעס	פּ ר אָ צ ע ס
פּראָשעק	פּ ר אָ ש ע ק
פּראָשקעס	פּ ר אָ ש ק ע ס
פּראָװיאַנט	פּ ר אָ װ י אַ נ ט
פּראָפֿעסער	פּ ר אָ פֿ ע ס ע ר
פּרוּװט	פּ ר וּ װ ט
פּשוט	פּ ש ו ט
פּשוטן	פּ ש ו ט ן
פּשוטע	פּ ש ו ט ע
פּשוטער	פּ ש ו ט ע ר
פּשט	פּ ש ט
פּױליש	פּ ױ ל י ש
פּױלן	פּ ױ ל ן
פּױער	פּ ױ ע ר
פּױערטעס	פּ ױ ע ר ט ע ס
פּױעריש	פּ ױ ע ר י ש
פּױערישן	פּ ױ ע ר י ש ן
פּױקט	פּ ױ ק ט
פּאַזע	פּ אַ ז ע
פּאַטשן	פּ אַ ט ש ן
פּאַלטן	פּ אַ ל ט ן
פּאַלאַץ	פּ אַ ל אַ ץ
פּאַמעלעך	פּ אַ מ ע ל ע ך
פּאַמעלעך־פּאַמעלעך	פּ אַ מ ע ל ע ך ־ פּ אַ מ ע ל ע ך
פּאַמעלעכן	פּ אַ מ ע ל ע כ ן
פּאַמעלעכע	פּ אַ מ ע ל ע כ ע
פּאַן	פּ אַ ן
פּאַנטאָפֿל־העלד	פּ אַ נ ט אָ פֿ ל ־ ה ע ל ד
פּאַנטאָפֿלעך	פּ אַ נ ט אָ פֿ ל ע ך
פּאַנטאָפֿעלעך	פּ אַ נ ט אָ פֿ ע ל ע ך
פּאַניע	פּ אַ נ י ע
פּאַנאַראַמע	פּ אַ נ אַ ר אַ מ ע
פּאַס	פּ אַ ס
פּאַסט	פּ אַ ס ט
פּאַסטוך	פּ אַ ס ט ו ך
פּאַסיק	פּ אַ ס י ק
פּאַסיקע	פּ אַ ס י ק ע
פּאַסירונג	פּ אַ ס י ר ו נ ג
פּאַסירט	פּ אַ ס י ר ט
פּאַסן	פּ אַ ס ן
פּאַסעליװשײסיאָ	פּ אַ ס ע ל י װ ש ײ ס י אָ
פּאַסעס	פּ אַ ס ע ס
פּאַסקודנע	פּ אַ ס ק ו ד נ ע
פּאַציענטן	פּ אַ צ י ע נ ט ן
פּאַקט	פּ אַ ק ט
פּאַקן	פּ אַ ק ן
פּאַקן־טרעגער	פּ אַ ק ן ־ ט ר ע ג ע ר
פּאַקנטרעגער	פּ אַ ק נ ט ר ע ג ע ר
פּאַרוסינע	פּ אַ ר ו ס י נ ע
פּאַרחאַטיע	פּ אַ ר ח אַ ט י ע
פּאַריז	פּ אַ ר י ז
פּאַריאַדאָק	פּ אַ ר י אַ ד אָ ק
פּאַרלער	פּ אַ ר ל ע ר
פּאַרע	פּ אַ ר ע
פּאַרשױן	פּ אַ ר ש ױ ן
פּאַרשױנען	פּ אַ ר ש ױ נ ע ן
פּאַראָבקעס	פּ אַ ר אָ ב ק ע ס
פּאַשעט	פּ אַ ש ע ט
פּאַװע	פּ אַ װ ע
פּאַפּיר	פּ אַ פּ י ר
פּאַפּירן	פּ אַ פּ י ר ן
פּאַפּיראָסל	פּ אַ פּ י ר אָ ס ל
פּאַפּיראָסן	פּ אַ פּ י ר אָ ס ן
פּאָגראָם	פּ אָ ג ר אָ ם
פּאָדלאָגע	פּ אָ ד ל אָ ג ע
פּאָדקאָװעס	פּ אָ ד ק אָ װ ע ס
פּאָדראַטשיק	פּ אָ ד ר אַ ט ש י ק
פּאָזע	פּ אָ ז ע
פּאָליטיקע	פּ אָ ל י ט י ק ע
פּאָליצײ	פּ אָ ל י צ ײ
פּאָלע	פּ אָ ל ע
פּאָלעס	פּ אָ ל ע ס
פּאָסט	פּ אָ ס ט
פּאָסטמײַסטער	פּ אָ ס ט מ ײַ ס ט ע ר
פּאָסעסער	פּ אָ ס ע ס ע ר
פּאָעמע	פּ אָ ע מ ע
פּאָקוס	פּ אָ ק ו ס
פּאָר	פּ אָ ר
פּאָריטש	פּ אָ ר י ט ש
פּאָרל	פּ אָ ר ל
פּאָראַדקעס	פּ אָ ר אַ ד ק ע ס
פּאָרפֿאָלק	פּ אָ ר פֿ אָ ל ק
פּאָפּירילע	פּ אָ פּ י ר י ל ע
פּאָפּערילע	פּ אָ פּ ע ר י ל ע
תּאוה	תּ א ו ה
תּוהו־ובוהו־	תּ ו ה ו ־ ו ב ו ה ו ־
תּוהו־ובוהו־װעלט	תּ ו ה ו ־ ו ב ו ה ו ־ װ ע ל ט
תּוך	תּ ו ך
תּוכחה	תּ ו כ ח ה
תּורה	תּ ו ר ה
תּורת־משה	תּ ו ר ת ־ מ ש ה
תּושבֿ	תּ ו ש בֿ
תּופֿס	תּ ו פֿ ס
תּחום־שבת	תּ ח ו ם ־ ש ב ת
תּחילת	תּ ח י ל ת
תּחינה	תּ ח י נ ה
תּחינות	תּ ח י נ ו ת
תּחתּונים	תּ ח תּ ו נ י ם
תּחתּית	תּ ח תּ י ת
תּימן	תּ י מ ן
תּיקון	תּ י ק ו ן
תּירוץ	תּ י ר ו ץ
תּירוצים	תּ י ר ו צ י ם
תּיכּף	תּ י כּ ף
תּכלית	תּ כ ל י ת
תּכריכים	תּ כ ר י כ י ם
תּכשיט	תּ כ ש י ט
תּל	תּ ל
תּלמוד	תּ ל מ ו ד
תּלמוד־תּורה	תּ ל מ ו ד ־ תּ ו ר ה
תּלמידי־בעל־שם	תּ ל מ י ד י ־ ב ע ל ־ ש ם
תּמיד	תּ מ י ד
תּמעװאַטע	תּ מ ע װ אַ ט ע
תּנאים	תּ נ א י ם
תּנחום	תּ נ ח ו ם
תּענית	תּ ע נ י ת
תּעניתים	תּ ע נ י ת י ם
תּרגום־לשון	תּ ר ג ו ם ־ ל ש ו ן
תּרעומות	תּ ר ע ו מ ו ת
תּשובה	תּ ש ו ב ה
תּשובֿה	תּ ש ו בֿ ה
תּאַװה	תּ אַ װ ה
תּבֿואה	תּ בֿ ו א ה
תּבֿואות	תּ בֿ ו א ו ת
תּבֿיעות	תּ בֿ י ע ו ת
תּפֿוצות	תּ פֿ ו צ ו ת
תּפֿילה	תּ פֿ י ל ה
תּפֿילהלע	תּ פֿ י ל ה ל ע
תּפֿילות	תּ פֿ י ל ו ת
תּפֿילין	תּ פֿ י ל י ן
תּפֿילין־בײַטעלע	תּ פֿ י ל י ן ־ ב ײַ ט ע ל ע
תּפֿיסה	תּ פֿ י ס ה
בֿיז	בֿ י ז
בֿית־מדרש	בֿ י ת ־ מ ד ר ש
בֿכן	בֿ כ ן
פֿוטער	פֿ ו ט ע ר
פֿוטערן	פֿ ו ט ע ר ן
פֿול	פֿ ו ל
פֿולן	פֿ ו ל ן
פֿולע	פֿ ו ל ע
פֿולער	פֿ ו ל ע ר
פֿון	פֿ ו ן
פֿונדעסטװעגן	פֿ ו נ ד ע ס ט װ ע ג ן
פֿונט	פֿ ו נ ט
פֿונעם	פֿ ו נ ע ם
פֿונקען	פֿ ו נ ק ע ן
פֿונאַנדערגעגאַנגען	פֿ ו נ אַ נ ד ע ר ג ע ג אַ נ ג ע ן
פֿונאַנדערגערעדט	פֿ ו נ אַ נ ד ע ר ג ע ר ע ד ט
פֿונאַנדערגעפֿאָרן	פֿ ו נ אַ נ ד ע ר ג ע פֿ אָ ר ן
פֿוס	פֿ ו ס
פֿוקסענעם	פֿ ו ק ס ע נ ע ם
פֿור	פֿ ו ר
פֿורמאַנישן	פֿ ו ר מ אַ נ י ש ן
פֿושער	פֿ ו ש ע ר
פֿופֿציק	פֿ ו פֿ צ י ק
פֿופֿצן	פֿ ו פֿ צ ן
פֿיל	פֿ י ל
פֿילט	פֿ י ל ט
פֿיליער	פֿ י ל י ע ר
פֿילן	פֿ י ל ן
פֿינגער	פֿ י נ ג ע ר
פֿינגערלעך	פֿ י נ ג ע ר ל ע ך
פֿינסטער	פֿ י נ ס ט ע ר
פֿינף	פֿ י נ ף
פֿינף־זעקס	פֿ י נ ף ־ ז ע ק ס
פֿינצטער	פֿ י נ צ ט ע ר
פֿינצטערן	פֿ י נ צ ט ע ר ן
פֿינצטערער	פֿ י נ צ ט ע ר ע ר
פֿינקלט	פֿ י נ ק ל ט
פֿינאַנץ־מיניסטער	פֿ י נ אַ נ ץ ־ מ י נ י ס ט ע ר
פֿיס	פֿ י ס
פֿיסלעך	פֿ י ס ל ע ך
פֿיר	פֿ י ר
פֿירט	פֿ י ר ט
פֿירמע	פֿ י ר מ ע
פֿירן	פֿ י ר ן
פֿיש	פֿ י ש
פֿלוס	פֿ ל ו ס
פֿלי	פֿ ל י
פֿליגל	פֿ ל י ג ל
פֿליט	פֿ ל י ט
פֿליטערלעך	פֿ ל י ט ע ר ל ע ך
פֿליסט	פֿ ל י ס ט
פֿליסנדיקן	פֿ ל י ס נ ד י ק ן
פֿליען	פֿ ל י ע ן
פֿלעג	פֿ ל ע ג
פֿלעגט	פֿ ל ע ג ט
פֿלעגן	פֿ ל ע ג ן
פֿלעם	פֿ ל ע ם
פֿלעשל	פֿ ל ע ש ל
פֿלױמען	פֿ ל ױ מ ע ן
פֿלױמען־צימעס	פֿ ל ױ מ ע ן ־ צ י מ ע ס
פֿלײש	פֿ ל ײ ש
פֿלאַטער	פֿ ל אַ ט ע ר
פֿלאַם	פֿ ל אַ ם
פֿלאַמט	פֿ ל אַ מ ט
פֿלאַקס	פֿ ל אַ ק ס
פֿלאַקערט	פֿ ל אַ ק ע ר ט
פֿעדעם	פֿ ע ד ע ם
פֿעדער	פֿ ע ד ע ר
פֿעדערן	פֿ ע ד ע ר ן
פֿעטע	פֿ ע ט ע
פֿעטער	פֿ ע ט ע ר
פֿעכן	פֿ ע כ ן
פֿעלד	פֿ ע ל ד
פֿעלד־בלומעלעך	פֿ ע ל ד ־ ב ל ו מ ע ל ע ך
פֿעלדער	פֿ ע ל ד ע ר
פֿעלדשער	פֿ ע ל ד ש ע ר
פֿעלז	פֿ ע ל ז
פֿעלט	פֿ ע ל ט
פֿעלן	פֿ ע ל ן
פֿעלעכלעך	פֿ ע ל ע כ ל ע ך
פֿעלשן	פֿ ע ל ש ן
פֿענסטער	פֿ ע נ ס ט ע ר
פֿענצטער	פֿ ע נ צ ט ע ר
פֿענצטערל	פֿ ע נ צ ט ע ר ל
פֿענצערל	פֿ ע נ צ ע ר ל
פֿעסט	פֿ ע ס ט
פֿעסטגעשטעלט	פֿ ע ס ט ג ע ש ט ע ל ט
פֿעסטן	פֿ ע ס ט ן
פֿעסל	פֿ ע ס ל
פֿערד	פֿ ע ר ד
פֿערדל	פֿ ע ר ד ל
פֿערדלס	פֿ ע ר ד ל ס
פֿערדס	פֿ ע ר ד ס
פֿערדעלע	פֿ ע ר ד ע ל ע
פֿערטל	פֿ ע ר ט ל
פֿערטער	פֿ ע ר ט ע ר
פֿערציק	פֿ ע ר צ י ק
פֿרום	פֿ ר ו ם
פֿרומע	פֿ ר ו מ ע
פֿרומער	פֿ ר ו מ ע ר
פֿרומקײט	פֿ ר ו מ ק ײ ט
פֿרי	פֿ ר י
פֿרילינג־נאַכט	פֿ ר י ל י נ ג ־ נ אַ כ ט
פֿרימער	פֿ ר י מ ע ר
פֿרימאָרגן	פֿ ר י מ אָ ר ג ן
פֿריער	פֿ ר י ע ר
פֿריערדיקן	פֿ ר י ע ר ד י ק ן
פֿריש	פֿ ר י ש
פֿרישע	פֿ ר י ש ע
פֿרישער	פֿ ר י ש ע ר
פֿרעג	פֿ ר ע ג
פֿרעג־געטאָן	פֿ ר ע ג ־ ג ע ט אָ ן
פֿרעגט	פֿ ר ע ג ט
פֿרעגן	פֿ ר ע ג ן
פֿרעגסט	פֿ ר ע ג ס ט
פֿרעמד	פֿ ר ע מ ד
פֿרעמדע	פֿ ר ע מ ד ע
פֿרעמדער	פֿ ר ע מ ד ע ר
פֿרעסט	פֿ ר ע ס ט
פֿרעק	פֿ ר ע ק
פֿרעש	פֿ ר ע ש
פֿרױ	פֿ ר ױ
פֿרײד	פֿ ר ײ ד
פֿרײדע־גיטל	פֿ ר ײ ד ע ־ ג י ט ל
פֿרײט	פֿ ר ײ ט
פֿרײלעך	פֿ ר ײ ל ע ך
פֿרײלעכן	פֿ ר ײ ל ע כ ן
פֿרײלעכסטער	פֿ ר ײ ל ע כ ס ט ע ר
פֿרײלעכע	פֿ ר ײ ל ע כ ע
פֿרײלעכער	פֿ ר ײ ל ע כ ע ר
פֿרײען	פֿ ר ײ ע ן
פֿריִען	פֿ ר יִ ע ן
פֿרײַ	פֿ ר ײַ
פֿרײַטיק	פֿ ר ײַ ט י ק
פֿרײַנד	פֿ ר ײַ נ ד
פֿרײַנדלעכע	פֿ ר ײַ נ ד ל ע כ ע
פֿרײַנט	פֿ ר ײַ נ ט
פֿרײַע	פֿ ר ײַ ע
פֿרײַען	פֿ ר ײַ ע ן
פֿראַנצױזיש	פֿ ר אַ נ צ ױ ז י ש
פֿראַנקרײַך	פֿ ר אַ נ ק ר ײַ ך
פֿראַסק	פֿ ר אַ ס ק
פֿראָסט	פֿ ר אָ ס ט
פֿױגל	פֿ ױ ג ל
פֿױל	פֿ ױ ל
פֿײגל	פֿ ײ ג ל
פֿײגעלע	פֿ ײ ג ע ל ע
פֿײַג	פֿ ײַ ג
פֿײַכט	פֿ ײַ כ ט
פֿײַכטע	פֿ ײַ כ ט ע
פֿײַל	פֿ ײַ ל
פֿײַן	פֿ ײַ ן
פֿײַנדע	פֿ ײַ נ ד ע
פֿײַנט	פֿ ײַ נ ט
פֿײַנסטע	פֿ ײַ נ ס ט ע
פֿײַנע	פֿ ײַ נ ע
פֿײַנפֿינקלקרױט	פֿ ײַ נ פֿ י נ ק ל ק ר ױ ט
פֿײַער	פֿ ײַ ע ר
פֿײַער־לעשערס	פֿ ײַ ע ר ־ ל ע ש ע ר ס
פֿײַערדיקע	פֿ ײַ ע ר ד י ק ע
פֿײַערל	פֿ ײַ ע ר ל
פֿײַערן	פֿ ײַ ע ר ן
פֿײַף	פֿ ײַ ף
פֿײַפֿט	פֿ ײַ פֿ ט
פֿײַפֿן	פֿ ײַ פֿ ן
פֿײַפֿער	פֿ ײַ פֿ ע ר
פֿאַבריק	פֿ אַ ב ר י ק
פֿאַבריקע	פֿ אַ ב ר י ק ע
פֿאַבריקאַנט	פֿ אַ ב ר י ק אַ נ ט
פֿאַטשײלע	פֿ אַ ט ש ײ ל ע
פֿאַטשײלעס	פֿ אַ ט ש ײ ל ע ס
פֿאַכן	פֿ אַ כ ן
פֿאַל	פֿ אַ ל
פֿאַלט	פֿ אַ ל ט
פֿאַלט־צו	פֿ אַ ל ט ־ צ ו
פֿאַלן	פֿ אַ ל ן
פֿאַלש	פֿ אַ ל ש
פֿאַלשס	פֿ אַ ל ש ס
פֿאַלשע	פֿ אַ ל ש ע
פֿאַמיליע־לעבן	פֿ אַ מ י ל י ע ־ ל ע ב ן
פֿאַמיליעס	פֿ אַ מ י ל י ע ס
פֿאַנטאַסטיק	פֿ אַ נ ט אַ ס ט י ק
פֿאַנאַנדערפֿאַלן	פֿ אַ נ אַ נ ד ע ר פֿ אַ ל ן
פֿאַסט	פֿ אַ ס ט
פֿאַסטן	פֿ אַ ס ט ן
פֿאַקטן	פֿ אַ ק ט ן
פֿאַר	פֿ אַ ר
פֿאַר'ן	פֿ אַ ר ' ן
פֿאַר־פּסח	פֿ אַ ר ־ פּ ס ח
פֿאַראומערט	פֿ אַ ר א ו מ ע ר ט
פֿאַראיבל	פֿ אַ ר א י ב ל
פֿאַראינטערעסירט	פֿ אַ ר א י נ ט ע ר ע ס י ר ט
פֿאַראײן	פֿ אַ ר א ײ ן
פֿאַראײניקונג	פֿ אַ ר א ײ נ י ק ו נ ג
פֿאַרב	פֿ אַ ר ב
פֿאַרבונדען	פֿ אַ ר ב ו נ ד ע ן
פֿאַרבלוטיקט	פֿ אַ ר ב ל ו ט י ק ט
פֿאַרבלענדט	פֿ אַ ר ב ל ע נ ד ט
פֿאַרבלאָנדזשעט	פֿ אַ ר ב ל אָ נ ד ז ש ע ט
פֿאַרבעטן	פֿ אַ ר ב ע ט ן
פֿאַרבעטענע	פֿ אַ ר ב ע ט ע נ ע
פֿאַרבענקט	פֿ אַ ר ב ע נ ק ט
פֿאַרברענגען	פֿ אַ ר ב ר ע נ ג ע ן
פֿאַרברענט	פֿ אַ ר ב ר ע נ ט
פֿאַרברענטע	פֿ אַ ר ב ר ע נ ט ע
פֿאַרברענען	פֿ אַ ר ב ר ע נ ע ן
פֿאַרבראַכט	פֿ אַ ר ב ר אַ כ ט
פֿאַרבראָכן	פֿ אַ ר ב ר אָ כ ן
פֿאַרבײַגעגאַנגען	פֿ אַ ר ב ײַ ג ע ג אַ נ ג ע ן
פֿאַרבאַנד	פֿ אַ ר ב אַ נ ד
פֿאַרבאָרגענע	פֿ אַ ר ב אָ ר ג ע נ ע
פֿאַרבאָרגענער	פֿ אַ ר ב אָ ר ג ע נ ע ר
פֿאַרגינען	פֿ אַ ר ג י נ ע ן
פֿאַרגליװערטע	פֿ אַ ר ג ל י װ ע ר ט ע
פֿאַרגעטערט	פֿ אַ ר ג ע ט ע ר ט
פֿאַרגעניגנס	פֿ אַ ר ג ע נ י ג נ ס
פֿאַרגעסט	פֿ אַ ר ג ע ס ט
פֿאַרגעסן	פֿ אַ ר ג ע ס ן
פֿאַרגעסנדיק	פֿ אַ ר ג ע ס נ ד י ק
פֿאַרגײן	פֿ אַ ר ג ײ ן
פֿאַרגאַנגען	פֿ אַ ר ג אַ נ ג ע ן
פֿאַרגאַפֿט	פֿ אַ ר ג אַ פֿ ט
פֿאַרדינט	פֿ אַ ר ד י נ ט
פֿאַרדינסט	פֿ אַ ר ד י נ ס ט
פֿאַרדינען	פֿ אַ ר ד י נ ע ן
פֿאַרדינערין	פֿ אַ ר ד י נ ע ר י ן
פֿאַרדריפּעטע	פֿ אַ ר ד ר י פּ ע ט ע
פֿאַרדרײט	פֿ אַ ר ד ר ײ ט
פֿאַרדרײען	פֿ אַ ר ד ר ײ ע ן
פֿאַרדאַנקען	פֿ אַ ר ד אַ נ ק ע ן
פֿאַרהונגערט	פֿ אַ ר ה ו נ ג ע ר ט
פֿאַרהוסט	פֿ אַ ר ה ו ס ט
פֿאַרהערן	פֿ אַ ר ה ע ר ן
פֿאַרהאַלטן	פֿ אַ ר ה אַ ל ט ן
פֿאַרהאָרעװעטע	פֿ אַ ר ה אָ ר ע װ ע ט ע
פֿאַרומערן	פֿ אַ ר ו מ ע ר ן
פֿאַרזוכט	פֿ אַ ר ז ו כ ט
פֿאַרזוכן	פֿ אַ ר ז ו כ ן
פֿאַרזונקען	פֿ אַ ר ז ו נ ק ע ן
פֿאַרזיכטיק	פֿ אַ ר ז י כ ט י ק
פֿאַרזינדיקן	פֿ אַ ר ז י נ ד י ק ן
פֿאַרזען	פֿ אַ ר ז ע ן
פֿאַרזעצט	פֿ אַ ר ז ע צ ט
פֿאַרזעצן	פֿ אַ ר ז ע צ ן
פֿאַרזאָגן	פֿ אַ ר ז אָ ג ן
פֿאַרזאָרגט	פֿ אַ ר ז אָ ר ג ט
פֿאַרזאָרגן	פֿ אַ ר ז אָ ר ג ן
פֿאַרזאָרגער	פֿ אַ ר ז אָ ר ג ע ר
פֿאַרחידושט	פֿ אַ ר ח י ד ו ש ט
פֿאַרחלומט	פֿ אַ ר ח ל ו מ ט
פֿאַרחתמטן	פֿ אַ ר ח ת מ ט ן
פֿאַרטומלטער	פֿ אַ ר ט ו מ ל ט ע ר
פֿאַרטיק	פֿ אַ ר ט י ק
פֿאַרטעכער	פֿ אַ ר ט ע כ ע ר
פֿאַרטריבן	פֿ אַ ר ט ר י ב ן
פֿאַרטרינקען	פֿ אַ ר ט ר י נ ק ע ן
פֿאַרטרױט	פֿ אַ ר ט ר ױ ט
פֿאַרטרײַב	פֿ אַ ר ט ר ײַ ב
פֿאַרטראַכט	פֿ אַ ר ט ר אַ כ ט
פֿאַרטשעפּען	פֿ אַ ר ט ש ע פּ ע ן
פֿאַרטאַראַראַמט	פֿ אַ ר ט אַ ר אַ ר אַ מ ט
פֿאַריבל	פֿ אַ ר י ב ל
פֿאַריאָגט	פֿ אַ ר י אָ ג ט
פֿאַרכליניעט	פֿ אַ ר כ ל י נ י ע ט
פֿאַרכאַפּט	פֿ אַ ר כ אַ פּ ט
פֿאַרליבעניש	פֿ אַ ר ל י ב ע נ י ש
פֿאַרלירט	פֿ אַ ר ל י ר ט
פֿאַרלעגער	פֿ אַ ר ל ע ג ע ר
פֿאַרלעשן	פֿ אַ ר ל ע ש ן
פֿאַרלױרן	פֿ אַ ר ל ױ ר ן
פֿאַרלײגט	פֿ אַ ר ל ײ ג ט
פֿאַרלײגטע	פֿ אַ ר ל ײ ג ט ע
פֿאַרלאַג	פֿ אַ ר ל אַ ג
פֿאַרלאַנגט	פֿ אַ ר ל אַ נ ג ט
פֿאַרלאַנגען	פֿ אַ ר ל אַ נ ג ע ן
פֿאַרלאָזט	פֿ אַ ר ל אָ ז ט
פֿאַרלאָזן	פֿ אַ ר ל אָ ז ן
פֿאַרלאָפֿן	פֿ אַ ר ל אָ פֿ ן
פֿאַרמעג	פֿ אַ ר מ ע ג
פֿאַרמעגן	פֿ אַ ר מ ע ג ן
פֿאַרמשפּט	פֿ אַ ר מ ש פּ ט
פֿאַרמאַכט	פֿ אַ ר מ אַ כ ט
פֿאַרמאַכן	פֿ אַ ר מ אַ כ ן
פֿאַרמאָג	פֿ אַ ר מ אָ ג
פֿאַרמאָגט	פֿ אַ ר מ אָ ג ט
פֿאַרן	פֿ אַ ר ן
פֿאַרנודעטן	פֿ אַ ר נ ו ד ע ט ן
פֿאַרנודעטער	פֿ אַ ר נ ו ד ע ט ע ר
פֿאַרנומען	פֿ אַ ר נ ו מ ע ן
פֿאַרנעפּלטע	פֿ אַ ר נ ע פּ ל ט ע
פֿאַרנאַכט	פֿ אַ ר נ אַ כ ט
פֿאַרסמאָלעװעטע	פֿ אַ ר ס מ אָ ל ע װ ע ט ע
פֿאַרענדיקט	פֿ אַ ר ע נ ד י ק ט
פֿאַרענטפֿערן	פֿ אַ ר ע נ ט פֿ ע ר ן
פֿאַרצוקערט	פֿ אַ ר צ ו ק ע ר ט
פֿאַרצרהט	פֿ אַ ר צ ר ה ט
פֿאַרצװײפֿלטן	פֿ אַ ר צ װ ײ פֿ ל ט ן
פֿאַרצװײפֿלטע	פֿ אַ ר צ װ ײ פֿ ל ט ע
פֿאַרצײכנטער	פֿ אַ ר צ ײ כ נ ט ע ר
פֿאַרצײלט	פֿ אַ ר צ ײ ל ט
פֿאַרצײלן	פֿ אַ ר צ ײ ל ן
פֿאַרצײַטנס	פֿ אַ ר צ ײַ ט נ ס
פֿאַרקוקט	פֿ אַ ר ק ו ק ט
פֿאַרקילונג	פֿ אַ ר ק י ל ו נ ג
פֿאַרקלאָגט	פֿ אַ ר ק ל אָ ג ט
פֿאַרקניפּן	פֿ אַ ר ק נ י פּ ן
פֿאַרקנסן	פֿ אַ ר ק נ ס ן
פֿאַרקנעפּלט	פֿ אַ ר ק נ ע פּ ל ט
פֿאַרקעמט	פֿ אַ ר ק ע מ ט
פֿאַרקערעװעט	פֿ אַ ר ק ע ר ע װ ע ט
פֿאַרקרומט	פֿ אַ ר ק ר ו מ ט
פֿאַרקראָכן	פֿ אַ ר ק ר אָ כ ן
פֿאַרקױפֿט	פֿ אַ ר ק ױ פֿ ט
פֿאַרקױפֿן	פֿ אַ ר ק ױ פֿ ן
פֿאַרקײטלען	פֿ אַ ר ק ײ ט ל ע ן
פֿאַרקאָכט	פֿ אַ ר ק אָ כ ט
פֿאַרשטיקט	פֿ אַ ר ש ט י ק ט
פֿאַרשטעלט	פֿ אַ ר ש ט ע ל ט
פֿאַרשטעלטער	פֿ אַ ר ש ט ע ל ט ע ר
פֿאַרשטעק	פֿ אַ ר ש ט ע ק
פֿאַרשטערט	פֿ אַ ר ש ט ע ר ט
פֿאַרשטערטן	פֿ אַ ר ש ט ע ר ט ן
פֿאַרשטערטע	פֿ אַ ר ש ט ע ר ט ע
פֿאַרשטױבט	פֿ אַ ר ש ט ױ ב ט
פֿאַרשטײ	פֿ אַ ר ש ט ײ
פֿאַרשטײט	פֿ אַ ר ש ט ײ ט
פֿאַרשטײן	פֿ אַ ר ש ט ײ ן
פֿאַרשטײען	פֿ אַ ר ש ט ײ ע ן
פֿאַרשטאַנד	פֿ אַ ר ש ט אַ נ ד
פֿאַרשטאַנען	פֿ אַ ר ש ט אַ נ ע ן
פֿאַרשטאַרט	פֿ אַ ר ש ט אַ ר ט
פֿאַרשטאָפּן	פֿ אַ ר ש ט אָ פּ ן
פֿאַרשידענע	פֿ אַ ר ש י ד ע נ ע
פֿאַרשיט	פֿ אַ ר ש י ט
פֿאַרשימלט	פֿ אַ ר ש י מ ל ט
פֿאַרשיקט	פֿ אַ ר ש י ק ט
פֿאַרשליסט	פֿ אַ ר ש ל י ס ט
פֿאַרשלעפּטע	פֿ אַ ר ש ל ע פּ ט ע
פֿאַרשלאָגן	פֿ אַ ר ש ל אָ ג ן
פֿאַרשלאָסן	פֿ אַ ר ש ל אָ ס ן
פֿאַרשלאָפֿן	פֿ אַ ר ש ל אָ פֿ ן
פֿאַרשלאָפֿענעם	פֿ אַ ר ש ל אָ פֿ ע נ ע ם
פֿאַרשנײטע	פֿ אַ ר ש נ ײ ט ע
פֿאַרשנאָשקעט	פֿ אַ ר ש נ אָ ש ק ע ט
פֿאַרשעמט	פֿ אַ ר ש ע מ ט
פֿאַרשריבן	פֿ אַ ר ש ר י ב ן
פֿאַרשרײַבט	פֿ אַ ר ש ר ײַ ב ט
פֿאַרשרײַבן	פֿ אַ ר ש ר ײַ ב ן
פֿאַרשרײַטס	פֿ אַ ר ש ר ײַ ט ס
פֿאַרשװינדט	פֿ אַ ר ש װ י נ ד ט
פֿאַרשװינדן	פֿ אַ ר ש װ י נ ד ן
פֿאַרשװינט	פֿ אַ ר ש װ י נ ט
פֿאַרשװיצטע	פֿ אַ ר ש װ י צ ט ע
פֿאַרשװאַרצט	פֿ אַ ר ש װ אַ ר צ ט
פֿאַרשװוּנדן	פֿ אַ ר ש װ וּ נ ד ן
פֿאַרשײדענע	פֿ אַ ר ש ײ ד ע נ ע
פֿאַרשאַרצט	פֿ אַ ר ש אַ ר צ ט
פֿאַרשאַרצטע	פֿ אַ ר ש אַ ר צ ט ע
פֿאַרשפּעטיקן	פֿ אַ ר ש פּ ע ט י ק ן
פֿאַרשפּאָרט	פֿ אַ ר ש פּ אָ ר ט
פֿאַרװיגט	פֿ אַ ר װ י ג ט
פֿאַרװילט	פֿ אַ ר װ י ל ט
פֿאַרװיסט	פֿ אַ ר װ י ס ט
פֿאַרװיקלט	פֿ אַ ר װ י ק ל ט
פֿאַרװאַקסענע	פֿ אַ ר װ אַ ק ס ע נ ע
פֿאַרװאַרפֿן	פֿ אַ ר װ אַ ר פֿ ן
פֿאַרװאָס	פֿ אַ ר װ אָ ס
פֿאַרװאָרפֿן	פֿ אַ ר װ אָ ר פֿ ן
פֿאַרװוּנדערט	פֿ אַ ר װ וּ נ ד ע ר ט
פֿאַרװוּנדערטער	פֿ אַ ר װ וּ נ ד ע ר ט ע ר
פֿאַראַ	פֿ אַ ר אַ
פֿאַראַן	פֿ אַ ר אַ ן
פֿאַרכּישופֿטן	פֿ אַ ר כּ י ש ו פֿ ט ן
פֿאַרפֿונדעװעט	פֿ אַ ר פֿ ו נ ד ע װ ע ט
פֿאַרפֿינצטערט	פֿ אַ ר פֿ י נ צ ט ע ר ט
פֿאַרפֿירט	פֿ אַ ר פֿ י ר ט
פֿאַרפֿלוכט	פֿ אַ ר פֿ ל ו כ ט
פֿאַרפֿלײצט	פֿ אַ ר פֿ ל ײ צ ט
פֿאַרפֿלאַנצט	פֿ אַ ר פֿ ל אַ נ צ ט
פֿאַרפֿעלט	פֿ אַ ר פֿ ע ל ט
פֿאַרפֿאַלן	פֿ אַ ר פֿ אַ ל ן
פֿאַרפֿאַסן	פֿ אַ ר פֿ אַ ס ן
פֿאַרפֿאַסער	פֿ אַ ר פֿ אַ ס ע ר
פֿאַרפֿאָרן	פֿ אַ ר פֿ אָ ר ן
פֿאָדעם	פֿ אָ ד ע ם
פֿאָדערשטוב	פֿ אָ ד ע ר ש ט ו ב
פֿאָטער	פֿ אָ ט ע ר
פֿאָטערס	פֿ אָ ט ע ר ס
פֿאָטערשטול	פֿ אָ ט ע ר ש ט ו ל
פֿאָכט	פֿ אָ כ ט
פֿאָלג	פֿ אָ ל ג
פֿאָלגט	פֿ אָ ל ג ט
פֿאָלגן	פֿ אָ ל ג ן
פֿאָלק	פֿ אָ ל ק
פֿאָלק־ישׂראל	פֿ אָ ל ק ־ י שׂ ר א ל
פֿאָלקס	פֿ אָ ל ק ס
פֿאָלקסליד	פֿ אָ ל ק ס ל י ד
פֿאָלקסליד־נוסח	פֿ אָ ל ק ס ל י ד ־ נ ו ס ח
פֿאָלקסלידער	פֿ אָ ל ק ס ל י ד ע ר
פֿאָן	פֿ אָ ן
פֿאָניען	פֿ אָ נ י ע ן
פֿאָנקעלע	פֿ אָ נ ק ע ל ע
פֿאָר	פֿ אָ ר
פֿאָרזיכטיק	פֿ אָ ר ז י כ ט י ק
פֿאָרט	פֿ אָ ר ט
פֿאָרטעפּיאַן	פֿ אָ ר ט ע פּ י אַ ן
פֿאָרמען	פֿ אָ ר מ ע ן
פֿאָרן	פֿ אָ ר ן
פֿאָרנדיק	פֿ אָ ר נ ד י ק
פֿאָרסט	פֿ אָ ר ס ט
פֿאָרקומען	פֿ אָ ר ק ו מ ע ן
פֿאָרשטעלן	פֿ אָ ר ש ט ע ל ן
פֿאָרױס	פֿ אָ ר ױ ס